"Date","Time","TimeZone","Name","Type","Status","Currency","Amount","Fees","Total","Exchange Rate","Receipt ID","Balance","Transaction ID","Item Title"
"04/01/2024","05:25:55","PST","Uber Payments BV","PreApproved Payment Bill User Payment","Completed","EUR","-29,80","0,00","-29,80",,"","-29,80","7JV08480WM726924V",""
"04/01/2024","05:25:55","PST","","General Card Deposit","Completed","EUR","29,80","0,00","29,80",,"","0,00","68M85459UV573825P",""
"05/01/2024","04:52:14","PST","Uber Payments BV","PreApproved Payment Bill User Payment","Completed","EUR","-17,20","0,00","-17,20",,"","-17,20","5P142645PX8200712",""
"05/01/2024","04:52:14","PST","","General Card Deposit","Completed","EUR","17,20","0,00","17,20",,"","0,00","5W250796JS986114N",""
"11/01/2024","05:21:21","PST","Uber Payments BV","PreApproved Payment Bill User Payment","Completed","EUR","-29,80","0,00","-29,80",,"","-29,80","4TB40089S4171732L",""
"11/01/2024","05:21:21","PST","","General Card Deposit","Completed","EUR","29,80","0,00","29,80",,"","0,00","91S206915U554622J",""
"16/01/2024","21:34:51","PST","Apple Services","PreApproved Payment Bill User Payment","Completed","EUR","-5,99","0,00","-5,99",,"","-5,99","6Y35399941293310B",""
"16/01/2024","21:34:51","PST","","General Card Deposit","Completed","EUR","5,99","0,00","5,99",,"","0,00","73L87647L1217714W",""
"17/01/2024","13:40:57","PST","Google","PreApproved Payment Bill User Payment","Completed","EUR","-8,49","0,00","-8,49",,"","-8,49","8N259786JX149805H",""
"17/01/2024","13:40:57","PST","","General Card Deposit","Completed","EUR","8,49","0,00","8,49",,"","0,00","26E30353AK697061R",""
"20/01/2024","04:16:02","PST","Uber BV","PreApproved Payment Bill User Payment","Completed","EUR","-4,99","0,00","-4,99",,"","-4,99","2PV37164SM632025D",""
"20/01/2024","04:16:02","PST","","General Card Deposit","Completed","EUR","4,99","0,00","4,99",,"","0,00","7X248103245029505",""
"21/01/2024","04:54:43","PST","Uber Payments BV","PreApproved Payment Bill User Payment","Completed","EUR","-29,80","0,00","-29,80",,"","-29,80","50W95650DA5197212",""
"21/01/2024","04:54:43","PST","","General Card Deposit","Completed","EUR","29,80","0,00","29,80",,"","0,00","80E97228X7351335R",""
"25/01/2024","05:15:52","PST","Uber Payments BV","PreApproved Payment Bill User Payment","Completed","EUR","-39,70","0,00","-39,70",,"","-39,70","8X56389498988042S",""
"25/01/2024","05:15:52","PST","","General Card Deposit","Completed","EUR","39,70","0,00","39,70",,"","0,00","8PD10221W34440749",""
"28/01/2024","03:15:52","PST","Sony Interactive Entertainment Network Europe Limited","PreApproved Payment Bill User Payment","Completed","EUR","-8,99","0,00","-8,99",,"","-8,99","6UY18772GM8902641",""
"28/01/2024","03:15:52","PST","","General Card Deposit","Completed","EUR","8,99","0,00","8,99",,"","0,00","98Y510398K633563L",""
"28/01/2024","05:03:44","PST","Google Payment Ireland Ltd.","PreApproved Payment Bill User Payment","Completed","EUR","-2,99","0,00","-2,99",,"","-2,99","0TL73097L95183023",""
"28/01/2024","05:03:44","PST","","General Card Deposit","Completed","EUR","2,99","0,00","2,99",,"","0,00","0R118976NL4573818",""
"28/01/2024","06:23:40","PST","NOS Lusomundo Cinemas, S.A.","Express Checkout Payment","Completed","EUR","-22,25","0,00","-22,25",,"","-22,25","1XS35734YB7704912",""
"28/01/2024","06:23:40","PST","","General Card Deposit","Completed","EUR","22,25","0,00","22,25",,"","0,00","2JL00209JW854022S",""
"29/01/2024","05:51:55","PST","Apple Services","PreApproved Payment Bill User Payment","Completed","EUR","-5,49","0,00","-5,49",,"","-5,49","04C814355S664322M",""
"29/01/2024","05:51:55","PST","","General Card Deposit","Completed","EUR","5,49","0,00","5,49",,"","0,00","20Y66202FV183803K",""
"29/01/2024","18:54:02","PST","Apple Services","PreApproved Payment Bill User Payment","Completed","EUR","-21,95","0,00","-21,95",,"","-21,95","3BP15942BK850862N",""
"29/01/2024","18:54:02","PST","","General Card Deposit","Completed","EUR","21,95","0,00","21,95",,"","0,00","5GU088836W126310C",""
"31/01/2024","05:51:04","PST","Uber Payments BV","PreApproved Payment Bill User Payment","Completed","EUR","-19,30","0,00","-19,30",,"","-19,30","36X02244JS154320D",""
"31/01/2024","05:51:04","PST","","General Card Deposit","Completed","EUR","19,30","0,00","19,30",,"","0,00","9C0818243H640474H",""
"01/02/2024","05:05:23","PST","Uber Payments BV","PreApproved Payment Bill User Payment","Completed","EUR","-29,80","0,00","-29,80",,"","-29,80","31668546NH2689445",""
"01/02/2024","05:05:23","PST","","General Card Deposit","Completed","EUR","29,80","0,00","29,80",,"","0,00","4YE14569L3738914K",""
"08/02/2024","04:57:02","PST","Uber Payments BV","PreApproved Payment Bill User Payment","Completed","EUR","-29,80","0,00","-29,80",,"","-29,80","92395547JV8531432",""
"08/02/2024","04:57:02","PST","","General Card Deposit","Completed","EUR","29,80","0,00","29,80",,"","0,00","8X569638PM643812K",""
"09/02/2024","09:32:29","PST","Hospital da Luz Clinica da Amadora","Express Checkout Payment","Completed","EUR","-17,00","0,00","-17,00",,"","-17,00","86G05386WW107535P",""
"09/02/2024","09:32:29","PST","","General Card Deposit","Completed","EUR","17,00","0,00","17,00",,"","0,00","7C9157756F529231A",""
"12/02/2024","08:54:39","PST","Apple Services","PreApproved Payment Bill User Payment","Completed","EUR","-3,99","0,00","-3,99",,"","-3,99","2H223295C35855503",""
"12/02/2024","08:54:39","PST","","General Card Deposit","Completed","EUR","3,99","0,00","3,99",,"","0,00","0UY23516HK1922924",""
"15/02/2024","05:08:35","PST","Uber Payments BV","PreApproved Payment Bill User Payment","Completed","EUR","-19,90","0,00","-19,90",,"","-19,90","3J452786YX612032R",""
"15/02/2024","05:08:35","PST","","General Card Deposit","Completed","EUR","19,90","0,00","19,90",,"","0,00","1S385364FJ0715400",""
"16/02/2024","21:36:37","PST","Apple Services","PreApproved Payment Bill User Payment","Completed","EUR","-5,99","0,00","-5,99",,"","-5,99","9KD31254GU561571V",""
"16/02/2024","21:36:37","PST","","General Card Deposit","Completed","EUR","5,99","0,00","5,99",,"","0,00","3MX359186M8530222",""
"17/02/2024","13:40:57","PST","Google","PreApproved Payment Bill User Payment","Completed","EUR","-8,49","0,00","-8,49",,"","-8,49","99231256GS3475358",""
"17/02/2024","13:40:57","PST","","General Card Deposit","Completed","EUR","8,49","0,00","8,49",,"","0,00","3AA80480WW8608410",""
"19/02/2024","05:08:08","PST","Uber Payments BV","PreApproved Payment Bill User Payment","Completed","EUR","-17,20","0,00","-17,20",,"","-17,20","5EM62058DE4063051",""
"19/02/2024","05:08:08","PST","","General Card Deposit","Completed","EUR","17,20","0,00","17,20",,"","0,00","0EM0791763036345S",""
"20/02/2024","04:10:08","PST","Uber BV","PreApproved Payment Bill User Payment","Completed","EUR","-4,99","0,00","-4,99",,"","-4,99","1CB80289138257355",""
"20/02/2024","04:10:08","PST","","General Card Deposit","Completed","EUR","4,99","0,00","4,99",,"","0,00","1RS81478FU6798749",""
"22/02/2024","05:24:29","PST","Uber Payments BV","PreApproved Payment Bill User Payment","Completed","EUR","-29,80","0,00","-29,80",,"","-29,80","0B5043582J560734Y",""
"22/02/2024","05:24:29","PST","","General Card Deposit","Completed","EUR","29,80","0,00","29,80",,"","0,00","0B6764084F481710P",""
"23/02/2024","08:34:27","PST","IKEA Portugal Móveis e Decoração, Lda","Express Checkout Payment","Completed","EUR","-318,00","0,00","-318,00",,"","-318,00","0RK39882K50132151",""
"23/02/2024","08:34:27","PST","","General Card Deposit","Completed","EUR","318,00","0,00","318,00",,"","0,00","6SA51936D3283352J",""
"26/02/2024","05:51:53","PST","Uber Payments BV","PreApproved Payment Bill User Payment","Completed","EUR","-16,72","0,00","-16,72",,"","-16,72","99T46894063065841",""
"26/02/2024","05:51:53","PST","","General Card Deposit","Completed","EUR","16,72","0,00","16,72",,"","0,00","3TH75861YN706061D",""
"28/02/2024","03:15:55","PST","Sony Interactive Entertainment Network Europe Limited","PreApproved Payment Bill User Payment","Completed","EUR","-8,99","0,00","-8,99",,"","-8,99","8FV7224887159461W",""
"28/02/2024","03:15:55","PST","","General Card Deposit","Completed","EUR","8,99","0,00","8,99",,"","0,00","86K92189X6334421B",""
"28/02/2024","05:03:43","PST","Google Payment Ireland Limited","PreApproved Payment Bill User Payment","Completed","EUR","-2,99","0,00","-2,99",,"","-2,99","4R6934824L974104W",""
"28/02/2024","05:03:43","PST","","General Card Deposit","Completed","EUR","2,99","0,00","2,99",,"","0,00","3T951885P8936534F",""
"28/02/2024","18:54:05","PST","Apple Services","PreApproved Payment Bill User Payment","Completed","EUR","-21,95","0,00","-21,95",,"","-21,95","0JS13634EC3254220",""
"28/02/2024","18:54:05","PST","","General Card Deposit","Completed","EUR","21,95","0,00","21,95",,"","0,00","2AE964655W1218845",""
"28/02/2024","21:53:30","PST","Apple Services","PreApproved Payment Bill User Payment","Completed","EUR","-5,49","0,00","-5,49",,"","-5,49","5XN917344S980882K",""
"28/02/2024","21:53:30","PST","","General Card Deposit","Completed","EUR","5,49","0,00","5,49",,"","0,00","6PK81102N7132864K",""
"01/03/2024","05:08:37","PST","Uber Payments BV","PreApproved Payment Bill User Payment","Completed","EUR","-29,80","0,00","-29,80",,"","-29,80","5WM97018J09671141",""
"01/03/2024","05:08:37","PST","","General Card Deposit","Completed","EUR","29,80","0,00","29,80",,"","0,00","73M85080VM708774X",""
"05/03/2024","07:44:52","PST","GOG Sp. Z o.o.","Express Checkout Payment","Completed","EUR","-9,99","0,00","-9,99",,"","-9,99","21C88856M2460230E",""
"05/03/2024","07:44:52","PST","","General Card Deposit","Completed","EUR","9,99","0,00","9,99",,"","0,00","4B481354694534742",""
"05/03/2024","08:14:09","PST","www.steampowered.com","Express Checkout Payment","Completed","EUR","-9,99","0,00","-9,99",,"","-9,99","78L67981HR386070R",""
"05/03/2024","08:14:09","PST","","General Card Deposit","Completed","EUR","9,99","0,00","9,99",,"","0,00","5CS665084B788054W",""
"06/03/2024","00:11:39","PST","GitHub, Inc.","PreApproved Payment Bill User Payment","Completed","USD","-10,00","0,00","-10,00",,"","-10,00","0CM41654XG811035G",""
"06/03/2024","00:11:39","PST","","General Card Deposit","Completed","USD","10,00","0,00","10,00",,"","0,00","13M23737YN301880H",""
"06/03/2024","01:03:30","PST","GOG Sp. Z o.o.","Payment Refund","Completed","EUR","9,99","0,00","9,99",,"","9,99","8N537790YU895204F",""
"06/03/2024","01:03:30","PST","","General Card Withdrawal","Completed","EUR","-9,99","0,00","-9,99",,"","0,00","5RJ489487S544325G",""
"07/03/2024","05:01:53","PST","Uber Payments BV","PreApproved Payment Bill User Payment","Completed","EUR","-19,90","0,00","-19,90",,"","-19,90","6J958879NK655525N",""
"07/03/2024","05:01:53","PST","","General Card Deposit","Completed","EUR","19,90","0,00","19,90",,"","0,00","1TH11876PN841642W",""
"08/03/2024","05:38:27","PST","Uber Payments BV","PreApproved Payment Bill User Payment","Completed","EUR","-17,20","0,00","-17,20",,"","-17,20","44050538R25192017",""
"08/03/2024","05:38:27","PST","","General Card Deposit","Completed","EUR","17,20","0,00","17,20",,"","0,00","1WB626759T363230J",""
"10/03/2024","06:36:36","PDT","Uber Payments BV","PreApproved Payment Bill User Payment","Completed","EUR","-36,10","0,00","-36,10",,"","-36,10","1X0059192D9195538",""
"10/03/2024","06:36:36","PDT","","General Card Deposit","Completed","EUR","36,10","0,00","36,10",,"","0,00","0UV044760S492471N",""
"10/03/2024","07:37:24","PDT","Uber Payments BV","PreApproved Payment Bill User Payment","Completed","EUR","-23,10","0,00","-23,10",,"","-23,10","8HX80109FE620530D",""
"10/03/2024","07:37:24","PDT","","General Card Deposit","Completed","EUR","23,10","0,00","23,10",,"","0,00","5JR46685KS331061M",""
"12/03/2024","04:16:28","PDT","NOS Lusomundo Cinemas, S.A.","Express Checkout Payment","Completed","EUR","-23,85","0,00","-23,85",,"","-23,85","58610925PA557673P",""
"12/03/2024","04:16:28","PDT","","General Card Deposit","Completed","EUR","23,85","0,00","23,85",,"","0,00","51L99148H83217845",""
"14/03/2024","06:26:24","PDT","Uber Payments BV","PreApproved Payment Bill User Payment","Completed","EUR","-19,90","0,00","-19,90",,"","-19,90","5KB56416E13644344",""
"14/03/2024","06:26:24","PDT","","General Card Deposit","Completed","EUR","19,90","0,00","19,90",,"","0,00","5XY56065BV1548305",""
"16/03/2024","01:31:45","PDT","PUBLICO - COMUNICACAO SOCIAL SA","Express Checkout Payment","Completed","EUR","-60,00","0,00","-60,00",,"","-60,00","0UJ86415LW528542N",""
"16/03/2024","01:31:45","PDT","","General Card Deposit","Completed","EUR","60,00","0,00","60,00",,"","0,00","8U544697HX649172R",""
"17/03/2024","14:40:57","PDT","Google","PreApproved Payment Bill User Payment","Completed","EUR","-8,49","0,00","-8,49",,"","-8,49","5U946271NS1400925",""
"17/03/2024","14:40:57","PDT","","General Card Deposit","Completed","EUR","8,49","0,00","8,49",,"","0,00","9EX50912V2420723G",""
"20/03/2024","05:10:09","PDT","Uber BV","PreApproved Payment Bill User Payment","Completed","EUR","-4,99","0,00","-4,99",,"","-4,99","7M6745978H437933T",""
"20/03/2024","05:10:09","PDT","","General Card Deposit","Completed","EUR","4,99","0,00","4,99",,"","0,00","98E33609FC0656143",""
"21/03/2024","06:10:33","PDT","Uber Payments BV","PreApproved Payment Bill User Payment","Completed","EUR","-39,70","0,00","-39,70",,"","-39,70","3J979110W13422345",""
"21/03/2024","06:10:33","PDT","","General Card Deposit","Completed","EUR","39,70","0,00","39,70",,"","0,00","07961139VH119384W",""
"23/03/2024","11:00:55","PDT","zooplus SE","Express Checkout Payment","Completed","EUR","-75,47","0,00","-75,47",,"","-75,47","9JT19428TY983414L",""
"23/03/2024","11:00:55","PDT","","General Card Deposit","Completed","EUR","75,47","0,00","75,47",,"","0,00","84J16916DG431632U",""
"25/03/2024","04:42:44","PDT","BCM - BRICOLAGE S.A.","Express Checkout Payment","Completed","EUR","-2.250,67","0,00","-2.250,67",,"","-2.250,67","76X60190KH559610W",""
"25/03/2024","04:42:44","PDT","","General Card Deposit","Completed","EUR","2.250,67","0,00","2.250,67",,"","0,00","4HV54323NP2832648",""
"25/03/2024","04:44:01","PDT","BCM - BRICOLAGE S.A.","Express Checkout Payment","Completed","EUR","-709,38","0,00","-709,38",,"","-709,38","0DP002856E5073810",""
"25/03/2024","04:44:01","PDT","","General Card Deposit","Completed","EUR","709,38","0,00","709,38",,"","0,00","7HJ28223C64695549",""
"27/03/2024","05:14:14","PDT","FEVER","Express Checkout Payment","Completed","EUR","-44,00","0,00","-44,00",,"","-44,00","34558706VE981661L",""
"27/03/2024","05:14:14","PDT","","General Card Deposit","Completed","EUR","44,00","0,00","44,00",,"","0,00","52F01472TK3207601",""
"27/03/2024","12:51:48","PDT","Uber Payments BV","PreApproved Payment Bill User Payment","Completed","EUR","-3,63","0,00","-3,63",,"","-3,63","3DC27746X85984134",""
"27/03/2024","12:51:48","PDT","","General Card Deposit","Completed","EUR","3,63","0,00","3,63",,"","0,00","26H141570F507740Y",""
"27/03/2024","12:52:29","PDT","Uber Payments BV","PreApproved Payment Bill User Payment","Completed","EUR","-2,00","0,00","-2,00",,"","-2,00","5YT42659JB950541W",""
"27/03/2024","12:52:29","PDT","","General Card Deposit","Completed","EUR","2,00","0,00","2,00",,"","0,00","2CD37777M0564302M",""
"27/03/2024","16:42:52","PDT","Uber Payments BV","PreApproved Payment Bill User Payment","Completed","EUR","-2,50","0,00","-2,50",,"","-2,50","906365190M681721R",""
"27/03/2024","16:42:52","PDT","","General Card Deposit","Completed","EUR","2,50","0,00","2,50",,"","0,00","1Y2686510E369905S",""
"27/03/2024","16:44:37","PDT","Uber Payments BV","PreApproved Payment Bill User Payment","Completed","EUR","-2,00","0,00","-2,00",,"","-2,00","1SW365275Y646080G",""
"27/03/2024","16:44:37","PDT","","General Card Deposit","Completed","EUR","2,00","0,00","2,00",,"","0,00","1AD25754WH207234P",""
"28/03/2024","04:15:43","PDT","Sony Interactive Entertainment Network Europe Limited","PreApproved Payment Bill User Payment","Completed","EUR","-8,99","0,00","-8,99",,"","-8,99","2G151662M1837854P",""
"28/03/2024","04:15:43","PDT","","General Card Deposit","Completed","EUR","8,99","0,00","8,99",,"","0,00","9RJ437293B9961629",""
"28/03/2024","06:03:43","PDT","Google Payment Ireland Limited","PreApproved Payment Bill User Payment","Completed","EUR","-2,99","0,00","-2,99",,"","-2,99","7W828383CC075060R",""
"28/03/2024","06:03:43","PDT","","General Card Deposit","Completed","EUR","2,99","0,00","2,99",,"","0,00","78A993920D804361G",""
"28/03/2024","21:56:02","PDT","Apple Services","PreApproved Payment Bill User Payment","Completed","EUR","-5,49","0,00","-5,49",,"","-5,49","34V81765PN052864R",""
"28/03/2024","21:56:02","PDT","","General Card Deposit","Completed","EUR","5,49","0,00","5,49",,"","0,00","3BL31232J1159774G",""
"29/03/2024","06:09:00","PDT","Uber Payments BV","PreApproved Payment Bill User Payment","Completed","EUR","-29,68","0,00","-29,68",,"","-29,68","9KL20373LN968824T",""
"29/03/2024","06:09:00","PDT","","General Card Deposit","Completed","EUR","29,68","0,00","29,68",,"","0,00","5LD73376DE754822L",""
"29/03/2024","18:53:36","PDT","Apple Services","PreApproved Payment Bill User Payment","Completed","EUR","-21,95","0,00","-21,95",,"","-21,95","68E268875T4823838",""
"29/03/2024","18:53:36","PDT","","General Card Deposit","Completed","EUR","21,95","0,00","21,95",,"","0,00","32R06328K19702813",""
"30/03/2024","10:28:21","PDT","Temu.com","Express Checkout Payment","Completed","EUR","-72,67","0,00","-72,67",,"","-72,67","2GX160938L655282T",""
"30/03/2024","10:28:21","PDT","","General Card Deposit","Completed","EUR","72,67","0,00","72,67",,"","0,00","0JB53115509483217",""
"30/03/2024","10:34:40","PDT","Temu.com","PreApproved Payment Bill User Payment","Completed","EUR","-18,48","0,00","-18,48",,"","-18,48","299987124H588825F",""
"30/03/2024","10:34:40","PDT","","General Card Deposit","Completed","EUR","18,48","0,00","18,48",,"","0,00","1R259540AA113924P",""
"31/03/2024","05:25:57","PDT","Uber Payments BV","PreApproved Payment Bill User Payment","Completed","EUR","-15,60","0,00","-15,60",,"","-15,60","5P613836TC588700Y",""
"31/03/2024","05:25:57","PDT","","General Card Deposit","Completed","EUR","15,60","0,00","15,60",,"","0,00","40M05218VL319325A",""
"01/04/2024","14:23:55","PDT","Apple Services","PreApproved Payment Bill User Payment","Completed","EUR","-3,99","0,00","-3,99",,"","-3,99","9KP027359N539372U",""
"01/04/2024","14:23:55","PDT","","General Card Deposit","Completed","EUR","3,99","0,00","3,99",,"","0,00","18C31900NR222194V",""
"02/04/2024","05:12:32","PDT","Uber Payments BV","PreApproved Payment Bill User Payment","Completed","EUR","-33,20","0,00","-33,20",,"","-33,20","1YX84122MX682852T",""
"02/04/2024","05:12:32","PDT","","General Card Deposit","Completed","EUR","33,20","0,00","33,20",,"","0,00","9TA28331W9516413M",""
"04/04/2024","05:18:26","PDT","Uber Payments BV","PreApproved Payment Bill User Payment","Completed","EUR","-29,80","0,00","-29,80",,"","-29,80","8WE23645MW267415Y",""
"04/04/2024","05:18:26","PDT","","General Card Deposit","Completed","EUR","29,80","0,00","29,80",,"","0,00","7U32361501752633T",""
"06/04/2024","10:12:14","PDT","GitHub, Inc.","PreApproved Payment Bill User Payment","Completed","USD","-10,00","0,00","-10,00",,"","-10,00","3923110811970993R",""
"06/04/2024","10:12:14","PDT","","General Card Deposit","Completed","USD","10,00","0,00","10,00",,"","0,00","62W45761R9085454T",""
"07/04/2024","05:12:31","PDT","Uber Payments BV","PreApproved Payment Bill User Payment","Completed","EUR","-15,60","0,00","-15,60",,"","-15,60","6DJ84307069447455",""
"07/04/2024","05:12:31","PDT","","General Card Deposit","Completed","EUR","15,60","0,00","15,60",,"","0,00","6TK9391532741420G",""
"08/04/2024","07:36:45","PDT","Google Payment Ireland Limited","PreApproved Payment Bill User Payment","Completed","EUR","-19,99","0,00","-19,99",,"","-19,99","84545913ME875331U",""
"08/04/2024","07:36:45","PDT","","General Card Deposit","Completed","EUR","19,99","0,00","19,99",,"","0,00","4BV06782EE9036301",""
"08/04/2024","17:01:51","PDT","Apple Services","PreApproved Payment Bill User Payment","Completed","EUR","-35,99","0,00","-35,99",,"","-35,99","91F34335698535703",""
"08/04/2024","17:01:51","PDT","","General Card Deposit","Completed","EUR","35,99","0,00","35,99",,"","0,00","35C11082T0176903A",""
"10/04/2024","04:27:59","PDT","Uber Payments BV","PreApproved Payment Bill User Payment","Completed","EUR","-29,80","0,00","-29,80",,"","-29,80","6PL10175944042815",""
"10/04/2024","04:27:59","PDT","","General Card Deposit","Completed","EUR","29,80","0,00","29,80",,"","0,00","1N43261382345103U",""
"11/04/2024","12:48:41","PDT","Uber Payments BV","PreApproved Payment Bill User Payment","Completed","EUR","-23,40","0,00","-23,40",,"","-23,40","0SX43178BS855434D",""
"11/04/2024","12:48:41","PDT","","General Card Deposit","Completed","EUR","23,40","0,00","23,40",,"","0,00","6L149652C5570550R",""
"12/04/2024","08:12:44","PDT","Sony Interactive Entertainment Network Europe Limited","PreApproved Payment Bill User Payment","Completed","EUR","-39,99","0,00","-39,99",,"","-39,99","0BS72065D7991420V",""
"12/04/2024","08:12:44","PDT","","General Card Deposit","Completed","EUR","39,99","0,00","39,99",,"","0,00","3JN05404AX056440X",""
"13/04/2024","04:22:43","PDT","Apple Services","PreApproved Payment Bill User Payment","Completed","EUR","-27,49","0,00","-27,49",,"","-27,49","6NM84159XN4553455",""
"13/04/2024","04:22:43","PDT","","General Card Deposit","Completed","EUR","27,49","0,00","27,49",,"","0,00","5B732387M13167352",""
"17/04/2024","13:40:57","PDT","Google","PreApproved Payment Bill User Payment","Completed","EUR","-8,49","0,00","-8,49",,"","-8,49","1KX62099P9084545J",""
"17/04/2024","13:40:57","PDT","","General Card Deposit","Completed","EUR","8,49","0,00","8,49",,"","0,00","8LB48652GK476322R",""
"18/04/2024","05:26:16","PDT","Uber Payments BV","PreApproved Payment Bill User Payment","Completed","EUR","-29,80","0,00","-29,80",,"","-29,80","54B504888P290834V",""
"18/04/2024","05:26:16","PDT","","General Card Deposit","Completed","EUR","29,80","0,00","29,80",,"","0,00","5GD022798P151223G",""
"20/04/2024","05:10:07","PDT","Uber BV","PreApproved Payment Bill User Payment","Completed","EUR","-4,99","0,00","-4,99",,"","-4,99","17635141U0895324T",""
"20/04/2024","05:10:07","PDT","","General Card Deposit","Completed","EUR","4,99","0,00","4,99",,"","0,00","59W41049DM562003D",""
"22/04/2024","14:01:46","PDT","WayMeet Limited","Express Checkout Payment","Completed","EUR","-64,99","0,00","-64,99",,"","-64,99","4N569531263706500",""
"22/04/2024","14:01:46","PDT","","General Card Deposit","Completed","EUR","64,99","0,00","64,99",,"","0,00","71H96021CE939615X",""
"24/04/2024","00:01:10","PDT","Uber Payments BV","PreApproved Payment Bill User Payment","Completed","EUR","-7,00","0,00","-7,00",,"","-7,00","654764296Y360845C",""
"24/04/2024","00:01:10","PDT","","General Card Deposit","Completed","EUR","7,00","0,00","7,00",,"","0,00","70397351K5732091C",""
"25/04/2024","05:15:04","PDT","Uber Payments BV","PreApproved Payment Bill User Payment","Completed","EUR","-33,20","0,00","-33,20",,"","-33,20","64L94831X1839241P",""
"25/04/2024","05:15:04","PDT","","General Card Deposit","Completed","EUR","33,20","0,00","33,20",,"","0,00","0JH0456626472662J",""
"25/04/2024","05:43:57","PDT","Uber Payments BV","PreApproved Payment Bill User Payment","Completed","EUR","-0,67","0,00","-0,67",,"","-0,67","4L865156746020406",""
"25/04/2024","05:43:57","PDT","","General Card Deposit","Completed","EUR","0,67","0,00","0,67",,"","0,00","3FT58744NG598490U",""
"25/04/2024","07:26:43","PDT","Uber Payments BV","PreApproved Payment Bill User Payment","Completed","EUR","-8,36","0,00","-8,36",,"","-8,36","1S464797JK2181032",""
"25/04/2024","07:26:43","PDT","","General Card Deposit","Completed","EUR","8,36","0,00","8,36",,"","0,00","82X71144J0441754F",""
"25/04/2024","07:27:13","PDT","Uber Payments BV","PreApproved Payment Bill User Payment","Completed","EUR","-5,00","0,00","-5,00",,"","-5,00","7VV33220S83921051",""
"25/04/2024","07:27:13","PDT","","General Card Deposit","Completed","EUR","5,00","0,00","5,00",,"","0,00","1NB81518N3707622B",""
"25/04/2024","10:50:24","PDT","Uber Payments BV","PreApproved Payment Bill User Payment","Completed","EUR","-8,19","0,00","-8,19",,"","-8,19","6SH52371471132841",""
"25/04/2024","10:50:24","PDT","","General Card Deposit","Completed","EUR","8,19","0,00","8,19",,"","0,00","46D11278DW239881A",""
"26/04/2024","05:11:47","PDT","Uber Payments BV","PreApproved Payment Bill User Payment","Completed","EUR","-19,50","0,00","-19,50",,"","-19,50","5GU551419F3018501",""
"26/04/2024","05:11:47","PDT","","General Card Deposit","Completed","EUR","19,50","0,00","19,50",,"","0,00","78705939W0687563X",""
"27/04/2024","05:08:31","PDT","Uber Payments BV","PreApproved Payment Bill User Payment","Completed","EUR","-17,20","0,00","-17,20",,"","-17,20","05534796FV9391631",""
"27/04/2024","05:08:31","PDT","","General Card Deposit","Completed","EUR","17,20","0,00","17,20",,"","0,00","6CD13327BK561842F",""
"28/04/2024","04:15:51","PDT","Sony Interactive Entertainment Network Europe Limited","PreApproved Payment Bill User Payment","Completed","EUR","-8,99","0,00","-8,99",,"","-8,99","9D739765WX471912K",""
"28/04/2024","04:15:51","PDT","","General Card Deposit","Completed","EUR","8,99","0,00","8,99",,"","0,00","6YW264613W924004G",""
"28/04/2024","05:16:06","PDT","Sony Interactive Entertainment Network Europe Limited","PreApproved Payment Bill User Payment","Completed","EUR","-3,99","0,00","-3,99",,"","-3,99","29Y10503TP356101J",""
"28/04/2024","05:16:06","PDT","","General Card Deposit","Completed","EUR","3,99","0,00","3,99",,"","0,00","39P33384CD136632S",""
"28/04/2024","06:03:46","PDT","Google Payment Ireland Limited","PreApproved Payment Bill User Payment","Completed","EUR","-2,99","0,00","-2,99",,"","-2,99","45R15246D2821925Y",""
"28/04/2024","06:03:46","PDT","","General Card Deposit","Completed","EUR","2,99","0,00","2,99",,"","0,00","76181652HF554672Y",""
"28/04/2024","21:52:44","PDT","Apple Services","PreApproved Payment Bill User Payment","Completed","EUR","-5,49","0,00","-5,49",,"","-5,49","68B208495B412921P",""
"28/04/2024","21:52:44","PDT","","General Card Deposit","Completed","EUR","5,49","0,00","5,49",,"","0,00","6R62635447941122S",""
"29/04/2024","11:22:47","PDT","Uber Payments BV","PreApproved Payment Bill User Payment","Completed","EUR","-13,00","0,00","-13,00",,"","-13,00","9UA52728UN217220N",""
"29/04/2024","11:22:47","PDT","","General Card Deposit","Completed","EUR","13,00","0,00","13,00",,"","0,00","40Y06610KN022912K",""
"29/04/2024","12:38:38","PDT","Uber Payments BV","PreApproved Payment Bill User Payment","Completed","EUR","-10,79","0,00","-10,79",,"","-10,79","2GD11708892911406",""
"29/04/2024","12:38:38","PDT","","General Card Deposit","Completed","EUR","10,79","0,00","10,79",,"","0,00","9V178163EV164843X",""
"29/04/2024","15:45:56","PDT","Uber Payments BV","PreApproved Payment Bill User Payment","Completed","EUR","-5,84","0,00","-5,84",,"","-5,84","9BU851082S6881640",""
"29/04/2024","15:45:56","PDT","","General Card Deposit","Completed","EUR","5,84","0,00","5,84",,"","0,00","00M70286S8030810L",""
"29/04/2024","18:53:42","PDT","Apple Services","PreApproved Payment Bill User Payment","Completed","EUR","-21,95","0,00","-21,95",,"","-21,95","07946851HV675962P",""
"29/04/2024","18:53:42","PDT","","General Card Deposit","Completed","EUR","21,95","0,00","21,95",,"","0,00","4N344899XX659261X",""
"01/05/2024","02:25:21","PDT","Dennis Hubert","Donation Payment","Completed","USD","-5,00","0,00","-5,00",,"","-5,00","9YR79915GB4301740",""
"01/05/2024","02:25:21","PDT","","General Card Deposit","Completed","USD","5,00","0,00","5,00",,"","0,00","9W083575U37194644",""
"01/05/2024","14:19:03","PDT","Apple Services","PreApproved Payment Bill User Payment","Completed","EUR","-3,99","0,00","-3,99",,"","-3,99","6M8882454V680942N",""
"01/05/2024","14:19:03","PDT","","General Card Deposit","Completed","EUR","3,99","0,00","3,99",,"","0,00","86K79788WC6093816",""
"02/05/2024","05:16:29","PDT","Uber Payments BV","PreApproved Payment Bill User Payment","Completed","EUR","-19,61","0,00","-19,61",,"","-19,61","1KS35465L3172511B",""
"02/05/2024","05:16:29","PDT","","General Card Deposit","Completed","EUR","19,61","0,00","19,61",,"","0,00","6UV70858P5784172F",""
"04/05/2024","05:03:47","PDT","Uber Payments BV","PreApproved Payment Bill User Payment","Completed","EUR","-32,10","0,00","-32,10",,"","-32,10","85B89575EY325811C",""
"04/05/2024","05:03:47","PDT","","General Card Deposit","Completed","EUR","32,10","0,00","32,10",,"","0,00","3HT99603AX501642C",""
"06/05/2024","10:06:00","PDT","GitHub, Inc.","PreApproved Payment Bill User Payment","Completed","USD","-10,00","0,00","-10,00",,"","-10,00","3B140129AD301805H",""
"06/05/2024","10:06:00","PDT","","General Card Deposit","Completed","USD","10,00","0,00","10,00",,"","0,00","8S871045A56411017",""
"09/05/2024","05:14:06","PDT","Uber Payments BV","PreApproved Payment Bill User Payment","Completed","EUR","-29,80","0,00","-29,80",,"","-29,80","06539872U9808953V",""
"09/05/2024","05:14:06","PDT","","General Card Deposit","Completed","EUR","29,80","0,00","29,80",,"","0,00","5A254999HA8176225",""
"11/05/2024","04:57:32","PDT","Uber Payments BV","PreApproved Payment Bill User Payment","Completed","EUR","-17,20","0,00","-17,20",,"","-17,20","1FR90530HL5336813",""
"11/05/2024","04:57:32","PDT","","General Card Deposit","Completed","EUR","17,20","0,00","17,20",,"","0,00","0PY52124CL610283H",""
"14/05/2024","06:00:33","PDT","Puro Mobile Srl","Express Checkout Payment","Completed","EUR","-59,95","0,00","-59,95",,"","-59,95","4HC20560FV5041131",""
"14/05/2024","06:00:33","PDT","","General Card Deposit","Completed","EUR","59,95","0,00","59,95",,"","0,00","8R952216RK805341F",""
"16/05/2024","05:13:26","PDT","Uber Payments BV","PreApproved Payment Bill User Payment","Completed","EUR","-39,70","0,00","-39,70",,"","-39,70","6HK159531S806793G",""
"16/05/2024","05:13:26","PDT","","General Card Deposit","Completed","EUR","39,70","0,00","39,70",,"","0,00","1JF63874P0605110E",""
"17/05/2024","13:40:58","PDT","Google","PreApproved Payment Bill User Payment","Completed","EUR","-8,49","0,00","-8,49",,"","-8,49","5AT37038PR6558128",""
"17/05/2024","13:40:58","PDT","","General Card Deposit","Completed","EUR","8,49","0,00","8,49",,"","0,00","4G952751NY671571P",""
"19/05/2024","07:48:06","PDT","Last2Ticket LDA","Express Checkout Payment","Completed","EUR","-16,00","0,00","-16,00",,"","-16,00","0S477161R3532944K",""
"19/05/2024","07:48:06","PDT","","General Card Deposit","Completed","EUR","16,00","0,00","16,00",,"","0,00","9PB528810F383003S",""
"20/05/2024","05:10:08","PDT","Uber BV","PreApproved Payment Bill User Payment","Completed","EUR","-4,99","0,00","-4,99",,"","-4,99","2EN4835990396230J",""
"20/05/2024","05:10:08","PDT","","General Card Deposit","Completed","EUR","4,99","0,00","4,99",,"","0,00","67S97152AR692850D",""
"23/05/2024","05:05:09","PDT","Uber Payments BV","PreApproved Payment Bill User Payment","Completed","EUR","-19,90","0,00","-19,90",,"","-19,90","5DM62932D1097470F",""
"23/05/2024","05:05:09","PDT","","General Card Deposit","Completed","EUR","19,90","0,00","19,90",,"","0,00","1UK576932W713011P",""
"25/05/2024","08:19:29","PDT","Sony Interactive Entertainment Network Europe Limited","PreApproved Payment Bill User Payment","Completed","EUR","-49,99","0,00","-49,99",,"","-49,99","8MA61641TT895022T",""
"25/05/2024","08:19:29","PDT","","General Card Deposit","Completed","EUR","49,99","0,00","49,99",,"","0,00","6JC004008K255815X",""
"25/05/2024","12:27:30","PDT","Apple Services","PreApproved Payment Bill User Payment","Completed","EUR","-2,49","0,00","-2,49",,"","-2,49","79A00625H6173630U",""
"25/05/2024","12:27:30","PDT","","General Card Deposit","Completed","EUR","2,49","0,00","2,49",,"","0,00","4YC88491HX0232842",""
"26/05/2024","06:05:51","PDT","Uber Payments BV","PreApproved Payment Bill User Payment","Completed","EUR","-34,20","0,00","-34,20",,"","-34,20","32814984K1822553T",""
"26/05/2024","06:05:51","PDT","","General Card Deposit","Completed","EUR","34,20","0,00","34,20",,"","0,00","9M448605DH180281Y",""
"28/05/2024","04:15:53","PDT","Sony Interactive Entertainment Network Europe Limited","PreApproved Payment Bill User Payment","Completed","EUR","-8,99","0,00","-8,99",,"","-8,99","44M18524SA563581Y",""
"28/05/2024","04:15:53","PDT","","General Card Deposit","Completed","EUR","8,99","0,00","8,99",,"","0,00","2RJ18349NV604071E",""
"28/05/2024","06:03:43","PDT","Google Payment Ireland Ltd.","PreApproved Payment Bill User Payment","Completed","EUR","-2,99","0,00","-2,99",,"","-2,99","59V63531FH3042847",""
"28/05/2024","06:03:43","PDT","","General Card Deposit","Completed","EUR","2,99","0,00","2,99",,"","0,00","8TJ47422KB3643626",""
"28/05/2024","21:52:11","PDT","Apple Services","PreApproved Payment Bill User Payment","Completed","EUR","-5,49","0,00","-5,49",,"","-5,49","9XM81603D9895421L",""
"28/05/2024","21:52:11","PDT","","General Card Deposit","Completed","EUR","5,49","0,00","5,49",,"","0,00","3LP981174G926741M",""
"29/05/2024","05:14:24","PDT","Uber Payments BV","PreApproved Payment Bill User Payment","Completed","EUR","-29,80","0,00","-29,80",,"","-29,80","8X926510AL302945B",""
"29/05/2024","05:14:24","PDT","","General Card Deposit","Completed","EUR","29,80","0,00","29,80",,"","0,00","9W35494208185125C",""
"29/05/2024","18:53:56","PDT","Apple Services","PreApproved Payment Bill User Payment","Completed","EUR","-21,95","0,00","-21,95",,"","-21,95","6WF93296L1037481T",""
"29/05/2024","18:53:56","PDT","","General Card Deposit","Completed","EUR","21,95","0,00","21,95",,"","0,00","5RK53399RM818470V",""
"05/06/2024","11:13:19","PDT","Uber Payments BV","PreApproved Payment Bill User Payment","Completed","EUR","-14,65","0,00","-14,65",,"","-14,65","1N732031TW235053F",""
"05/06/2024","11:13:19","PDT","","General Card Deposit","Completed","EUR","14,65","0,00","14,65",,"","0,00","0J764582BY5929745",""
"05/06/2024","16:13:08","PDT","Uber Payments BV","PreApproved Payment Bill User Payment","Completed","EUR","-9,59","0,00","-9,59",,"","-9,59","3HD27444Y7838891T",""
"05/06/2024","16:13:08","PDT","","General Card Deposit","Completed","EUR","9,59","0,00","9,59",,"","0,00","99C47104317080210",""
"06/06/2024","05:11:32","PDT","Uber Payments BV","PreApproved Payment Bill User Payment","Completed","EUR","-29,35","0,00","-29,35",,"","-29,35","8NY625112X209250K",""
"06/06/2024","05:11:32","PDT","","General Card Deposit","Completed","EUR","29,35","0,00","29,35",,"","0,00","0XR7360207080690X",""
"06/06/2024","14:39:05","PDT","Wikimedia Foundation, Inc.","Express Checkout Payment","Completed","EUR","-2,35","0,00","-2,35",,"","-2,35","24B67676EF950460X",""
"06/06/2024","14:39:05","PDT","","General Card Deposit","Completed","EUR","2,35","0,00","2,35",,"","0,00","5AD15488S63616307",""
"08/06/2024","05:35:52","PDT","Uber Payments BV","PreApproved Payment Bill User Payment","Completed","EUR","-17,20","0,00","-17,20",,"","-17,20","6C897270W0966000N",""
"08/06/2024","05:35:52","PDT","","General Card Deposit","Completed","EUR","17,20","0,00","17,20",,"","0,00","01T69455X5919845E",""
"11/06/2024","05:39:40","PDT","Uber Payments BV","PreApproved Payment Bill User Payment","Completed","EUR","-29,80","0,00","-29,80",,"","-29,80","1W528610FA431935R",""
"11/06/2024","05:39:40","PDT","","General Card Deposit","Completed","EUR","29,80","0,00","29,80",,"","0,00","0C274485PE7007923",""
"12/06/2024","05:28:17","PDT","Uber Payments BV","PreApproved Payment Bill User Payment","Completed","EUR","-47,09","0,00","-47,09",,"","-47,09","3VH717188X3546124",""
"12/06/2024","05:28:17","PDT","","General Card Deposit","Completed","EUR","47,09","0,00","47,09",,"","0,00","44R51479KD487625L",""
"13/06/2024","10:16:24","PDT","Waves, Inc.","Express Checkout Payment","Completed","USD","-35,99","0,00","-35,99",,"","-35,99","4YV12373S0253905A",""
"13/06/2024","10:16:24","PDT","","General Card Deposit","Completed","USD","35,99","0,00","35,99",,"","0,00","9US30143AW760382D",""
"16/06/2024","01:06:48","PDT","Uber Payments BV","PreApproved Payment Bill User Payment","Completed","EUR","-16,09","0,00","-16,09",,"","-16,09","98T48625TE682584X",""
"16/06/2024","01:06:48","PDT","","General Card Deposit","Completed","EUR","16,09","0,00","16,09",,"","0,00","25A53697CS972123E",""
"16/06/2024","02:22:55","PDT","Uber Payments BV","PreApproved Payment Bill User Payment","Completed","EUR","-0,24","0,00","-0,24",,"","-0,24","3VP10170C8748454D",""
"16/06/2024","02:22:55","PDT","","General Card Deposit","Completed","EUR","0,24","0,00","0,24",,"","0,00","0SV22787UM676293A",""
"16/06/2024","11:54:38","PDT","LuggageHero A/S","PreApproved Payment Bill User Payment","Completed","GBP","-20,10","0,00","-20,10",,"","-20,10","1WW639069S555084K",""
"16/06/2024","11:54:38","PDT","","General Card Deposit","Completed","GBP","20,10","0,00","20,10",,"","0,00","6AE71450XB398090U",""
"16/06/2024","12:22:01","PDT","UBER PAYMENTS UK LIMITED","PreApproved Payment Bill User Payment","Completed","GBP","-12,81","0,00","-12,81",,"","-12,81","1659985128315225K",""
"16/06/2024","12:22:01","PDT","","General Card Deposit","Completed","GBP","12,81","0,00","12,81",,"","0,00","1PD56455UH708433T",""
"17/06/2024","12:58:27","PDT","Apple Services","PreApproved Payment Bill User Payment","Completed","EUR","-3,99","0,00","-3,99",,"","-3,99","0LW393180W104814V",""
"17/06/2024","12:58:27","PDT","","General Card Deposit","Completed","EUR","3,99","0,00","3,99",,"","0,00","5NG057550W966831A",""
"17/06/2024","13:40:57","PDT","Google","PreApproved Payment Bill User Payment","Completed","EUR","-8,49","0,00","-8,49",,"","-8,49","2KX5362773701984V",""
"17/06/2024","13:40:57","PDT","","General Card Deposit","Completed","EUR","8,49","0,00","8,49",,"","0,00","85U843524H784434L",""
"20/06/2024","03:16:40","PDT","Nuro Audio LLC","Express Checkout Payment","Completed","USD","-159,99","0,00","-159,99",,"","-159,99","95420190KP990842H",""
"20/06/2024","03:16:40","PDT","","General Card Deposit","Completed","USD","159,99","0,00","159,99",,"","0,00","91036107DE3705357",""
"20/06/2024","05:06:58","PDT","Uber Payments BV","PreApproved Payment Bill User Payment","Completed","EUR","-29,80","0,00","-29,80",,"","-29,80","43U613921J728764V",""
"20/06/2024","05:06:58","PDT","","General Card Deposit","Completed","EUR","29,80","0,00","29,80",,"","0,00","7VS08407Y2712461S",""
"20/06/2024","05:10:05","PDT","Uber BV","PreApproved Payment Bill User Payment","Completed","EUR","-4,99","0,00","-4,99",,"","-4,99","4RB533580G620272Y",""
"20/06/2024","05:10:05","PDT","","General Card Deposit","Completed","EUR","4,99","0,00","4,99",,"","0,00","0NU1337034574871U",""
"22/06/2024","13:03:00","PDT","TuneCore","PreApproved Payment Bill User Payment","Completed","USD","-23,29","0,00","-23,29",,"","-23,29","4RV438544L877342X",""
"22/06/2024","13:03:00","PDT","","General Card Deposit","Completed","USD","23,29","0,00","23,29",,"","0,00","1GV74371UB4607436",""
"26/06/2024","06:37:39","PDT","GitHub, Inc.","PreApproved Payment Bill User Payment","Completed","USD","-3,33","0,00","-3,33",,"","-3,33","8CU03964S28545747",""
"26/06/2024","06:37:39","PDT","","General Card Deposit","Completed","USD","3,33","0,00","3,33",,"","0,00","6VC074989S540920T",""
"26/06/2024","12:47:38","PDT","Uber Payments BV","PreApproved Payment Bill User Payment","Completed","EUR","-19,80","0,00","-19,80",,"","-19,80","8V593250E33363012",""
"26/06/2024","12:47:38","PDT","","General Card Deposit","Completed","EUR","19,80","0,00","19,80",,"","0,00","00U21856RL244082W",""
"28/06/2024","04:15:56","PDT","Sony Interactive Entertainment Network Europe Limited","PreApproved Payment Bill User Payment","Completed","EUR","-8,99","0,00","-8,99",,"","-8,99","5BE027556K467660M",""
"28/06/2024","04:15:56","PDT","","General Card Deposit","Completed","EUR","8,99","0,00","8,99",,"","0,00","0CS33448YV267364J",""
"28/06/2024","05:07:54","PDT","Uber Payments BV","PreApproved Payment Bill User Payment","Completed","EUR","-29,80","0,00","-29,80",,"","-29,80","8YX094329H832135E",""
"28/06/2024","05:07:54","PDT","","General Card Deposit","Completed","EUR","29,80","0,00","29,80",,"","0,00","4LH5263506110581G",""
"28/06/2024","06:03:46","PDT","Google Payment Ireland Limited","PreApproved Payment Bill User Payment","Completed","EUR","-2,99","0,00","-2,99",,"","-2,99","7RE49765FM883303E",""
"28/06/2024","06:03:46","PDT","","General Card Deposit","Completed","EUR","2,99","0,00","2,99",,"","0,00","43975870EV561335P",""
"28/06/2024","21:52:30","PDT","Apple Services","PreApproved Payment Bill User Payment","Completed","EUR","-5,49","0,00","-5,49",,"","-5,49","2XG010710G506872L",""
"28/06/2024","21:52:30","PDT","","General Card Deposit","Completed","EUR","5,49","0,00","5,49",,"","0,00","9B154353LM9103921",""
"29/06/2024","18:53:40","PDT","Apple Services","PreApproved Payment Bill User Payment","Completed","EUR","-21,95","0,00","-21,95",,"","-21,95","62M5918916643092U",""
"29/06/2024","18:53:40","PDT","","General Card Deposit","Completed","EUR","21,95","0,00","21,95",,"","0,00","0Y495882BG804472T",""
"06/07/2024","10:21:55","PDT","GitHub, Inc.","PreApproved Payment Bill User Payment","Completed","USD","-10,00","0,00","-10,00",,"","-10,00","9T594579SH201032C",""
"06/07/2024","10:21:55","PDT","","General Card Deposit","Completed","USD","10,00","0,00","10,00",,"","0,00","2J468915XV773272K",""
"08/07/2024","03:07:27","PDT","Google Payment Ireland Limited","PreApproved Payment Bill User Payment","Completed","EUR","-99,99","0,00","-99,99",,"","-99,99","85X810146B697903J",""
"08/07/2024","03:07:27","PDT","","General Card Deposit","Completed","EUR","99,99","0,00","99,99",,"","0,00","32C551854P1202112",""
"10/07/2024","03:05:30","PDT","Fnac Portugal","Express Checkout Payment","Completed","EUR","-5,71","0,00","-5,71",,"","-5,71","1C745885JU121652C",""
"10/07/2024","03:05:30","PDT","","General Card Deposit","Completed","EUR","5,71","0,00","5,71",,"","0,00","5B1313758S912822V",""
"10/07/2024","11:37:29","PDT","Uber Payments BV","PreApproved Payment Bill User Payment","Completed","EUR","-5,77","0,00","-5,77",,"","-5,77","0TE65779SS9636210",""
"10/07/2024","11:37:29","PDT","","General Card Deposit","Completed","EUR","5,77","0,00","5,77",,"","0,00","08P674503H603042S",""
"10/07/2024","14:56:26","PDT","Uber Payments BV","PreApproved Payment Bill User Payment","Completed","EUR","-0,23","0,00","-0,23",,"","-0,23","1R344051060774831",""
"10/07/2024","14:56:26","PDT","","General Card Deposit","Completed","EUR","0,23","0,00","0,23",,"","0,00","8TX075477U510352L",""
"11/07/2024","05:05:19","PDT","Uber Payments BV","PreApproved Payment Bill User Payment","Completed","EUR","-39,70","0,00","-39,70",,"","-39,70","3YJ74676JC675164T",""
"11/07/2024","05:05:19","PDT","","General Card Deposit","Completed","EUR","39,70","0,00","39,70",,"","0,00","8L236374PE1713523",""
"12/07/2024","05:55:05","PDT","Uber Payments BV","PreApproved Payment Bill User Payment","Completed","EUR","-33,20","0,00","-33,20",,"","-33,20","2GJ77214238426737",""
"12/07/2024","05:55:05","PDT","","General Card Deposit","Completed","EUR","33,20","0,00","33,20",,"","0,00","8AM75280Y25953739",""
"14/07/2024","12:32:32","PDT","Uber Payments BV","PreApproved Payment Bill User Payment","Completed","EUR","-48,50","0,00","-48,50",,"","-48,50","8BJ13696M9053180C",""
"14/07/2024","12:32:32","PDT","","General Card Deposit","Completed","EUR","48,50","0,00","48,50",,"","0,00","59M05238JB048721M",""
"17/07/2024","13:40:57","PDT","Google","PreApproved Payment Bill User Payment","Completed","EUR","-8,49","0,00","-8,49",,"","-8,49","2EA293254A840094H",""
"17/07/2024","13:40:57","PDT","","General Card Deposit","Completed","EUR","8,49","0,00","8,49",,"","0,00","1U3957800U237422Y",""
"18/07/2024","05:16:56","PDT","Uber Payments BV","PreApproved Payment Bill User Payment","Completed","EUR","-29,80","0,00","-29,80",,"","-29,80","7V529712WE0597445",""
"18/07/2024","05:16:56","PDT","","General Card Deposit","Completed","EUR","29,80","0,00","29,80",,"","0,00","11G81683UJ667023A",""
"18/07/2024","07:55:57","PDT","BSHP Electrodomésticos Soc.Unip.Lda","Express Checkout Payment","Completed","EUR","-549,00","0,00","-549,00",,"","-549,00","74K49337WB993605N",""
"18/07/2024","07:55:57","PDT","","General Card Deposit","Completed","EUR","549,00","0,00","549,00",,"","0,00","4X9665245X2743900",""
"20/07/2024","05:10:07","PDT","Uber BV","PreApproved Payment Bill User Payment","Completed","EUR","-4,99","0,00","-4,99",,"","-4,99","5BN57297S81055133",""
"20/07/2024","05:10:07","PDT","","General Card Deposit","Completed","EUR","4,99","0,00","4,99",,"","0,00","40F84033WL3711617",""
"21/07/2024","05:26:00","PDT","Uber Payments BV","PreApproved Payment Bill User Payment","Completed","EUR","-38,75","0,00","-38,75",,"","-38,75","8CX5207341811924E",""
"21/07/2024","05:26:00","PDT","","General Card Deposit","Completed","EUR","38,75","0,00","38,75",,"","0,00","2J117974RJ6833848",""
"22/07/2024","05:18:06","PDT","Uber Payments BV","PreApproved Payment Bill User Payment","Completed","EUR","-31,20","0,00","-31,20",,"","-31,20","96237003JM0220710",""
"22/07/2024","05:18:06","PDT","","General Card Deposit","Completed","EUR","31,20","0,00","31,20",,"","0,00","6G884296R6960604U",""
"24/07/2024","06:24:40","PDT","Sony Interactive Entertainment Network Europe Limited","PreApproved Payment Bill User Payment","Completed","EUR","-11,99","0,00","-11,99",,"","-11,99","76104496H7857021M",""
"24/07/2024","06:24:40","PDT","","General Card Deposit","Completed","EUR","11,99","0,00","11,99",,"","0,00","0DA05705CE889471R",""
"25/07/2024","04:59:31","PDT","Uber Payments BV","PreApproved Payment Bill User Payment","Completed","EUR","-29,80","0,00","-29,80",,"","-29,80","6FY23958B06085113",""
"25/07/2024","04:59:31","PDT","","General Card Deposit","Completed","EUR","29,80","0,00","29,80",,"","0,00","29V71583SL239051G",""
"28/07/2024","03:42:01","PDT","Dashlane USA Inc","Subscription Payment","Completed","EUR","-39,99","0,00","-39,99",,"","-39,99","6EB51065WX172102V",""
"28/07/2024","03:42:01","PDT","","General Card Deposit","Completed","EUR","39,99","0,00","39,99",,"","0,00","0V849929XF6813830",""
"28/07/2024","04:15:51","PDT","Sony Interactive Entertainment Network Europe Limited","PreApproved Payment Bill User Payment","Completed","EUR","-8,99","0,00","-8,99",,"","-8,99","66Y10887N9130534F",""
"28/07/2024","04:15:51","PDT","","General Card Deposit","Completed","EUR","8,99","0,00","8,99",,"","0,00","2D986873TX447092M",""
"28/07/2024","04:41:36","PDT","Dashlane USA Inc","Payment Refund","Completed","EUR","39,99","0,00","39,99",,"","39,99","8FH13629T5828683K",""
"28/07/2024","04:41:36","PDT","","General Card Withdrawal","Completed","EUR","-39,99","0,00","-39,99",,"","0,00","8JD13553VK379340T",""
"28/07/2024","21:52:31","PDT","Apple Services","PreApproved Payment Bill User Payment","Completed","EUR","-5,49","0,00","-5,49",,"","-5,49","0WA08257SE201541P",""
"28/07/2024","21:52:31","PDT","","General Card Deposit","Completed","EUR","5,49","0,00","5,49",,"","0,00","4Y3161881S9542518",""
"29/07/2024","18:53:37","PDT","Apple Services","PreApproved Payment Bill User Payment","Completed","EUR","-21,95","0,00","-21,95",,"","-21,95","93U31995WA234933L",""
"29/07/2024","18:53:37","PDT","","General Card Deposit","Completed","EUR","21,95","0,00","21,95",,"","0,00","4ER573175F7053344",""
"30/07/2024","10:31:06","PDT","Uber Payments BV","PreApproved Payment Bill User Payment","Completed","EUR","-3,80","0,00","-3,80",,"","-3,80","97P31015J2562403B",""
"30/07/2024","10:31:06","PDT","","General Card Deposit","Completed","EUR","3,80","0,00","3,80",,"","0,00","7SV46329PX688923L",""
"31/07/2024","10:09:14","PDT","The Way Ahead Group Ltd","Express Checkout Payment","Completed","EUR","-32,10","0,00","-32,10",,"","-32,10","4G413106MA8796643",""
"31/07/2024","10:09:14","PDT","","General Card Deposit","Completed","EUR","32,10","0,00","32,10",,"","0,00","2E910491LX3167152",""
"01/08/2024","05:22:26","PDT","Uber Payments BV","PreApproved Payment Bill User Payment","Completed","EUR","-29,62","0,00","-29,62",,"","-29,62","7BL29867DS749814N",""
"01/08/2024","05:22:26","PDT","","General Card Deposit","Completed","EUR","29,62","0,00","29,62",,"","0,00","9M794698987936012",""
"03/08/2024","01:38:09","PDT","Sony Interactive Entertainment Network Europe Limited","PreApproved Payment Bill User Payment","Completed","EUR","-25,49","0,00","-25,49",,"","-25,49","9M9248264C678180W",""
"03/08/2024","01:38:09","PDT","","General Card Deposit","Completed","EUR","25,49","0,00","25,49",,"","0,00","27892124LN219742L",""
"06/08/2024","10:14:12","PDT","GitHub, Inc.","PreApproved Payment Bill User Payment","Completed","USD","-10,00","0,00","-10,00",,"","-10,00","9K787547LK157111F",""
"06/08/2024","10:14:12","PDT","","General Card Deposit","Completed","USD","10,00","0,00","10,00",,"","0,00","8LS278344E1038719",""
"08/08/2024","05:05:13","PDT","Uber Payments BV","PreApproved Payment Bill User Payment","Completed","EUR","-29,80","0,00","-29,80",,"","-29,80","4EU77941BK637183G",""
"08/08/2024","05:05:13","PDT","","General Card Deposit","Completed","EUR","29,80","0,00","29,80",,"","0,00","932227864M883320M",""
"10/08/2024","05:11:33","PDT","CÊ LÁ VI, LDA","Express Checkout Payment","Completed","EUR","-33,99","0,00","-33,99",,"","-33,99","0Y326352R0388871H",""
"10/08/2024","05:11:33","PDT","","General Card Deposit","Completed","EUR","33,99","0,00","33,99",,"","0,00","7MN85260F7674391Y",""
"10/08/2024","05:22:47","PDT","Uber Payments BV","PreApproved Payment Bill User Payment","Completed","EUR","-17,10","0,00","-17,10",,"","-17,10","42835248MD859633P",""
"10/08/2024","05:22:47","PDT","","General Card Deposit","Completed","EUR","17,10","0,00","17,10",,"","0,00","0D0071669D853492P",""
"15/08/2024","05:12:48","PDT","Uber Payments BV","PreApproved Payment Bill User Payment","Completed","EUR","-17,20","0,00","-17,20",,"","-17,20","2HJ90102F19412158",""
"15/08/2024","05:12:48","PDT","","General Card Deposit","Completed","EUR","17,20","0,00","17,20",,"","0,00","62715179S97180300",""
"15/08/2024","09:20:20","PDT","Apple Services","PreApproved Payment Bill User Payment","Completed","EUR","-3,99","0,00","-3,99",,"","-3,99","80W94161UL631415H",""
"15/08/2024","09:20:20","PDT","","General Card Deposit","Completed","EUR","3,99","0,00","3,99",,"","0,00","2P071056VY842393U",""
"16/08/2024","04:54:02","PDT","Uber Payments BV","PreApproved Payment Bill User Payment","Completed","EUR","-29,80","0,00","-29,80",,"","-29,80","04F28724EB068123R",""
"16/08/2024","04:54:02","PDT","","General Card Deposit","Completed","EUR","29,80","0,00","29,80",,"","0,00","64B55872CS582345G",""
"17/08/2024","13:40:57","PDT","Google","PreApproved Payment Bill User Payment","Completed","EUR","-8,49","0,00","-8,49",,"","-8,49","3M637486BR1131203",""
"17/08/2024","13:40:57","PDT","","General Card Deposit","Completed","EUR","8,49","0,00","8,49",,"","0,00","5GM54179EF359231G",""
"20/08/2024","05:10:07","PDT","Uber BV","PreApproved Payment Bill User Payment","Completed","EUR","-4,99","0,00","-4,99",,"","-4,99","3B617045SJ042504B",""
"20/08/2024","05:10:07","PDT","","General Card Deposit","Completed","EUR","4,99","0,00","4,99",,"","0,00","78C902255H210944G",""
"22/08/2024","05:35:14","PDT","Uber Payments BV","PreApproved Payment Bill User Payment","Completed","EUR","-29,80","0,00","-29,80",,"","-29,80","6X268940PJ714781W",""
"22/08/2024","05:35:14","PDT","","General Card Deposit","Completed","EUR","29,80","0,00","29,80",,"","0,00","7TN23828W9419940V",""
"24/08/2024","01:48:22","PDT","TuneCore","PreApproved Payment Bill User Payment","Completed","USD","-17,55","0,00","-17,55",,"","-17,55","1BK66290GA600994J",""
"24/08/2024","01:48:22","PDT","","General Card Deposit","Completed","USD","17,55","0,00","17,55",,"","0,00","16P85763T06758907",""
"24/08/2024","05:20:41","PDT","Uber Payments BV","PreApproved Payment Bill User Payment","Completed","EUR","-33,40","0,00","-33,40",,"","-33,40","23061511PJ320714T",""
"24/08/2024","05:20:41","PDT","","General Card Deposit","Completed","EUR","33,40","0,00","33,40",,"","0,00","9X911441YW2307300",""
"25/08/2024","15:01:34","PDT","Pedro del Hierro (Tendam Retail SA)","Express Checkout Payment","Completed","EUR","-39,99","0,00","-39,99",,"","-39,99","0KR02125ER439803A",""
"25/08/2024","15:01:34","PDT","","General Card Deposit","Completed","EUR","39,99","0,00","39,99",,"","0,00","8UW87256025657209",""
"27/08/2024","04:49:42","PDT","Uber Payments BV","PreApproved Payment Bill User Payment","Completed","EUR","-19,90","0,00","-19,90",,"","-19,90","1WV80604X87350948",""
"27/08/2024","04:49:42","PDT","","General Card Deposit","Completed","EUR","19,90","0,00","19,90",,"","0,00","95C78744UT5148112",""
"27/08/2024","09:11:45","PDT","Waves, Inc.","Express Checkout Payment","Completed","USD","-59,98","0,00","-59,98",,"","-59,98","5YU650363U912544V",""
"27/08/2024","09:11:45","PDT","","General Card Deposit","Completed","USD","59,98","0,00","59,98",,"","0,00","21G32233HA556623W",""
"28/08/2024","04:15:51","PDT","Sony Interactive Entertainment Network Europe Limited","PreApproved Payment Bill User Payment","Completed","EUR","-8,99","0,00","-8,99",,"","-8,99","7HR26084NP2578609",""
"28/08/2024","04:15:51","PDT","","General Card Deposit","Completed","EUR","8,99","0,00","8,99",,"","0,00","9AE822587R5912833",""
"28/08/2024","09:56:56","PDT","Mike Pachelli","Express Checkout Payment","Completed","USD","-8,00","0,00","-8,00",,"","-8,00","59129424E6789035A",""
"28/08/2024","09:56:56","PDT","","General Card Deposit","Completed","USD","8,00","0,00","8,00",,"","0,00","6AY98691S72526056",""
"28/08/2024","21:52:03","PDT","Apple Services","PreApproved Payment Bill User Payment","Completed","EUR","-5,49","0,00","-5,49",,"","-5,49","9JC71320DP389570Y",""
"28/08/2024","21:52:03","PDT","","General Card Deposit","Completed","EUR","5,49","0,00","5,49",,"","0,00","6YL16603SB470624K",""
"29/08/2024","05:12:22","PDT","Uber Payments BV","PreApproved Payment Bill User Payment","Completed","EUR","-29,80","0,00","-29,80",,"","-29,80","5TP63971SG562505E",""
"29/08/2024","05:12:22","PDT","","General Card Deposit","Completed","EUR","29,80","0,00","29,80",,"","0,00","6KL03029YR714551S",""
"29/08/2024","10:21:14","PDT","IP Development LLC","Express Checkout Payment","Completed","USD","-13,32","0,00","-13,32",,"","-13,32","39R40031YB584551U",""
"29/08/2024","10:21:14","PDT","","General Card Deposit","Completed","USD","13,32","0,00","13,32",,"","0,00","7TH66435T8543540K",""
"29/08/2024","18:55:24","PDT","Apple Services","PreApproved Payment Bill User Payment","Completed","EUR","-21,95","0,00","-21,95",,"","-21,95","3LD17744SA002844J",""
"29/08/2024","18:55:24","PDT","","General Card Deposit","Completed","EUR","21,95","0,00","21,95",,"","0,00","17V97303MS332045T",""
"30/08/2024","05:06:50","PDT","Uber Payments BV","PreApproved Payment Bill User Payment","Completed","EUR","-12,60","0,00","-12,60",,"","-12,60","4KL38251YJ327543D",""
"30/08/2024","05:06:50","PDT","","General Card Deposit","Completed","EUR","12,60","0,00","12,60",,"","0,00","3WY94148Y4032592A",""
"30/08/2024","13:27:09","PDT","Benetton Group Srl","Express Checkout Payment","Completed","EUR","-49,96","0,00","-49,96",,"","-49,96","6N6143051H749044C",""
"30/08/2024","13:27:09","PDT","","General Card Deposit","Completed","EUR","49,96","0,00","49,96",,"","0,00","8FL51364JW930823N",""
"03/09/2024","00:43:51","PDT","El Corte Inglés, Grandes Armazéns, S.A.","Express Checkout Payment","Completed","EUR","-26,90","0,00","-26,90",,"","-26,90","8FD65825K23799625",""
"03/09/2024","00:43:51","PDT","","General Card Deposit","Completed","EUR","26,90","0,00","26,90",,"","0,00","8DK83264T66753713",""
"05/09/2024","05:26:44","PDT","Uber Payments BV","PreApproved Payment Bill User Payment","Completed","EUR","-39,70","0,00","-39,70",,"","-39,70","77N14497XF208561M",""
"05/09/2024","05:26:44","PDT","","General Card Deposit","Completed","EUR","39,70","0,00","39,70",,"","0,00","5EG88434SA5903501",""
"10/09/2024","05:04:42","PDT","Uber Payments BV","PreApproved Payment Bill User Payment","Completed","EUR","-16,10","0,00","-16,10",,"","-16,10","92D11871T89194107",""
"10/09/2024","05:04:42","PDT","","General Card Deposit","Completed","EUR","16,10","0,00","16,10",,"","0,00","1RU246141A426273B",""
"12/09/2024","05:10:02","PDT","Uber Payments BV","PreApproved Payment Bill User Payment","Completed","EUR","-39,70","0,00","-39,70",,"","-39,70","56054998GX308560M",""
"12/09/2024","05:10:02","PDT","","General Card Deposit","Completed","EUR","39,70","0,00","39,70",,"","0,00","3TD79710FS638274A",""
"13/09/2024","14:42:11","PDT","Apple Services","PreApproved Payment Bill User Payment","Completed","EUR","-3,99","0,00","-3,99",,"","-3,99","8B6369599F737982L",""
"13/09/2024","14:42:11","PDT","","General Card Deposit","Completed","EUR","3,99","0,00","3,99",,"","0,00","2S432030E72784605",""
"15/09/2024","06:42:04","PDT","Uber Payments BV","PreApproved Payment Bill User Payment","Completed","EUR","-13,50","0,00","-13,50",,"","-13,50","0NG28445HG031584L",""
"15/09/2024","06:42:04","PDT","","General Card Deposit","Completed","EUR","13,50","0,00","13,50",,"","0,00","5BR17166NK6226343",""
"17/09/2024","13:40:57","PDT","Google","PreApproved Payment Bill User Payment","Completed","EUR","-8,49","0,00","-8,49",,"","-8,49","4NG7755387897543W",""
"17/09/2024","13:40:57","PDT","","General Card Deposit","Completed","EUR","8,49","0,00","8,49",,"","0,00","4RD14429B4855600K",""
"19/09/2024","00:35:15","PDT","Benetton Group Srl","Payment Refund","Completed","EUR","24,98","0,00","24,98",,"","24,98","4GC30475TD721432E",""
"19/09/2024","00:35:15","PDT","","General Card Withdrawal","Completed","EUR","-24,98","0,00","-24,98",,"","0,00","7D463476J4664944E",""
"19/09/2024","05:33:51","PDT","Uber Payments BV","PreApproved Payment Bill User Payment","Completed","EUR","-17,20","0,00","-17,20",,"","-17,20","7E4721865M814552S",""
"19/09/2024","05:33:51","PDT","","General Card Deposit","Completed","EUR","17,20","0,00","17,20",,"","0,00","7W229157WS6941053",""
"20/09/2024","05:10:08","PDT","Uber BV","PreApproved Payment Bill User Payment","Completed","EUR","-4,99","0,00","-4,99",,"","-4,99","6P806895SF500012A",""
"20/09/2024","05:10:08","PDT","","General Card Deposit","Completed","EUR","4,99","0,00","4,99",,"","0,00","7TH5218228715851W",""
"20/09/2024","05:23:09","PDT","Uber Payments BV","PreApproved Payment Bill User Payment","Completed","EUR","-19,90","0,00","-19,90",,"","-19,90","3DE09379BL8926031",""
"20/09/2024","05:23:09","PDT","","General Card Deposit","Completed","EUR","19,90","0,00","19,90",,"","0,00","36G12844S30651426",""
"20/09/2024","13:01:03","PDT","Apple Services","PreApproved Payment Bill User Payment","Completed","EUR","-8,99","0,00","-8,99",,"","-8,99","2W606671SF819693K",""
"20/09/2024","13:01:03","PDT","","General Card Deposit","Completed","EUR","8,99","0,00","8,99",,"","0,00","9UV25869HG468762K",""
"22/09/2024","05:06:13","PDT","Uber Payments BV","PreApproved Payment Bill User Payment","Completed","EUR","-25,20","0,00","-25,20",,"","-25,20","7EX381682Y090625F",""
"22/09/2024","05:06:13","PDT","","General Card Deposit","Completed","EUR","25,20","0,00","25,20",,"","0,00","8P022286WD6768901",""
"23/09/2024","00:17:59","PDT","Google","PreApproved Payment Bill User Payment","Completed","EUR","-6,04","0,00","-6,04",,"","-6,04","7PP07650AG2958108",""
"23/09/2024","00:17:59","PDT","","General Card Deposit","Completed","EUR","6,04","0,00","6,04",,"","0,00","906968411R348671F",""
"26/09/2024","01:28:19","PDT","GitHub, Inc.","PreApproved Payment Bill User Payment","Completed","USD","-3,33","0,00","-3,33",,"","-3,33","6W787447Y2526093T",""
"26/09/2024","01:28:19","PDT","","General Card Deposit","Completed","USD","3,33","0,00","3,33",,"","0,00","00V436562A446650S",""
"26/09/2024","05:27:06","PDT","Uber Payments BV","PreApproved Payment Bill User Payment","Completed","EUR","-29,80","0,00","-29,80",,"","-29,80","43F30127RP767421D",""
"26/09/2024","05:27:06","PDT","","General Card Deposit","Completed","EUR","29,80","0,00","29,80",,"","0,00","5V4469742B7264406",""
"28/09/2024","04:15:47","PDT","Sony Interactive Entertainment Network Europe Limited","PreApproved Payment Bill User Payment","Completed","EUR","-8,99","0,00","-8,99",,"","-8,99","7UV99290P1887344D",""
"28/09/2024","04:15:47","PDT","","General Card Deposit","Completed","EUR","8,99","0,00","8,99",,"","0,00","93C55182XC2541201",""
"28/09/2024","21:53:01","PDT","Apple Services","PreApproved Payment Bill User Payment","Completed","EUR","-5,49","0,00","-5,49",,"","-5,49","8AN15393LP493021J",""
"28/09/2024","21:53:01","PDT","","General Card Deposit","Completed","EUR","5,49","0,00","5,49",,"","0,00","8UF18461HM5304630",""
"29/09/2024","05:48:20","PDT","Uber Payments BV","PreApproved Payment Bill User Payment","Completed","EUR","-34,59","0,00","-34,59",,"","-34,59","247878522E215845E",""
"29/09/2024","05:48:20","PDT","","General Card Deposit","Completed","EUR","34,59","0,00","34,59",,"","0,00","06309787V0394553K",""
"29/09/2024","18:53:45","PDT","Apple Services","PreApproved Payment Bill User Payment","Completed","EUR","-21,95","0,00","-21,95",,"","-21,95","15S96700WF686443S",""
"29/09/2024","18:53:45","PDT","","General Card Deposit","Completed","EUR","21,95","0,00","21,95",,"","0,00","8JM93067822551351",""
"30/09/2024","07:58:39","PDT","CALZEDONIA PORTUGAL LDA","Express Checkout Payment","Completed","EUR","-15,98","0,00","-15,98",,"","-15,98","15754486GF653152L",""
"30/09/2024","07:58:39","PDT","","General Card Deposit","Completed","EUR","15,98","0,00","15,98",,"","0,00","2U443298RU578235P",""
"01/10/2024","05:05:30","PDT","Uber Payments BV","PreApproved Payment Bill User Payment","Completed","EUR","-17,71","0,00","-17,71",,"","-17,71","110267867B676151H",""
"01/10/2024","05:05:30","PDT","","General Card Deposit","Completed","EUR","17,71","0,00","17,71",,"","0,00","3U0773451F7256427",""
"03/10/2024","04:46:10","PDT","Uber Payments BV","PreApproved Payment Bill User Payment","Completed","EUR","-30,77","0,00","-30,77",,"","-30,77","39817074JT297970D",""
"03/10/2024","04:46:10","PDT","","General Card Deposit","Completed","EUR","30,77","0,00","30,77",,"","0,00","8PP01415BW1316108",""
"03/10/2024","07:28:30","PDT","FIVERR INTERNATIONAL LTD.","Express Checkout Payment","Completed","EUR","-32,97","0,00","-32,97",,"","-32,97","0BA907490R1299930",""
"03/10/2024","07:28:30","PDT","","General Card Deposit","Completed","EUR","32,97","0,00","32,97",,"","0,00","52E959127S391410L",""
"04/10/2024","08:58:32","PDT","FIVERR INTERNATIONAL LTD.","PreApproved Payment Bill User Payment","Completed","EUR","-125,55","0,00","-125,55",,"","-125,55","00K75218R0024474C",""
"04/10/2024","08:58:32","PDT","","General Card Deposit","Completed","EUR","125,55","0,00","125,55",,"","0,00","84U9667832305950P",""
"05/10/2024","04:49:15","PDT","Uber Payments BV","PreApproved Payment Bill User Payment","Completed","EUR","-15,65","0,00","-15,65",,"","-15,65","1PJ96961DL870561D",""
"05/10/2024","04:49:15","PDT","","General Card Deposit","Completed","EUR","15,65","0,00","15,65",,"","0,00","08K61025MP131981N",""
"06/10/2024","09:49:27","PDT","GitHub, Inc.","PreApproved Payment Bill User Payment","Completed","USD","-10,00","0,00","-10,00",,"","-10,00","3MS110929B976443F",""
"06/10/2024","09:49:27","PDT","","General Card Deposit","Completed","USD","10,00","0,00","10,00",,"","0,00","14L5765784184401H",""
"10/10/2024","05:00:54","PDT","Uber Payments BV","PreApproved Payment Bill User Payment","Completed","EUR","-30,77","0,00","-30,77",,"","-30,77","63M05466HP501525B",""
"10/10/2024","05:00:54","PDT","","General Card Deposit","Completed","EUR","30,77","0,00","30,77",,"","0,00","4XX676872K1810331",""
"12/10/2024","05:02:49","PDT","Uber Payments BV","PreApproved Payment Bill User Payment","Completed","EUR","-39,87","0,00","-39,87",,"","-39,87","38910273L19986937",""
"12/10/2024","05:02:49","PDT","","General Card Deposit","Completed","EUR","39,87","0,00","39,87",,"","0,00","0AH497088Y553160U",""
"17/10/2024","05:10:31","PDT","Uber Payments BV","PreApproved Payment Bill User Payment","Completed","EUR","-30,77","0,00","-30,77",,"","-30,77","6ML686926P501232X",""
"17/10/2024","05:10:31","PDT","","General Card Deposit","Completed","EUR","30,77","0,00","30,77",,"","0,00","9NM49625WC7264736",""
"18/10/2024","05:07:12","PDT","Uber Payments BV","PreApproved Payment Bill User Payment","Completed","EUR","-17,71","0,00","-17,71",,"","-17,71","3V7372219K621344R",""
"18/10/2024","05:07:12","PDT","","General Card Deposit","Completed","EUR","17,71","0,00","17,71",,"","0,00","7GA85055TY483094F",""
"18/10/2024","12:34:26","PDT","Uber Payments BV","PreApproved Payment Bill User Payment","Completed","EUR","-28,51","0,00","-28,51",,"","-28,51","63585083XE972014M",""
"18/10/2024","12:34:26","PDT","","General Card Deposit","Completed","EUR","28,51","0,00","28,51",,"","0,00","92676868BV390582P",""
"18/10/2024","13:34:41","PDT","Uber Payments BV","PreApproved Payment Bill User Payment","Completed","EUR","-2,98","0,00","-2,98",,"","-2,98","83312000HU3608434",""
"18/10/2024","13:34:41","PDT","","General Card Deposit","Completed","EUR","2,98","0,00","2,98",,"","0,00","9YT12842HA1868434",""
"19/10/2024","05:24:44","PDT","Uber Payments BV","PreApproved Payment Bill User Payment","Completed","EUR","-11,56","0,00","-11,56",,"","-11,56","38M40936G6741080A",""
"19/10/2024","05:24:44","PDT","","General Card Deposit","Completed","EUR","11,56","0,00","11,56",,"","0,00","0NG01685S6695135Y",""
"19/10/2024","13:19:23","PDT","Uber Payments BV","PreApproved Payment Bill User Payment","Completed","EUR","-27,32","0,00","-27,32",,"","-27,32","8L618159U7966113W",""
"19/10/2024","13:19:23","PDT","","General Card Deposit","Completed","EUR","27,32","0,00","27,32",,"","0,00","49R64327LL0819024",""
"20/10/2024","05:10:07","PDT","Uber BV","PreApproved Payment Bill User Payment","Completed","EUR","-4,99","0,00","-4,99",,"","-4,99","69G982953P159820E",""
"20/10/2024","05:10:07","PDT","","General Card Deposit","Completed","EUR","4,99","0,00","4,99",,"","0,00","4XY31942HR047593S",""
"20/10/2024","05:46:39","PDT","Uber Payments BV","PreApproved Payment Bill User Payment","Completed","EUR","-34,78","0,00","-34,78",,"","-34,78","4T804749DC735104M",""
"20/10/2024","05:46:39","PDT","","General Card Deposit","Completed","EUR","34,78","0,00","34,78",,"","0,00","62334266TS858232T",""
"21/10/2024","05:12:49","PDT","Uber Payments BV","PreApproved Payment Bill User Payment","Completed","EUR","-13,90","0,00","-13,90",,"","-13,90","77R03949WC755530C",""
"21/10/2024","05:12:49","PDT","","General Card Deposit","Completed","EUR","13,90","0,00","13,90",,"","0,00","68U17705VN667710N",""
"22/10/2024","23:58:35","PDT","Uber Payments BV","PreApproved Payment Bill User Payment","Completed","EUR","-12,82","0,00","-12,82",,"","-12,82","24R27319SV584031L",""
"22/10/2024","23:58:35","PDT","","General Card Deposit","Completed","EUR","12,82","0,00","12,82",,"","0,00","92L933797U522251Y",""
"23/10/2024","00:12:25","PDT","Google","PreApproved Payment Bill User Payment","Completed","EUR","-12,99","0,00","-12,99",,"","-12,99","6M514427TM4981643",""
"23/10/2024","00:12:25","PDT","","General Card Deposit","Completed","EUR","12,99","0,00","12,99",,"","0,00","12952395KA5467539",""
"24/10/2024","05:21:10","PDT","Uber Payments BV","PreApproved Payment Bill User Payment","Completed","EUR","-30,17","0,00","-30,17",,"","-30,17","38G408546B119863V",""
"24/10/2024","05:21:10","PDT","","General Card Deposit","Completed","EUR","30,17","0,00","30,17",,"","0,00","2YH95460DP588580R",""
"24/10/2024","05:23:17","PDT","Google Payment Ireland Limited","PreApproved Payment Bill User Payment","Completed","EUR","-2,99","0,00","-2,99",,"","-2,99","7LD29978FY355350N",""
"24/10/2024","05:23:17","PDT","","General Card Deposit","Completed","EUR","2,99","0,00","2,99",,"","0,00","1U69903770417370N",""
"28/10/2024","04:16:09","PDT","Sony Interactive Entertainment Network Europe Limited","PreApproved Payment Bill User Payment","Completed","EUR","-8,99","0,00","-8,99",,"","-8,99","84X79809R6513440R",""
"28/10/2024","04:16:09","PDT","","General Card Deposit","Completed","EUR","8,99","0,00","8,99",,"","0,00","35H35933PG945632B",""
"28/10/2024","21:52:13","PDT","Apple Services","PreApproved Payment Bill User Payment","Completed","EUR","-5,49","0,00","-5,49",,"","-5,49","70K1238971094750E",""
"28/10/2024","21:52:13","PDT","","General Card Deposit","Completed","EUR","5,49","0,00","5,49",,"","0,00","16A86212SR1252113",""
"29/10/2024","06:11:49","PDT","Uber Payments BV","PreApproved Payment Bill User Payment","Completed","EUR","-34,21","0,00","-34,21",,"","-34,21","4LU34962UM0960723",""
"29/10/2024","06:11:49","PDT","","General Card Deposit","Completed","EUR","34,21","0,00","34,21",,"","0,00","2MS81309WE1690348",""
"29/10/2024","14:05:29","PDT","Uber Payments BV","PreApproved Payment Bill User Payment","Completed","EUR","-18,75","0,00","-18,75",,"","-18,75","9TH69373E1876470X",""
"29/10/2024","14:05:29","PDT","","General Card Deposit","Completed","EUR","18,75","0,00","18,75",,"","0,00","56R722642A4777343",""
"29/10/2024","18:54:13","PDT","Apple Services","PreApproved Payment Bill User Payment","Completed","EUR","-21,95","0,00","-21,95",,"","-21,95","05X737865W5173645",""
"29/10/2024","18:54:13","PDT","","General Card Deposit","Completed","EUR","21,95","0,00","21,95",,"","0,00","9LF0540054912711V",""
"31/10/2024","06:19:13","PDT","Uber Payments BV","PreApproved Payment Bill User Payment","Completed","EUR","-30,77","0,00","-30,77",,"","-30,77","6TF35877D5076772C",""
"31/10/2024","06:19:13","PDT","","General Card Deposit","Completed","EUR","30,77","0,00","30,77",,"","0,00","5TT65317DE769664B",""
"31/10/2024","10:40:21","PDT","Sony Interactive Entertainment Network Europe Limited","PreApproved Payment Bill User Payment","Completed","EUR","-79,99","0,00","-79,99",,"","-79,99","9JK85386TT195580L",""
"31/10/2024","10:40:21","PDT","","General Card Deposit","Completed","EUR","79,99","0,00","79,99",,"","0,00","1B088370A0458731R",""
"31/10/2024","17:45:51","PDT","Paddle.net","PreApproved Payment Bill User Payment","Completed","EUR","-39,95","0,00","-39,95",,"","-39,95","2PR97549MB9670309",""
"31/10/2024","17:45:51","PDT","","General Card Deposit","Completed","EUR","39,95","0,00","39,95",,"","0,00","2CD59924U2125674U",""
"03/11/2024","05:12:19","PST","Uber Payments BV","PreApproved Payment Bill User Payment","Completed","EUR","-31,29","0,00","-31,29",,"","-31,29","73J31267NL2873748",""
"03/11/2024","05:12:19","PST","","General Card Deposit","Completed","EUR","31,29","0,00","31,29",,"","0,00","9N273630X2769802T",""
"03/11/2024","05:35:25","PST","Uber Payments BV","Payment Refund","Completed","EUR","5,72","0,00","5,72",,"","5,72","3NR482633H165723E",""
"03/11/2024","05:35:25","PST","","General Card Withdrawal","Completed","EUR","-5,72","0,00","-5,72",,"","0,00","9VJ741775V984251D",""
"05/11/2024","11:18:15","PST","Waves, Inc.","Express Checkout Payment","Completed","USD","-29,99","0,00","-29,99",,"","-29,99","0R1504745G9614050",""
"05/11/2024","11:18:15","PST","","General Card Deposit","Completed","USD","29,99","0,00","29,99",,"","0,00","717672816Y9367313",""
"06/11/2024","10:02:50","PST","GitHub, Inc.","PreApproved Payment Bill User Payment","Completed","USD","-10,00","0,00","-10,00",,"","-10,00","91B68562CM906651U",""
"06/11/2024","10:02:50","PST","","General Card Deposit","Completed","USD","10,00","0,00","10,00",,"","0,00","9B0214386T059951R",""
"07/11/2024","00:28:58","PST","Secretlab NL B.V.","Express Checkout Payment","Completed","EUR","-27,90","0,00","-27,90",,"","-27,90","968250085V7488327",""
"07/11/2024","00:28:58","PST","","General Card Deposit","Completed","EUR","27,90","0,00","27,90",,"","0,00","4N478481NS362653E",""
"07/11/2024","05:11:34","PST","Uber Payments BV","PreApproved Payment Bill User Payment","Completed","EUR","-20,50","0,00","-20,50",,"","-20,50","2ML05080F5675474R",""
"07/11/2024","05:11:34","PST","","General Card Deposit","Completed","EUR","20,50","0,00","20,50",,"","0,00","2DJ301107W611145N",""
"09/11/2024","05:03:22","PST","Uber Payments BV","PreApproved Payment Bill User Payment","Completed","EUR","-34,21","0,00","-34,21",,"","-34,21","7CT97037Y74333608",""
"09/11/2024","05:03:22","PST","","General Card Deposit","Completed","EUR","34,21","0,00","34,21",,"","0,00","9DT83265GL878211Y",""
"14/11/2024","05:07:22","PST","Uber Payments BV","PreApproved Payment Bill User Payment","Completed","EUR","-30,77","0,00","-30,77",,"","-30,77","4TF92435NR919461K",""
"14/11/2024","05:07:22","PST","","General Card Deposit","Completed","EUR","30,77","0,00","30,77",,"","0,00","6D559488TM2905200",""
"20/11/2024","04:10:08","PST","Uber BV","PreApproved Payment Bill User Payment","Completed","EUR","-4,99","0,00","-4,99",,"","-4,99","02A94971XC044193X",""
"20/11/2024","04:10:08","PST","","General Card Deposit","Completed","EUR","4,99","0,00","4,99",,"","0,00","8BK24664US0448412",""
"20/11/2024","05:22:56","PST","Uber Payments BV","PreApproved Payment Bill User Payment","Completed","EUR","-17,71","0,00","-17,71",,"","-17,71","9NU94905VL570380C",""
"20/11/2024","05:22:56","PST","","General Card Deposit","Completed","EUR","17,71","0,00","17,71",,"","0,00","77Y45800R73933255",""
"22/11/2024","05:27:43","PST","Uber Payments BV","PreApproved Payment Bill User Payment","Completed","EUR","-20,50","0,00","-20,50",,"","-20,50","7KH45447L4037540T",""
"22/11/2024","05:27:43","PST","","General Card Deposit","Completed","EUR","20,50","0,00","20,50",,"","0,00","247782070C897561W",""
"23/11/2024","00:12:25","PST","Google","PreApproved Payment Bill User Payment","Completed","EUR","-12,99","0,00","-12,99",,"","-12,99","7JM96358GD801683T",""
"23/11/2024","00:12:25","PST","","General Card Deposit","Completed","EUR","12,99","0,00","12,99",,"","0,00","5GV41072G6673573G",""
"23/11/2024","05:20:31","PST","Uber Payments BV","PreApproved Payment Bill User Payment","Completed","EUR","-16,37","0,00","-16,37",,"","-16,37","62R48013K06289905",""
"23/11/2024","05:20:31","PST","","General Card Deposit","Completed","EUR","16,37","0,00","16,37",,"","0,00","3S729595EP5690321",""
"24/11/2024","05:36:17","PST","Uber Payments BV","PreApproved Payment Bill User Payment","Completed","EUR","-23,17","0,00","-23,17",,"","-23,17","4G140656NV9472057",""
"24/11/2024","05:36:17","PST","","General Card Deposit","Completed","EUR","23,17","0,00","23,17",,"","0,00","53948809H94878948",""
"24/11/2024","12:10:13","PST","TuneCore","PreApproved Payment Bill User Payment","Completed","USD","-46,80","0,00","-46,80",,"","-46,80","0475551181513734U",""
"24/11/2024","12:10:13","PST","","General Card Deposit","Completed","USD","46,80","0,00","46,80",,"","0,00","42A63698YY098664H",""
"25/11/2024","14:50:58","PST","OT Distribution GmbH & Co KG","Express Checkout Payment","Completed","EUR","-1,23","0,00","-1,23",,"","-1,23","0CU94947VL906801L",""
"25/11/2024","14:50:58","PST","","General Card Deposit","Completed","EUR","1,23","0,00","1,23",,"","0,00","2SB552113M490000D",""
"28/11/2024","03:16:06","PST","Sony Interactive Entertainment Network Europe Limited","PreApproved Payment Bill User Payment","Completed","EUR","-8,99","0,00","-8,99",,"","-8,99","0YE87131SV8334924",""
"28/11/2024","03:16:06","PST","","General Card Deposit","Completed","EUR","8,99","0,00","8,99",,"","0,00","2WJ95040DG868113G",""
"28/11/2024","05:19:01","PST","Uber Payments BV","PreApproved Payment Bill User Payment","Completed","EUR","-30,77","0,00","-30,77",,"","-30,77","10X68446199118207",""
"28/11/2024","05:19:01","PST","","General Card Deposit","Completed","EUR","30,77","0,00","30,77",,"","0,00","14N681553P4224346",""
"28/11/2024","21:52:06","PST","Apple Services","PreApproved Payment Bill User Payment","Completed","EUR","-5,49","0,00","-5,49",,"","-5,49","3RT27678WS720935G",""
"28/11/2024","21:52:06","PST","","General Card Deposit","Completed","EUR","5,49","0,00","5,49",,"","0,00","6RH13557RK748872N",""
"29/11/2024","18:57:45","PST","Apple Services","PreApproved Payment Bill User Payment","Completed","EUR","-21,95","0,00","-21,95",,"","-21,95","5BU83289B0429600N",""
"29/11/2024","18:57:45","PST","","General Card Deposit","Completed","EUR","21,95","0,00","21,95",,"","0,00","38588128XG373593L",""
"30/11/2024","05:08:55","PST","Uber Payments BV","PreApproved Payment Bill User Payment","Completed","EUR","-14,67","0,00","-14,67",,"","-14,67","5BP44328MN8792506",""
"30/11/2024","05:08:55","PST","","General Card Deposit","Completed","EUR","14,67","0,00","14,67",,"","0,00","2E137191CC0182743",""
"01/12/2024","05:08:11","PST","Uber Payments BV","PreApproved Payment Bill User Payment","Completed","EUR","-39,27","0,00","-39,27",,"","-39,27","57986142TP158633G",""
"01/12/2024","05:08:11","PST","","General Card Deposit","Completed","EUR","39,27","0,00","39,27",,"","0,00","1TU6629391406474C",""
"05/12/2024","05:28:21","PST","Uber Payments BV","PreApproved Payment Bill User Payment","Completed","EUR","-30,77","0,00","-30,77",,"","-30,77","6SG28942VW2956034",""
"05/12/2024","05:28:21","PST","","General Card Deposit","Completed","EUR","30,77","0,00","30,77",,"","0,00","2P011351T1356462J",""
"06/12/2024","05:09:37","PST","Uber Payments BV","PreApproved Payment Bill User Payment","Completed","EUR","-35,31","0,00","-35,31",,"","-35,31","7RC28426C0383602J",""
"06/12/2024","05:09:37","PST","","General Card Deposit","Completed","EUR","35,31","0,00","35,31",,"","0,00","36C009135V062545W",""
"06/12/2024","14:34:13","PST","Apple Services","PreApproved Payment Bill User Payment","Completed","EUR","-3,99","0,00","-3,99",,"","-3,99","91707051JK5729217",""
"06/12/2024","14:34:13","PST","","General Card Deposit","Completed","EUR","3,99","0,00","3,99",,"","0,00","81M81080PT4809911",""
"11/12/2024","14:57:53","PST","Sony Interactive Entertainment Network Europe Limited","PreApproved Payment Bill User Payment","Completed","EUR","-39,99","0,00","-39,99",,"","-39,99","41612071CY520534C",""
"11/12/2024","14:57:53","PST","","General Card Deposit","Completed","EUR","39,99","0,00","39,99",,"","0,00","905073076F625473A",""
"12/12/2024","05:28:14","PST","Uber Payments BV","PreApproved Payment Bill User Payment","Completed","EUR","-30,77","0,00","-30,77",,"","-30,77","69S5400471680172C",""
"12/12/2024","05:28:14","PST","","General Card Deposit","Completed","EUR","30,77","0,00","30,77",,"","0,00","2DS628743D5299943",""
"12/12/2024","06:29:00","PST","Uber Payments BV","PreApproved Payment Bill User Payment","Completed","EUR","-5,94","0,00","-5,94",,"","-5,94","3US75362WV4684144",""
"12/12/2024","06:29:00","PST","","General Card Deposit","Completed","EUR","5,94","0,00","5,94",,"","0,00","47C69059VE809914J",""
"15/12/2024","07:22:57","PST","Uber Payments BV","PreApproved Payment Bill User Payment","Completed","EUR","-50,99","0,00","-50,99",,"","-50,99","6FL396167R259762V",""
"15/12/2024","07:22:57","PST","","General Card Deposit","Completed","EUR","50,99","0,00","50,99",,"","0,00","7N7139534L715714R",""
"15/12/2024","08:23:34","PST","Uber Payments BV","PreApproved Payment Bill User Payment","Completed","EUR","-2,00","0,00","-2,00",,"","-2,00","16W3998332566683P",""
"15/12/2024","08:23:34","PST","","General Card Deposit","Completed","EUR","2,00","0,00","2,00",,"","0,00","2W25820653188700U",""
"16/12/2024","07:43:48","PST","Apple Services","PreApproved Payment Bill User Payment","Completed","EUR","-30,99","0,00","-30,99",,"","-30,99","6S030918272104148",""
"16/12/2024","07:43:48","PST","","General Card Deposit","Completed","EUR","30,99","0,00","30,99",,"","0,00","9P421849TD269600L",""
"16/12/2024","10:13:04","PST","Uber Payments BV","PreApproved Payment Bill User Payment","Completed","EUR","-11,28","0,00","-11,28",,"","-11,28","4PG18266SX015423D",""
"16/12/2024","10:13:04","PST","","General Card Deposit","Completed","EUR","11,28","0,00","11,28",,"","0,00","2CG78191HB2824620",""
"16/12/2024","14:22:13","PST","Uber Payments BV","PreApproved Payment Bill User Payment","Completed","EUR","-19,72","0,00","-19,72",,"","-19,72","8XR10895UC9714518",""
"16/12/2024","14:22:13","PST","","General Card Deposit","Completed","EUR","19,72","0,00","19,72",,"","0,00","7BV26415D5885310D",""
"16/12/2024","15:58:56","PST","Martina Fink","Mobile Payment","Completed","EUR","-50,00","0,00","-50,00",,"","-50,00","39X91471HS340960K",""
"16/12/2024","15:58:56","PST","","General Card Deposit","Completed","EUR","50,00","0,00","50,00",,"","0,00","3CS370066K4390920",""
"17/12/2024","07:35:47","PST","Uber Payments BV","PreApproved Payment Bill User Payment","Completed","EUR","-11,00","0,00","-11,00",,"","-11,00","0TF90072A0378342A",""
"17/12/2024","07:35:47","PST","","General Card Deposit","Completed","EUR","11,00","0,00","11,00",,"","0,00","6HT11073T9984645L",""
"17/12/2024","14:40:59","PST","Uber Payments BV","PreApproved Payment Bill User Payment","Completed","EUR","-12,50","0,00","-12,50",,"","-12,50","3FE35026AX230730S",""
"17/12/2024","14:40:59","PST","","General Card Deposit","Completed","EUR","12,50","0,00","12,50",,"","0,00","2BX38787R1932444M",""
"18/12/2024","00:35:12","PST","Uber Payments BV","PreApproved Payment Bill User Payment","Completed","EUR","-46,32","0,00","-46,32",,"","-46,32","6DH09103U5057601F",""
"18/12/2024","00:35:12","PST","","General Card Deposit","Completed","EUR","46,32","0,00","46,32",,"","0,00","1FG415641T378670N",""
"19/12/2024","05:19:29","PST","Uber Payments BV","PreApproved Payment Bill User Payment","Completed","EUR","-30,77","0,00","-30,77",,"","-30,77","3EU68150A8394902E",""
"19/12/2024","05:19:29","PST","","General Card Deposit","Completed","EUR","30,77","0,00","30,77",,"","0,00","8GJ97849UW633381R",""
"19/12/2024","06:19:42","PST","Uber Payments BV","PreApproved Payment Bill User Payment","Completed","EUR","-4,46","0,00","-4,46",,"","-4,46","90091382RE406612T",""
"19/12/2024","06:19:42","PST","","General Card Deposit","Completed","EUR","4,46","0,00","4,46",,"","0,00","7M088430V9012443M",""
"20/12/2024","04:10:08","PST","Uber BV","PreApproved Payment Bill User Payment","Completed","EUR","-4,99","0,00","-4,99",,"","-4,99","09L66420K46113701",""
"20/12/2024","04:10:08","PST","","General Card Deposit","Completed","EUR","4,99","0,00","4,99",,"","0,00","3JP64536FA114304W",""
"20/12/2024","08:26:48","PST","Sony Interactive Entertainment Network Europe Limited","PreApproved Payment Bill User Payment","Completed","EUR","-3,99","0,00","-3,99",,"","-3,99","6RB18626VF021620B",""
"20/12/2024","08:26:48","PST","","General Card Deposit","Completed","EUR","3,99","0,00","3,99",,"","0,00","8HU02035U1468802M",""
"20/12/2024","08:53:31","PST","www.steampowered.com","Express Checkout Payment","Completed","EUR","-4,47","0,00","-4,47",,"","-4,47","91280883DU390320C",""
"20/12/2024","08:53:31","PST","","General Card Deposit","Completed","EUR","4,47","0,00","4,47",,"","0,00","4JR69988KU148812L",""
"22/12/2024","01:29:16","PST","MasterClass","PreApproved Payment Bill User Payment","Completed","EUR","-96,00","0,00","-96,00",,"","-96,00","16339114LS901051F",""
"22/12/2024","01:29:16","PST","","General Card Deposit","Completed","EUR","96,00","0,00","96,00",,"","0,00","8JA98440DB977974K",""
"23/12/2024","00:12:25","PST","Google","PreApproved Payment Bill User Payment","Completed","EUR","-17,99","0,00","-17,99",,"","-17,99","64258706S9812603S",""
"23/12/2024","00:12:25","PST","","General Card Deposit","Completed","EUR","17,99","0,00","17,99",,"","0,00","19S49112K5854305J",""
"25/12/2024","02:10:00","PST","Spitfire Audio Holdings Limited","Express Checkout Payment","Completed","EUR","-269,00","0,00","-269,00",,"","-269,00","9XS296959C9872207",""
"25/12/2024","02:10:00","PST","","General Card Deposit","Completed","EUR","269,00","0,00","269,00",,"","0,00","6HL16141Y7335141E",""
"26/12/2024","05:10:50","PST","Uber Payments BV","PreApproved Payment Bill User Payment","Completed","EUR","-30,77","0,00","-30,77",,"","-30,77","69U59085DM2702735",""
"26/12/2024","05:10:50","PST","","General Card Deposit","Completed","EUR","30,77","0,00","30,77",,"","0,00","2FT97521N1755311R",""
"27/12/2024","15:48:58","PST","Spitfire Audio Holdings Limited","Express Checkout Payment","Completed","EUR","-17,00","0,00","-17,00",,"","-17,00","9RF10489AF3064008",""
"27/12/2024","15:48:58","PST","","General Card Deposit","Completed","EUR","17,00","0,00","17,00",,"","0,00","7H761679UV177181E",""
"28/12/2024","03:16:24","PST","Sony Interactive Entertainment Network Europe Limited","PreApproved Payment Bill User Payment","Completed","EUR","-8,99","0,00","-8,99",,"","-8,99","8GJ00402XM1288337",""
"28/12/2024","03:16:24","PST","","General Card Deposit","Completed","EUR","8,99","0,00","8,99",,"","0,00","21C90178VU013794Y",""
"28/12/2024","21:52:01","PST","Apple Services","PreApproved Payment Bill User Payment","Completed","EUR","-5,49","0,00","-5,49",,"","-5,49","4KE3297304924504H",""
"28/12/2024","21:52:01","PST","","General Card Deposit","Completed","EUR","5,49","0,00","5,49",,"","0,00","02966850X3031483C",""
"29/12/2024","18:53:42","PST","Apple Services","PreApproved Payment Bill User Payment","Completed","EUR","-21,95","0,00","-21,95",,"","-21,95","6EE865583W000642D",""
"29/12/2024","18:53:42","PST","","General Card Deposit","Completed","EUR","21,95","0,00","21,95",,"","0,00","28411522F7583752M",""
"30/12/2024","05:13:12","PST","Uber Payments BV","PreApproved Payment Bill User Payment","Completed","EUR","-17,71","0,00","-17,71",,"","-17,71","2M313413TE021120T",""
"30/12/2024","05:13:12","PST","","General Card Deposit","Completed","EUR","17,71","0,00","17,71",,"","0,00","4CA05810VB5779019",""
"30/12/2024","12:56:11","PST","Uber Payments BV","PreApproved Payment Bill User Payment","Completed","EUR","-18,53","0,00","-18,53",,"","-18,53","9FR66078LN939504G",""
"30/12/2024","12:56:11","PST","","General Card Deposit","Completed","EUR","18,53","0,00","18,53",,"","0,00","5YC799725D305883D",""
