"Date","Time","TimeZone","Name","Type","Status","Currency","Amount","Fees","Total","Exchange Rate","Receipt ID","Balance","Transaction ID","Item Title"
"02/01/2023","00:28:49","PST","Uber Payments BV","PreApproved Payment Bill User Payment","Completed","EUR","-16,05","0,00","-16,05",,"","-16,05","65A97725BC430953B",""
"02/01/2023","00:28:49","PST","","General Card Deposit","Completed","EUR","16,05","0,00","16,05",,"","0,00","7DL87846Y6170350X",""
"02/01/2023","07:17:45","PST","Apple Services","PreApproved Payment Bill User Payment","Completed","EUR","-4,99","0,00","-4,99",,"","-4,99","1RJ22782YJ892244Y",""
"02/01/2023","07:17:45","PST","","General Card Deposit","Completed","EUR","4,99","0,00","4,99",,"","0,00","4R4497394U4958734",""
"05/01/2023","04:58:08","PST","Uber Payments BV","PreApproved Payment Bill User Payment","Completed","EUR","-33,67","0,00","-33,67",,"","-33,67","88N94943TU7711409",""
"05/01/2023","04:58:08","PST","","General Card Deposit","Completed","EUR","33,67","0,00","33,67",,"","0,00","24662454VR0232302",""
"05/01/2023","11:57:36","PST","Uber Payments BV","PreApproved Payment Bill User Payment","Completed","EUR","-27,37","0,00","-27,37",,"","-27,37","9RM70768G22537154",""
"05/01/2023","11:57:36","PST","","General Card Deposit","Completed","EUR","27,37","0,00","27,37",,"","0,00","0A637850HL7281357",""
"12/01/2023","02:22:41","PST","Uber Payments BV","PreApproved Payment Bill User Payment","Completed","EUR","-8,30","0,00","-8,30",,"","-8,30","1EJ20506F1129513X",""
"12/01/2023","02:22:41","PST","","General Card Deposit","Completed","EUR","8,30","0,00","8,30",,"","0,00","4LY81141C0550400X",""
"12/01/2023","03:00:03","PST","Uber Payments BV","PreApproved Payment Bill User Payment","Completed","EUR","-1,00","0,00","-1,00",,"","-1,00","1LM96302FE886515N",""
"12/01/2023","03:00:03","PST","","General Card Deposit","Completed","EUR","1,00","0,00","1,00",,"","0,00","3GF6569535194223L",""
"12/01/2023","03:18:17","PST","Uber Payments BV","PreApproved Payment Bill User Payment","Completed","EUR","-7,91","0,00","-7,91",,"","-7,91","18M74492W1826973U",""
"12/01/2023","03:18:17","PST","","General Card Deposit","Completed","EUR","7,91","0,00","7,91",,"","0,00","70H4170389102073T",""
"12/01/2023","03:20:29","PST","Uber Payments BV","PreApproved Payment Bill User Payment","Completed","EUR","-1,00","0,00","-1,00",,"","-1,00","4D09111474594450U",""
"12/01/2023","03:20:29","PST","","General Card Deposit","Completed","EUR","1,00","0,00","1,00",,"","0,00","9AX658267W7755427",""
"12/01/2023","05:14:50","PST","Uber Payments BV","PreApproved Payment Bill User Payment","Completed","EUR","-33,67","0,00","-33,67",,"","-33,67","6G196315WR949225H",""
"12/01/2023","05:14:50","PST","","General Card Deposit","Completed","EUR","33,67","0,00","33,67",,"","0,00","96G74516HP663080W",""
"15/01/2023","05:13:04","PST","Uber Payments BV","PreApproved Payment Bill User Payment","Completed","EUR","-33,19","0,00","-33,19",,"","-33,19","18A397650W875362W",""
"15/01/2023","05:13:04","PST","","General Card Deposit","Completed","EUR","33,19","0,00","33,19",,"","0,00","1GG94608V96213232",""
"15/01/2023","12:51:06","PST","Comité Português para a UNICEF","Express Checkout Payment","Completed","EUR","-100,00","0,00","-100,00",,"","-100,00","20D090764X613404W",""
"15/01/2023","12:51:06","PST","","General Card Deposit","Completed","GBP","93,41","0,00","93,41",,"","93,41","28067640E04115922",""
"15/01/2023","12:51:06","PST","","General Currency Conversion","Completed","GBP","-93,41","0,00","-93,41",1.070585590648533,"","0,00","3UK18508LX265420R",""
"15/01/2023","12:51:06","PST","","General Currency Conversion","Completed","EUR","100,00","0,00","100,00",,"","0,00","75Y1284664276004A",""
"17/01/2023","13:40:58","PST","Google","PreApproved Payment Bill User Payment","Completed","EUR","-8,49","0,00","-8,49",,"","-8,49","9XA13934YL079735V",""
"17/01/2023","13:40:58","PST","","General Card Deposit","Completed","EUR","8,49","0,00","8,49",,"","0,00","60L7497366565843A",""
"19/01/2023","05:26:36","PST","Uber Payments BV","PreApproved Payment Bill User Payment","Completed","EUR","-33,67","0,00","-33,67",,"","-33,67","3S058175DD5439407",""
"19/01/2023","05:26:36","PST","","General Card Deposit","Completed","EUR","33,67","0,00","33,67",,"","0,00","5YS47077H34107541",""
"19/01/2023","12:08:22","PST","Uber Payments BV","PreApproved Payment Bill User Payment","Completed","EUR","-48,99","0,00","-48,99",,"","-48,99","9K408590TC025540M",""
"19/01/2023","12:08:22","PST","","General Card Deposit","Completed","EUR","48,99","0,00","48,99",,"","0,00","57Y77001LV460913A",""
"19/01/2023","20:11:37","PST","Netflix.com","PreApproved Payment Bill User Payment","Completed","EUR","-15,99","0,00","-15,99",,"","-15,99","0SY46874NP7113320",""
"19/01/2023","20:11:37","PST","","General Card Deposit","Completed","EUR","15,99","0,00","15,99",,"","0,00","97424839ME010824L",""
"22/01/2023","07:03:08","PST","Apple Services","PreApproved Payment Bill User Payment","Completed","EUR","-2,99","0,00","-2,99",,"","-2,99","05U64581TA265032A",""
"22/01/2023","07:03:08","PST","","General Card Deposit","Completed","EUR","2,99","0,00","2,99",,"","0,00","44V034050R1569340",""
"26/01/2023","05:20:11","PST","Uber Payments BV","PreApproved Payment Bill User Payment","Completed","EUR","-33,67","0,00","-33,67",,"","-33,67","8AS99422CW021853H",""
"26/01/2023","05:20:11","PST","","General Card Deposit","Completed","EUR","33,67","0,00","33,67",,"","0,00","54472721PG593345R",""
"26/01/2023","16:32:47","PST","Apple Services","PreApproved Payment Bill User Payment","Completed","EUR","-1,99","0,00","-1,99",,"","-1,99","0TW61709YE3309046",""
"26/01/2023","16:32:47","PST","","General Card Deposit","Completed","EUR","1,99","0,00","1,99",,"","0,00","8K1276285W078005R",""
"26/01/2023","16:33:54","PST","Apple Services","PreApproved Payment Bill User Payment","Completed","EUR","-5,49","0,00","-5,49",,"","-5,49","7R295850LG081113T",""
"26/01/2023","16:33:54","PST","","General Card Deposit","Completed","EUR","5,49","0,00","5,49",,"","0,00","142130127V914141T",""
"28/01/2023","05:03:41","PST","Google Payment Ireland Ltd.","PreApproved Payment Bill User Payment","Completed","EUR","-2,99","0,00","-2,99",,"","-2,99","1LX19587M7744073M",""
"28/01/2023","05:03:41","PST","","General Card Deposit","Completed","EUR","2,99","0,00","2,99",,"","0,00","23906482LG020902R",""
"01/02/2023","12:13:51","PST","Uber Payments BV","PreApproved Payment Bill User Payment","Completed","EUR","-35,29","0,00","-35,29",,"","-35,29","8R483027LP735320H",""
"01/02/2023","12:13:51","PST","","General Card Deposit","Completed","EUR","35,29","0,00","35,29",,"","0,00","76K83381AX028045K",""
"12/02/2023","08:35:59","PST","Sony Interactive Entertainment Network Europe Limited","PreApproved Payment Bill User Payment","Completed","EUR","-9,99","0,00","-9,99",,"","-9,99","2L678500W44445128",""
"12/02/2023","08:35:59","PST","","General Card Deposit","Completed","EUR","9,99","0,00","9,99",,"","0,00","58447112B56169708",""
"12/02/2023","11:58:57","PST","Uber Payments BV","PreApproved Payment Bill User Payment","Completed","EUR","-14,40","0,00","-14,40",,"","-14,40","9AF38830590338515",""
"12/02/2023","11:58:57","PST","","General Card Deposit","Completed","EUR","14,40","0,00","14,40",,"","0,00","953015105J7801906",""
"13/02/2023","02:45:48","PST","Uber Payments BV","PreApproved Payment Bill User Payment","Completed","EUR","-7,63","0,00","-7,63",,"","-7,63","24640302D5074713B",""
"13/02/2023","02:45:48","PST","","General Card Deposit","Completed","EUR","7,63","0,00","7,63",,"","0,00","1GE21622PF987721A",""
"13/02/2023","04:03:36","PST","Uber Payments BV","PreApproved Payment Bill User Payment","Completed","EUR","-3,60","0,00","-3,60",,"","-3,60","2UD385375X7194223",""
"13/02/2023","04:03:36","PST","","General Card Deposit","Completed","EUR","3,60","0,00","3,60",,"","0,00","8WX143913S899502T",""
"13/02/2023","04:05:37","PST","Uber Payments BV","PreApproved Payment Bill User Payment","Completed","EUR","-0,50","0,00","-0,50",,"","-0,50","30Y393677J975425U",""
"13/02/2023","04:05:37","PST","","General Card Deposit","Completed","EUR","0,50","0,00","0,50",,"","0,00","47G51668BP475931A",""
"17/02/2023","10:51:20","PST","Uber Payments BV","PreApproved Payment Bill User Payment","Completed","EUR","-14,16","0,00","-14,16",,"","-14,16","7HT615823T525980X",""
"17/02/2023","10:51:20","PST","","General Card Deposit","Completed","EUR","14,16","0,00","14,16",,"","0,00","8VG021769Y4644352",""
"17/02/2023","13:40:58","PST","Google","PreApproved Payment Bill User Payment","Completed","EUR","-8,49","0,00","-8,49",,"","-8,49","7F098302LM948010N",""
"17/02/2023","13:40:58","PST","","General Card Deposit","Completed","EUR","8,49","0,00","8,49",,"","0,00","3M869021H9103610H",""
"19/02/2023","01:58:38","PST","Samsung Electrónica Portuguesa, Unipessoal Lda.","Express Checkout Payment","Completed","EUR","-15,55","0,00","-15,55",,"","-15,55","2FV36312ED5327916",""
"19/02/2023","01:58:38","PST","","General Card Deposit","Completed","EUR","15,55","0,00","15,55",,"","0,00","4FR54496FP089300V",""
"21/02/2023","06:11:46","PST","NOS Lusomundo Cinemas, S.A.","Express Checkout Payment","Completed","EUR","-15,00","0,00","-15,00",,"","-15,00","2L937243GL071781C",""
"21/02/2023","06:11:46","PST","","General Card Deposit","Completed","EUR","15,00","0,00","15,00",,"","0,00","7YB82655FW808772E",""
"22/02/2023","07:02:37","PST","Apple Services","PreApproved Payment Bill User Payment","Completed","EUR","-2,99","0,00","-2,99",,"","-2,99","4CS232948B9242001",""
"22/02/2023","07:02:37","PST","","General Card Deposit","Completed","EUR","2,99","0,00","2,99",,"","0,00","3WP83903XA2544428",""
"26/02/2023","12:16:39","PST","Apple Services","PreApproved Payment Bill User Payment","Completed","EUR","-1,99","0,00","-1,99",,"","-1,99","80724637572013425",""
"26/02/2023","12:16:39","PST","","General Card Deposit","Completed","EUR","1,99","0,00","1,99",,"","0,00","65Y745654F696221P",""
"26/02/2023","12:18:12","PST","Apple Services","PreApproved Payment Bill User Payment","Completed","EUR","-5,49","0,00","-5,49",,"","-5,49","84U040362A1961015",""
"26/02/2023","12:18:12","PST","","General Card Deposit","Completed","EUR","5,49","0,00","5,49",,"","0,00","8ML38993YF584330K",""
"28/02/2023","05:03:43","PST","Google Payment Ireland Limited","PreApproved Payment Bill User Payment","Completed","EUR","-2,99","0,00","-2,99",,"","-2,99","2HT96830040173942",""
"28/02/2023","05:03:43","PST","","General Card Deposit","Completed","EUR","2,99","0,00","2,99",,"","0,00","75A38318MT2651902",""
"02/03/2023","03:31:00","PST","Uber Payments BV","PreApproved Payment Bill User Payment","Completed","EUR","-9,51","0,00","-9,51",,"","-9,51","4BL00902C8398145M",""
"02/03/2023","03:31:00","PST","","General Card Deposit","Completed","EUR","9,51","0,00","9,51",,"","0,00","2YV8960016949084D",""
"02/03/2023","04:47:08","PST","Uber Payments BV","PreApproved Payment Bill User Payment","Completed","EUR","-8,98","0,00","-8,98",,"","-8,98","08K76769736601433",""
"02/03/2023","04:47:08","PST","","General Card Deposit","Completed","EUR","8,98","0,00","8,98",,"","0,00","0JH83049CY949563H",""
"02/03/2023","04:49:23","PST","Uber Payments BV","PreApproved Payment Bill User Payment","Completed","EUR","-1,00","0,00","-1,00",,"","-1,00","4TW88337XV0515706",""
"02/03/2023","04:49:23","PST","","General Card Deposit","Completed","EUR","1,00","0,00","1,00",,"","0,00","2BK49807DV5622313",""
"06/03/2023","08:58:03","PST","Uber Payments BV","PreApproved Payment Bill User Payment","Completed","EUR","-11,44","0,00","-11,44",,"","-11,44","99A3857439155840Y",""
"06/03/2023","08:58:03","PST","","General Card Deposit","Completed","EUR","11,44","0,00","11,44",,"","0,00","2V826217BT6977648",""
"07/03/2023","07:49:45","PST","NOS Lusomundo Cinemas, S.A.","Express Checkout Payment","Completed","EUR","-5,00","0,00","-5,00",,"","-5,00","28R94113TD666023K",""
"07/03/2023","07:49:45","PST","","General Card Deposit","Completed","EUR","5,00","0,00","5,00",,"","0,00","24098479TV358531Y",""
"09/03/2023","05:37:10","PST","Uber Payments BV","PreApproved Payment Bill User Payment","Completed","EUR","-17,05","0,00","-17,05",,"","-17,05","0TD83571RK142490Y",""
"09/03/2023","05:37:10","PST","","General Card Deposit","Completed","EUR","17,05","0,00","17,05",,"","0,00","2D227523EE955604K",""
"10/03/2023","12:14:47","PST","Uber Payments BV","PreApproved Payment Bill User Payment","Completed","EUR","-16,63","0,00","-16,63",,"","-16,63","03G8951379796323N",""
"10/03/2023","12:14:47","PST","","General Card Deposit","Completed","EUR","16,63","0,00","16,63",,"","0,00","5CB15826EA6894104",""
"14/03/2023","03:49:13","PDT","Uber Payments BV","PreApproved Payment Bill User Payment","Completed","EUR","-4,25","0,00","-4,25",,"","-4,25","4A1637715K175354B",""
"14/03/2023","03:49:13","PDT","","General Card Deposit","Completed","EUR","4,25","0,00","4,25",,"","0,00","4UJ62358RT487305C",""
"14/03/2023","03:49:20","PDT","Uber Payments BV","PreApproved Payment Bill User Payment","Completed","EUR","-0,50","0,00","-0,50",,"","-0,50","49K22088JL567672N",""
"14/03/2023","03:49:20","PDT","","General Card Deposit","Completed","EUR","0,50","0,00","0,50",,"","0,00","8ND08989WS876534P",""
"16/03/2023","06:27:17","PDT","Uber Payments BV","PreApproved Payment Bill User Payment","Completed","EUR","-17,05","0,00","-17,05",,"","-17,05","27Y1305282200921W",""
"16/03/2023","06:27:17","PDT","","General Card Deposit","Completed","EUR","17,05","0,00","17,05",,"","0,00","25C52448HM3625202",""
"17/03/2023","14:40:57","PDT","Google","PreApproved Payment Bill User Payment","Completed","EUR","-8,49","0,00","-8,49",,"","-8,49","88B570929Y255134B",""
"17/03/2023","14:40:57","PDT","","General Card Deposit","Completed","EUR","8,49","0,00","8,49",,"","0,00","3RV01583UE1176941",""
"18/03/2023","08:24:47","PDT","NOS Lusomundo Cinemas, S.A.","Express Checkout Payment","Completed","EUR","-15,00","0,00","-15,00",,"","-15,00","32265882W11096321",""
"18/03/2023","08:24:47","PDT","","General Card Deposit","Completed","EUR","15,00","0,00","15,00",,"","0,00","40092873HY308133F",""
"22/03/2023","07:02:32","PDT","Apple Services","PreApproved Payment Bill User Payment","Completed","EUR","-2,99","0,00","-2,99",,"","-2,99","5KM12553PJ987023M",""
"22/03/2023","07:02:32","PDT","","General Card Deposit","Completed","EUR","2,99","0,00","2,99",,"","0,00","5DB750638W7189209",""
"26/03/2023","16:32:24","PDT","Apple Services","PreApproved Payment Bill User Payment","Completed","EUR","-1,99","0,00","-1,99",,"","-1,99","74T57945FS2487807",""
"26/03/2023","16:32:24","PDT","","General Card Deposit","Completed","EUR","1,99","0,00","1,99",,"","0,00","4N3929471H6428437",""
"26/03/2023","16:33:32","PDT","Apple Services","PreApproved Payment Bill User Payment","Completed","EUR","-5,49","0,00","-5,49",,"","-5,49","76198013VS820105V",""
"26/03/2023","16:33:32","PDT","","General Card Deposit","Completed","EUR","5,49","0,00","5,49",,"","0,00","5YS665503D298591S",""
"28/03/2023","06:03:43","PDT","Google Payment Ireland Limited","PreApproved Payment Bill User Payment","Completed","EUR","-2,99","0,00","-2,99",,"","-2,99","6XX87971XS075432Y",""
"28/03/2023","06:03:43","PDT","","General Card Deposit","Completed","EUR","2,99","0,00","2,99",,"","0,00","70F077850V045034S",""
"28/03/2023","13:58:48","PDT","Apple Services","PreApproved Payment Bill User Payment","Completed","EUR","-6,99","0,00","-6,99",,"","-6,99","8MY4836140042984B",""
"28/03/2023","13:58:48","PDT","","General Card Deposit","Completed","EUR","6,99","0,00","6,99",,"","0,00","18G169345M7494116",""
"29/03/2023","03:32:59","PDT","Fnac Portugal","Express Checkout Payment","Completed","EUR","-59,99","0,00","-59,99",,"","-59,99","3J9993466D899300J",""
"29/03/2023","03:32:59","PDT","","General Card Deposit","Completed","EUR","59,99","0,00","59,99",,"","0,00","5YB50200JG160282C",""
"31/03/2023","12:08:08","PDT","Uber Payments BV","PreApproved Payment Bill User Payment","Completed","EUR","-16,50","0,00","-16,50",,"","-16,50","1YG01614DG217994P",""
"31/03/2023","12:08:08","PDT","","General Card Deposit","Completed","EUR","16,50","0,00","16,50",,"","0,00","36F01602KM3673525",""
"01/04/2023","05:12:32","PDT","Uber Payments BV","PreApproved Payment Bill User Payment","Completed","EUR","-17,05","0,00","-17,05",,"","-17,05","6TP77201UB9184004",""
"01/04/2023","05:12:32","PDT","","General Card Deposit","Completed","EUR","17,05","0,00","17,05",,"","0,00","8AH672569J955120J",""
"04/04/2023","01:15:55","PDT","Uber Payments BV","PreApproved Payment Bill User Payment","Completed","EUR","-12,59","0,00","-12,59",,"","-12,59","7F968349ET9669921",""
"04/04/2023","01:15:55","PDT","","General Card Deposit","Completed","EUR","12,59","0,00","12,59",,"","0,00","8GR62217U45227145",""
"04/04/2023","04:22:44","PDT","Uber Payments BV","PreApproved Payment Bill User Payment","Completed","EUR","-10,57","0,00","-10,57",,"","-10,57","0JY59005AN480953W",""
"04/04/2023","04:22:44","PDT","","General Card Deposit","Completed","EUR","10,57","0,00","10,57",,"","0,00","90F504727J406813X",""
"07/04/2023","12:49:49","PDT","Uber Payments BV","PreApproved Payment Bill User Payment","Completed","EUR","-43,69","0,00","-43,69",,"","-43,69","2JF52809TU7647935",""
"07/04/2023","12:49:49","PDT","","General Card Deposit","Completed","EUR","43,69","0,00","43,69",,"","0,00","9A72378766918125R",""
"08/04/2023","07:36:44","PDT","Google Payment Ireland Limited","PreApproved Payment Bill User Payment","Completed","EUR","-19,99","0,00","-19,99",,"","-19,99","5SG749690M1198719",""
"08/04/2023","07:36:44","PDT","","General Card Deposit","Completed","EUR","19,99","0,00","19,99",,"","0,00","28071509CH7248354",""
"09/04/2023","01:01:46","PDT","Apple Services","PreApproved Payment Bill User Payment","Completed","EUR","-19,99","0,00","-19,99",,"","-19,99","5T1875179V0925126",""
"09/04/2023","01:01:46","PDT","","General Card Deposit","Completed","EUR","19,99","0,00","19,99",,"","0,00","1LE860089L4200616",""
"13/04/2023","11:43:10","PDT","Uber Payments BV","PreApproved Payment Bill User Payment","Completed","EUR","-19,29","0,00","-19,29",,"","-19,29","5U609612WT801863E",""
"13/04/2023","11:43:10","PDT","","General Card Deposit","Completed","EUR","19,29","0,00","19,29",,"","0,00","94T26244AU540454C",""
"14/04/2023","05:45:00","PDT","Uber Payments BV","PreApproved Payment Bill User Payment","Completed","EUR","-33,54","0,00","-33,54",,"","-33,54","55348906KB801150R",""
"14/04/2023","05:45:00","PDT","","General Card Deposit","Completed","EUR","33,54","0,00","33,54",,"","0,00","1FM45887JX028362F",""
"17/04/2023","13:40:58","PDT","Google","PreApproved Payment Bill User Payment","Completed","EUR","-8,49","0,00","-8,49",,"","-8,49","1KM21086MS749981T",""
"17/04/2023","13:40:58","PDT","","General Card Deposit","Completed","EUR","8,49","0,00","8,49",,"","0,00","9PM18298RL4832335",""
"20/04/2023","05:08:10","PDT","Uber Payments BV","PreApproved Payment Bill User Payment","Completed","EUR","-17,05","0,00","-17,05",,"","-17,05","3YS18525LN334112F",""
"20/04/2023","05:08:10","PDT","","General Card Deposit","Completed","EUR","17,05","0,00","17,05",,"","0,00","8WC147584N499025C",""
"22/04/2023","07:02:36","PDT","Apple Services","PreApproved Payment Bill User Payment","Completed","EUR","-2,99","0,00","-2,99",,"","-2,99","5XD78375BC8919512",""
"22/04/2023","07:02:36","PDT","","General Card Deposit","Completed","EUR","2,99","0,00","2,99",,"","0,00","8VB45173GS0160244",""
"26/04/2023","16:32:44","PDT","Apple Services","PreApproved Payment Bill User Payment","Completed","EUR","-1,99","0,00","-1,99",,"","-1,99","2AP47084RU321593A",""
"26/04/2023","16:32:44","PDT","","General Card Deposit","Completed","EUR","1,99","0,00","1,99",,"","0,00","1NF42647UP6411026",""
"26/04/2023","16:33:34","PDT","Apple Services","PreApproved Payment Bill User Payment","Completed","EUR","-5,49","0,00","-5,49",,"","-5,49","1S310478P9486500B",""
"26/04/2023","16:33:34","PDT","","General Card Deposit","Completed","EUR","5,49","0,00","5,49",,"","0,00","2WW08750AC138501T",""
"27/04/2023","05:34:06","PDT","Uber Payments BV","PreApproved Payment Bill User Payment","Completed","EUR","-17,05","0,00","-17,05",,"","-17,05","8MG0954623966835S",""
"27/04/2023","05:34:06","PDT","","General Card Deposit","Completed","EUR","17,05","0,00","17,05",,"","0,00","8B294727DC694070J",""
"28/04/2023","05:59:01","PDT","Apple Services","PreApproved Payment Bill User Payment","Completed","EUR","-6,99","0,00","-6,99",,"","-6,99","2CJ41543XT515824E",""
"28/04/2023","05:59:01","PDT","","General Card Deposit","Completed","EUR","6,99","0,00","6,99",,"","0,00","095304971U2150044",""
"28/04/2023","06:03:43","PDT","Google Payment Ireland Limited","PreApproved Payment Bill User Payment","Completed","EUR","-2,99","0,00","-2,99",,"","-2,99","7SE60619ND310980X",""
"28/04/2023","06:03:43","PDT","","General Card Deposit","Completed","EUR","2,99","0,00","2,99",,"","0,00","8CP68875057791919",""
"04/05/2023","05:32:52","PDT","Uber Payments BV","PreApproved Payment Bill User Payment","Completed","EUR","-34,54","0,00","-34,54",,"","-34,54","4C351253SU857212L",""
"04/05/2023","05:32:52","PDT","","General Card Deposit","Completed","EUR","34,54","0,00","34,54",,"","0,00","2AY43837GY7398624",""
"13/05/2023","11:02:11","PDT","Uber Payments BV","PreApproved Payment Bill User Payment","Completed","GBP","-13,77","0,00","-13,77",,"","-13,77","35P70591TW904945F",""
"13/05/2023","11:02:11","PDT","","General Card Deposit","Completed","GBP","13,77","0,00","13,77",,"","0,00","44R862130S741742U",""
"17/05/2023","13:40:57","PDT","Google","PreApproved Payment Bill User Payment","Completed","EUR","-8,49","0,00","-8,49",,"","-8,49","4UJ03338232074505",""
"17/05/2023","13:40:57","PDT","","General Card Deposit","Completed","EUR","8,49","0,00","8,49",,"","0,00","1SJ74033CW221602A",""
"18/05/2023","04:24:54","PDT","Heathrow Express Operating Company Limited","Express Checkout Payment","Completed","GBP","-25,00","0,00","-25,00",,"","-25,00","9DR33839P33449519",""
"18/05/2023","04:24:54","PDT","","General Card Deposit","Completed","GBP","25,00","0,00","25,00",,"","0,00","70450075HS576442V",""
"19/05/2023","11:41:55","PDT","Uber Payments BV","PreApproved Payment Bill User Payment","Completed","EUR","-34,19","0,00","-34,19",,"","-34,19","35C57979FB0805459",""
"19/05/2023","11:41:55","PDT","","General Card Deposit","Completed","EUR","34,19","0,00","34,19",,"","0,00","28690086GF0964416",""
"25/05/2023","05:21:31","PDT","Uber Payments BV","PreApproved Payment Bill User Payment","Completed","EUR","-18,15","0,00","-18,15",,"","-18,15","605923380M3676216",""
"25/05/2023","05:21:31","PDT","","General Card Deposit","Completed","EUR","18,15","0,00","18,15",,"","0,00","29E19879NX096181V",""
"26/05/2023","16:33:26","PDT","Apple Services","PreApproved Payment Bill User Payment","Completed","EUR","-1,99","0,00","-1,99",,"","-1,99","6MY38482FK0172614",""
"26/05/2023","16:33:26","PDT","","General Card Deposit","Completed","EUR","1,99","0,00","1,99",,"","0,00","37E23581R2695251R",""
"26/05/2023","16:33:46","PDT","Apple Services","PreApproved Payment Bill User Payment","Completed","EUR","-5,49","0,00","-5,49",,"","-5,49","6MP52022M5982015R",""
"26/05/2023","16:33:46","PDT","","General Card Deposit","Completed","EUR","5,49","0,00","5,49",,"","0,00","9LK38290JM953912K",""
"28/05/2023","05:59:14","PDT","Apple Services","PreApproved Payment Bill User Payment","Completed","EUR","-6,99","0,00","-6,99",,"","-6,99","4VA955261B358390U",""
"28/05/2023","05:59:14","PDT","","General Card Deposit","Completed","EUR","6,99","0,00","6,99",,"","0,00","6X081926DH085632E",""
"28/05/2023","06:03:40","PDT","Google Payment Ireland Limited","PreApproved Payment Bill User Payment","Completed","EUR","-2,99","0,00","-2,99",,"","-2,99","0XN90567CW333031T",""
"28/05/2023","06:03:40","PDT","","General Card Deposit","Completed","EUR","2,99","0,00","2,99",,"","0,00","54B00263VR8179336",""
"29/05/2023","18:54:15","PDT","Apple Services","PreApproved Payment Bill User Payment","Completed","EUR","-18,95","0,00","-18,95",,"","-18,95","3L7596268P535972P",""
"29/05/2023","18:54:15","PDT","","General Card Deposit","Completed","EUR","18,95","0,00","18,95",,"","0,00","3SJ37231X3281322T",""
"29/05/2023","18:54:18","PDT","Apple Services","Payment Refund","Completed","EUR","6,76","0,00","6,76",,"","6,76","2LM62998U44667025",""
"29/05/2023","18:54:18","PDT","","General Card Withdrawal","Completed","EUR","-6,76","0,00","-6,76",,"","0,00","9N1210227B5683401",""
"01/06/2023","05:22:11","PDT","Uber Payments BV","PreApproved Payment Bill User Payment","Completed","EUR","-18,15","0,00","-18,15",,"","-18,15","5Y172308PT831002H",""
"01/06/2023","05:22:11","PDT","","General Card Deposit","Completed","EUR","18,15","0,00","18,15",,"","0,00","6KU48622F5932272J",""
"01/06/2023","07:00:00","PDT","Booking.com BV","Express Checkout Payment","Completed","EUR","-279,30","0,00","-279,30",,"","-279,30","4X263015HU343013L",""
"01/06/2023","07:00:00","PDT","","General Card Deposit","Completed","EUR","279,30","0,00","279,30",,"","0,00","9B457414UP2539412",""
"02/06/2023","05:17:27","PDT","Uber Payments BV","PreApproved Payment Bill User Payment","Completed","EUR","-34,29","0,00","-34,29",,"","-34,29","1G217523BA194232G",""
"02/06/2023","05:17:27","PDT","","General Card Deposit","Completed","EUR","34,29","0,00","34,29",,"","0,00","632754091R0233224",""
"09/06/2023","05:10:19","PDT","Uber Payments BV","PreApproved Payment Bill User Payment","Completed","EUR","-34,29","0,00","-34,29",,"","-34,29","69N24255EH301014X",""
"09/06/2023","05:10:19","PDT","","General Card Deposit","Completed","EUR","34,29","0,00","34,29",,"","0,00","2AM84113CY105634N",""
"12/06/2023","10:46:45","PDT","Airbnb Payments Luxembourg S.A.","PreApproved Payment Bill User Payment","Completed","EUR","-1.420,11","0,00","-1.420,11",,"","-1.420,11","59F04600D9889935M",""
"12/06/2023","10:46:45","PDT","","General Card Deposit","Completed","EUR","1.420,11","0,00","1.420,11",,"","0,00","85543101B3685751L",""
"13/06/2023","13:12:34","PDT","Uber Payments BV","PreApproved Payment Bill User Payment","Completed","EUR","-61,74","0,00","-61,74",,"","-61,74","63P19269CF490925X",""
"13/06/2023","13:12:34","PDT","","General Card Deposit","Completed","EUR","61,74","0,00","61,74",,"","0,00","5666072951366425R",""
"16/06/2023","05:33:05","PDT","Uber Payments BV","PreApproved Payment Bill User Payment","Completed","EUR","-33,42","0,00","-33,42",,"","-33,42","32U63987F75511612",""
"16/06/2023","05:33:05","PDT","","General Card Deposit","Completed","EUR","33,42","0,00","33,42",,"","0,00","9BS7985572879691W",""
"17/06/2023","02:15:58","PDT","Fnac Portugal","Express Checkout Payment","Completed","EUR","-1.151,00","0,00","-1.151,00",,"","-1.151,00","8FX18413YX8500509",""
"17/06/2023","02:15:58","PDT","","General Card Deposit","Completed","EUR","1.151,00","0,00","1.151,00",,"","0,00","2WM70591BJ442140L",""
"17/06/2023","07:00:39","PDT","Puro Mobile Srl","Express Checkout Payment","Completed","EUR","-48,76","0,00","-48,76",,"","-48,76","5TY79974MT040461U",""
"17/06/2023","07:00:39","PDT","","General Card Deposit","Completed","EUR","48,76","0,00","48,76",,"","0,00","0HB91438GA035123E",""
"17/06/2023","12:55:50","PDT","Uber Payments BV","PreApproved Payment Bill User Payment","Completed","EUR","-48,74","0,00","-48,74",,"","-48,74","22G52095TS870652G",""
"17/06/2023","12:55:50","PDT","","General Card Deposit","Completed","EUR","48,74","0,00","48,74",,"","0,00","8T709474GH039044T",""
"17/06/2023","13:40:58","PDT","Google","PreApproved Payment Bill User Payment","Completed","EUR","-8,49","0,00","-8,49",,"","-8,49","22L87586F17369453",""
"17/06/2023","13:40:58","PDT","","General Card Deposit","Completed","EUR","8,49","0,00","8,49",,"","0,00","7FP11993C5410224M",""
"22/06/2023","05:24:22","PDT","Uber Payments BV","PreApproved Payment Bill User Payment","Completed","EUR","-26,54","0,00","-26,54",,"","-26,54","4T1578457T8513912",""
"22/06/2023","05:24:22","PDT","","General Card Deposit","Completed","EUR","26,54","0,00","26,54",,"","0,00","3XJ83033YE938500B",""
"24/06/2023","05:14:59","PDT","Uber Payments BV","PreApproved Payment Bill User Payment","Completed","EUR","-22,53","0,00","-22,53",,"","-22,53","6V111939J5073471P",""
"24/06/2023","05:14:59","PDT","","General Card Deposit","Completed","EUR","22,53","0,00","22,53",,"","0,00","3T949328UB423313L",""
"24/06/2023","12:13:51","PDT","Uber Payments BV","PreApproved Payment Bill User Payment","Completed","EUR","-32,52","0,00","-32,52",,"","-32,52","2N790627P7176943B",""
"24/06/2023","12:13:51","PDT","","General Card Deposit","Completed","EUR","32,52","0,00","32,52",,"","0,00","7W514882D95003211",""
"26/06/2023","16:33:48","PDT","Apple Services","PreApproved Payment Bill User Payment","Completed","EUR","-5,49","0,00","-5,49",,"","-5,49","5LB42226BY3592146",""
"26/06/2023","16:33:48","PDT","","General Card Deposit","Completed","EUR","5,49","0,00","5,49",,"","0,00","29B08845LA203530E",""
"26/06/2023","16:39:38","PDT","Apple Services","PreApproved Payment Bill User Payment","Completed","EUR","-1,99","0,00","-1,99",,"","-1,99","8UA345835W690110F",""
"26/06/2023","16:39:38","PDT","","General Card Deposit","Completed","EUR","1,99","0,00","1,99",,"","0,00","0WM085355R009992Y",""
"28/06/2023","06:03:43","PDT","Google Payment Ireland Limited","PreApproved Payment Bill User Payment","Completed","EUR","-2,99","0,00","-2,99",,"","-2,99","9G999920LN8157808",""
"28/06/2023","06:03:43","PDT","","General Card Deposit","Completed","EUR","2,99","0,00","2,99",,"","0,00","1RW575392V030515L",""
"29/06/2023","18:54:20","PDT","Apple Services","PreApproved Payment Bill User Payment","Completed","EUR","-18,95","0,00","-18,95",,"","-18,95","7AJ74157MA309322Y",""
"29/06/2023","18:54:20","PDT","","General Card Deposit","Completed","EUR","18,95","0,00","18,95",,"","0,00","4T619861P6214425L",""
"06/07/2023","05:24:49","PDT","Uber Payments BV","PreApproved Payment Bill User Payment","Completed","EUR","-33,42","0,00","-33,42",,"","-33,42","4GN73394HM834231E",""
"06/07/2023","05:24:49","PDT","","General Card Deposit","Completed","EUR","33,42","0,00","33,42",,"","0,00","92N8863398105415C",""
"12/07/2023","05:25:22","PDT","Uber Payments BV","PreApproved Payment Bill User Payment","Completed","EUR","-33,42","0,00","-33,42",,"","-33,42","5B622475C8184294G",""
"12/07/2023","05:25:22","PDT","","General Card Deposit","Completed","EUR","33,42","0,00","33,42",,"","0,00","5VY711631E6878458",""
"17/07/2023","13:40:58","PDT","Google","PreApproved Payment Bill User Payment","Completed","EUR","-8,49","0,00","-8,49",,"","-8,49","8JS564850L060020T",""
"17/07/2023","13:40:58","PDT","","General Card Deposit","Completed","EUR","8,49","0,00","8,49",,"","0,00","54539870WC142424A",""
"21/07/2023","05:31:53","PDT","Uber Payments BV","PreApproved Payment Bill User Payment","Completed","EUR","-32,92","0,00","-32,92",,"","-32,92","9JE23165RE206813A",""
"21/07/2023","05:31:53","PDT","","General Card Deposit","Completed","EUR","32,92","0,00","32,92",,"","0,00","74L326369N726721R",""
"22/07/2023","12:47:25","PDT","Uber Payments BV","PreApproved Payment Bill User Payment","Completed","EUR","-66,29","0,00","-66,29",,"","-66,29","9RB49827CC716174L",""
"22/07/2023","12:47:25","PDT","","General Card Deposit","Completed","EUR","66,29","0,00","66,29",,"","0,00","02R914341G305412S",""
"23/07/2023","09:26:19","PDT","Antonio Barbosa e Castro, Lda.","Website Payment","Completed","EUR","-83,00","0,00","-83,00",,"","-83,00","4D1572913A837083K",""
"23/07/2023","09:26:19","PDT","","General Card Deposit","Completed","EUR","83,00","0,00","83,00",,"","0,00","3K234767DU835271R",""
"24/07/2023","06:45:50","PDT","Sony Interactive Entertainment Network Europe Limited","PreApproved Payment Bill User Payment","Completed","EUR","-24,99","0,00","-24,99",,"","-24,99","03B71730TW777704H",""
"24/07/2023","06:45:50","PDT","","General Card Deposit","Completed","EUR","24,99","0,00","24,99",,"","0,00","61T05966581513428",""
"26/07/2023","16:32:33","PDT","Apple Services","PreApproved Payment Bill User Payment","Completed","EUR","-1,99","0,00","-1,99",,"","-1,99","22E091415N5419607",""
"26/07/2023","16:32:33","PDT","","General Card Deposit","Completed","EUR","1,99","0,00","1,99",,"","0,00","5MM99768NV685833P",""
"26/07/2023","16:35:19","PDT","Apple Services","PreApproved Payment Bill User Payment","Completed","EUR","-5,49","0,00","-5,49",,"","-5,49","0SG1149454247071S",""
"26/07/2023","16:35:19","PDT","","General Card Deposit","Completed","EUR","5,49","0,00","5,49",,"","0,00","0GS31603UE801233T",""
"27/07/2023","05:26:37","PDT","Uber Payments BV","PreApproved Payment Bill User Payment","Completed","EUR","-32,92","0,00","-32,92",,"","-32,92","4TT10351L8285192V",""
"27/07/2023","05:26:37","PDT","","General Card Deposit","Completed","EUR","32,92","0,00","32,92",,"","0,00","6SN44602LC4178946",""
"28/07/2023","03:58:38","PDT","Dashlane USA Inc","Subscription Payment","Completed","EUR","-39,99","0,00","-39,99",,"","-39,99","361139740T805234Y",""
"28/07/2023","03:58:38","PDT","","General Card Deposit","Completed","EUR","39,99","0,00","39,99",,"","0,00","3N378672S3141390Y",""
"28/07/2023","06:03:44","PDT","Google Payment Ireland Limited","PreApproved Payment Bill User Payment","Completed","EUR","-2,99","0,00","-2,99",,"","-2,99","3GH41045421695232",""
"28/07/2023","06:03:44","PDT","","General Card Deposit","Completed","EUR","2,99","0,00","2,99",,"","0,00","93W7601199962180A",""
"29/07/2023","18:54:03","PDT","Apple Services","PreApproved Payment Bill User Payment","Completed","EUR","-18,95","0,00","-18,95",,"","-18,95","07V29983VF419674N",""
"29/07/2023","18:54:03","PDT","","General Card Deposit","Completed","EUR","18,95","0,00","18,95",,"","0,00","27Y19774MN336310C",""
"14/08/2023","13:03:58","PDT","Uber Payments BV","PreApproved Payment Bill User Payment","Completed","EUR","-31,76","0,00","-31,76",,"","-31,76","92M20670NY4529357",""
"14/08/2023","13:03:58","PDT","","General Card Deposit","Completed","EUR","31,76","0,00","31,76",,"","0,00","0LD1013890485513K",""
"17/08/2023","05:25:46","PDT","Uber Payments BV","PreApproved Payment Bill User Payment","Completed","EUR","-42,84","0,00","-42,84",,"","-42,84","9NK08119M0231790U",""
"17/08/2023","05:25:46","PDT","","General Card Deposit","Completed","EUR","42,84","0,00","42,84",,"","0,00","1H9401189A587312T",""
"17/08/2023","13:40:57","PDT","Google","PreApproved Payment Bill User Payment","Completed","EUR","-8,49","0,00","-8,49",,"","-8,49","18X72892F9796521V",""
"17/08/2023","13:40:57","PDT","","General Card Deposit","Completed","EUR","8,49","0,00","8,49",,"","0,00","54421623K65258118",""
"20/08/2023","06:03:45","PDT","Uber Payments BV","PreApproved Payment Bill User Payment","Completed","EUR","-45,94","0,00","-45,94",,"","-45,94","7N633849H4593225P",""
"20/08/2023","06:03:45","PDT","","General Card Deposit","Completed","EUR","45,94","0,00","45,94",,"","0,00","9TN710117S507624H",""
"24/08/2023","04:59:11","PDT","Uber Payments BV","PreApproved Payment Bill User Payment","Completed","EUR","-32,92","0,00","-32,92",,"","-32,92","5X031276A4173130V",""
"24/08/2023","04:59:11","PDT","","General Card Deposit","Completed","EUR","32,92","0,00","32,92",,"","0,00","8G8913551H179103U",""
"25/08/2023","13:41:52","PDT","Uber Payments BV","PreApproved Payment Bill User Payment","Completed","EUR","-16,27","0,00","-16,27",,"","-16,27","4E124297DY9501214",""
"25/08/2023","13:41:52","PDT","","General Card Deposit","Completed","EUR","16,27","0,00","16,27",,"","0,00","9A732160N8168182H",""
"25/08/2023","16:20:02","PDT","Uber Payments BV","PreApproved Payment Bill User Payment","Completed","EUR","-14,24","0,00","-14,24",,"","-14,24","94E16913BC468871M",""
"25/08/2023","16:20:02","PDT","","General Card Deposit","Completed","EUR","14,24","0,00","14,24",,"","0,00","29Y48632X5206290B",""
"26/08/2023","16:32:22","PDT","Apple Services","PreApproved Payment Bill User Payment","Completed","EUR","-1,99","0,00","-1,99",,"","-1,99","3VE00332PP840384P",""
"26/08/2023","16:32:22","PDT","","General Card Deposit","Completed","EUR","1,99","0,00","1,99",,"","0,00","4LW580145D148112W",""
"26/08/2023","16:34:06","PDT","Apple Services","PreApproved Payment Bill User Payment","Completed","EUR","-5,49","0,00","-5,49",,"","-5,49","8FX46966ER516281R",""
"26/08/2023","16:34:06","PDT","","General Card Deposit","Completed","EUR","5,49","0,00","5,49",,"","0,00","86R71107GP474181D",""
"27/08/2023","06:11:23","PDT","Uber Payments BV","PreApproved Payment Bill User Payment","Completed","EUR","-28,56","0,00","-28,56",,"","-28,56","4GK78345Y5043445A",""
"27/08/2023","06:11:23","PDT","","General Card Deposit","Completed","EUR","28,56","0,00","28,56",,"","0,00","2FX834024E0223706",""
"28/08/2023","06:04:15","PDT","Google Payment Ireland Limited","PreApproved Payment Bill User Payment","Completed","EUR","-2,99","0,00","-2,99",,"","-2,99","798613306E711993G",""
"28/08/2023","06:04:15","PDT","","General Card Deposit","Completed","EUR","2,99","0,00","2,99",,"","0,00","49X993814M9872744",""
"29/08/2023","18:53:40","PDT","Apple Services","PreApproved Payment Bill User Payment","Completed","EUR","-18,95","0,00","-18,95",,"","-18,95","3604195084677071D",""
"29/08/2023","18:53:40","PDT","","General Card Deposit","Completed","EUR","18,95","0,00","18,95",,"","0,00","66T397405V468280A",""
"31/08/2023","05:07:39","PDT","Uber Payments BV","PreApproved Payment Bill User Payment","Completed","EUR","-32,92","0,00","-32,92",,"","-32,92","6GL22025E6896115T",""
"31/08/2023","05:07:39","PDT","","General Card Deposit","Completed","EUR","32,92","0,00","32,92",,"","0,00","5JR32282707732813",""
"07/09/2023","05:22:45","PDT","Uber Payments BV","PreApproved Payment Bill User Payment","Completed","EUR","-33,17","0,00","-33,17",,"","-33,17","0G34152980178814E",""
"07/09/2023","05:22:45","PDT","","General Card Deposit","Completed","EUR","33,17","0,00","33,17",,"","0,00","13E615303M714445B",""
"08/09/2023","06:03:02","PDT","NOS Lusomundo Cinemas, S.A.","Express Checkout Payment","Completed","EUR","-15,00","0,00","-15,00",,"","-15,00","300105047F338112F",""
"08/09/2023","06:03:02","PDT","","General Card Deposit","Completed","EUR","15,00","0,00","15,00",,"","0,00","88S26996W75414217",""
"10/09/2023","04:51:35","PDT","Uber Payments BV","PreApproved Payment Bill User Payment","Completed","EUR","-34,97","0,00","-34,97",,"","-34,97","5DE680443A662662W",""
"10/09/2023","04:51:35","PDT","","General Card Deposit","Completed","EUR","34,97","0,00","34,97",,"","0,00","2D956484HB876814U",""
"12/09/2023","05:31:18","PDT","Uber Payments BV","PreApproved Payment Bill User Payment","Completed","EUR","-18,06","0,00","-18,06",,"","-18,06","9HV81227R2325123Y",""
"12/09/2023","05:31:18","PDT","","General Card Deposit","Completed","EUR","18,06","0,00","18,06",,"","0,00","8CU0668079609112H",""
"13/09/2023","13:10:10","PDT","Uber Payments BV","PreApproved Payment Bill User Payment","Completed","EUR","-50,98","0,00","-50,98",,"","-50,98","4VY607721E119391R",""
"13/09/2023","13:10:10","PDT","","General Card Deposit","Completed","EUR","50,98","0,00","50,98",,"","0,00","43E63254DT8941802",""
"14/09/2023","05:06:36","PDT","Uber Payments BV","PreApproved Payment Bill User Payment","Completed","EUR","-22,28","0,00","-22,28",,"","-22,28","7MS88189845503706",""
"14/09/2023","05:06:36","PDT","","General Card Deposit","Completed","EUR","22,28","0,00","22,28",,"","0,00","0YS193311V1028835",""
"17/09/2023","05:01:51","PDT","Uber Payments BV","PreApproved Payment Bill User Payment","Completed","EUR","-19,05","0,00","-19,05",,"","-19,05","7KJ70695XD1011033",""
"17/09/2023","05:01:51","PDT","","General Card Deposit","Completed","EUR","19,05","0,00","19,05",,"","0,00","9T767301484108941",""
"17/09/2023","05:34:51","PDT","Apple Services","PreApproved Payment Bill User Payment","Completed","EUR","-5,99","0,00","-5,99",,"","-5,99","2A214538KH7646832",""
"17/09/2023","05:34:51","PDT","","General Card Deposit","Completed","EUR","5,99","0,00","5,99",,"","0,00","70R178825A938872U",""
"17/09/2023","13:40:58","PDT","Google","PreApproved Payment Bill User Payment","Completed","EUR","-8,49","0,00","-8,49",,"","-8,49","9C4549718A650105S",""
"17/09/2023","13:40:58","PDT","","General Card Deposit","Completed","EUR","8,49","0,00","8,49",,"","0,00","50N81127VW322761X",""
"21/09/2023","05:37:49","PDT","Uber Payments BV","PreApproved Payment Bill User Payment","Completed","EUR","-39,70","0,00","-39,70",,"","-39,70","2C081648YM816133T",""
"21/09/2023","05:37:49","PDT","","General Card Deposit","Completed","EUR","39,70","0,00","39,70",,"","0,00","8YR75810MY4429432",""
"23/09/2023","13:43:15","PDT","Sony Interactive Entertainment Network Europe Limited","PreApproved Payment Bill User Payment","Completed","EUR","-39,99","0,00","-39,99",,"","-39,99","32M06226CV423825S",""
"23/09/2023","13:43:15","PDT","","General Card Deposit","Completed","EUR","39,99","0,00","39,99",,"","0,00","62D059293F0065816",""
"26/09/2023","16:32:34","PDT","Apple Services","PreApproved Payment Bill User Payment","Completed","EUR","-1,99","0,00","-1,99",,"","-1,99","4AW58099XT749661L",""
"26/09/2023","16:32:34","PDT","","General Card Deposit","Completed","EUR","1,99","0,00","1,99",,"","0,00","1WR834354D151091U",""
"26/09/2023","16:34:14","PDT","Apple Services","PreApproved Payment Bill User Payment","Completed","EUR","-5,49","0,00","-5,49",,"","-5,49","9ES15838G0943232P",""
"26/09/2023","16:34:14","PDT","","General Card Deposit","Completed","EUR","5,49","0,00","5,49",,"","0,00","6GT06918P1749904T",""
"28/09/2023","05:26:15","PDT","Uber Payments BV","PreApproved Payment Bill User Payment","Completed","EUR","-29,80","0,00","-29,80",,"","-29,80","0L517024ET3117256",""
"28/09/2023","05:26:15","PDT","","General Card Deposit","Completed","EUR","29,80","0,00","29,80",,"","0,00","18J3315716898205P",""
"28/09/2023","06:03:43","PDT","Google Payment Ireland Ltd.","PreApproved Payment Bill User Payment","Completed","EUR","-2,99","0,00","-2,99",,"","-2,99","2RB15725H2082854L",""
"28/09/2023","06:03:43","PDT","","General Card Deposit","Completed","EUR","2,99","0,00","2,99",,"","0,00","47T19157LP683050A",""
"29/09/2023","10:08:30","PDT","Transactial Limited","PreApproved Payment Bill User Payment","Completed","EUR","-13,74","0,00","-13,74",,"","-13,74","3C602087CN085631J",""
"29/09/2023","10:08:30","PDT","","General Card Deposit","Completed","EUR","13,74","0,00","13,74",,"","0,00","1CB25264VW511614Y",""
"29/09/2023","13:28:24","PDT","Uber Payments BV","PreApproved Payment Bill User Payment","Completed","EUR","-29,09","0,00","-29,09",,"","-29,09","1WG9687455118944B",""
"29/09/2023","13:28:24","PDT","","General Card Deposit","Completed","EUR","29,09","0,00","29,09",,"","0,00","36W7173514030780D",""
"29/09/2023","14:44:00","PDT","Sony Interactive Entertainment Network Europe Limited","PreApproved Payment Bill User Payment","Completed","EUR","-39,99","0,00","-39,99",,"","-39,99","25S16973AP463823F",""
"29/09/2023","14:44:00","PDT","","General Card Deposit","Completed","EUR","39,99","0,00","39,99",,"","0,00","7UC96752UF791760N",""
"29/09/2023","18:54:15","PDT","Apple Services","PreApproved Payment Bill User Payment","Completed","EUR","-18,95","0,00","-18,95",,"","-18,95","7BY356542T350983R",""
"29/09/2023","18:54:15","PDT","","General Card Deposit","Completed","EUR","18,95","0,00","18,95",,"","0,00","1YH19399U7123335D",""
"01/10/2023","01:00:06","PDT","Transactial Limited","Payment Refund","Completed","EUR","13,74","0,00","13,74",,"","13,74","5NN5666799037784U",""
"01/10/2023","01:00:06","PDT","","General Card Withdrawal","Completed","EUR","-13,74","0,00","-13,74",,"","0,00","798195758V471264E",""
"01/10/2023","06:21:10","PDT","Sony Interactive Entertainment Network Europe Limited","PreApproved Payment Bill User Payment","Completed","EUR","-8,99","0,00","-8,99",,"","-8,99","9DF53658FX4250336",""
"01/10/2023","06:21:10","PDT","","General Card Deposit","Completed","EUR","8,99","0,00","8,99",,"","0,00","5NY20201F07288109",""
"06/10/2023","05:15:56","PDT","Uber Payments BV","PreApproved Payment Bill User Payment","Completed","EUR","-29,80","0,00","-29,80",,"","-29,80","92F78235EM780884Y",""
"06/10/2023","05:15:56","PDT","","General Card Deposit","Completed","EUR","29,80","0,00","29,80",,"","0,00","1EW062538P276552N",""
"12/10/2023","05:20:31","PDT","Uber Payments BV","PreApproved Payment Bill User Payment","Completed","EUR","-34,30","0,00","-34,30",,"","-34,30","4W4056755C2583123",""
"12/10/2023","05:20:31","PDT","","General Card Deposit","Completed","EUR","34,30","0,00","34,30",,"","0,00","5C582572Y3278722A",""
"16/10/2023","21:36:06","PDT","Apple Services","PreApproved Payment Bill User Payment","Completed","EUR","-5,99","0,00","-5,99",,"","-5,99","3GK86841GD3108822",""
"16/10/2023","21:36:06","PDT","","General Card Deposit","Completed","EUR","5,99","0,00","5,99",,"","0,00","8W3470022K733314A",""
"17/10/2023","13:40:58","PDT","Google","PreApproved Payment Bill User Payment","Completed","EUR","-8,49","0,00","-8,49",,"","-8,49","9G6324692Y8456417",""
"17/10/2023","13:40:58","PDT","","General Card Deposit","Completed","EUR","8,49","0,00","8,49",,"","0,00","63D27289KV471740K",""
"20/10/2023","05:10:08","PDT","Uber Payments BV","PreApproved Payment Bill User Payment","Completed","EUR","-4,99","0,00","-4,99",,"","-4,99","46V84210J86850107",""
"20/10/2023","05:10:08","PDT","","General Card Deposit","Completed","EUR","4,99","0,00","4,99",,"","0,00","5RC619199M267525D",""
"20/10/2023","05:24:46","PDT","Uber Payments BV","PreApproved Payment Bill User Payment","Completed","EUR","-29,80","0,00","-29,80",,"","-29,80","99P45768UP1915102",""
"20/10/2023","05:24:46","PDT","","General Card Deposit","Completed","EUR","29,80","0,00","29,80",,"","0,00","4M139195SL586021L",""
"23/10/2023","04:56:07","PDT","Apple Services","PreApproved Payment Bill User Payment","Completed","EUR","-9,99","0,00","-9,99",,"","-9,99","5GJ95611RH659401D",""
"23/10/2023","04:56:07","PDT","","General Card Deposit","Completed","EUR","9,99","0,00","9,99",,"","0,00","3SL56281K4341203K",""
"24/10/2023","05:23:12","PDT","Google Payment Ireland Ltd.","PreApproved Payment Bill User Payment","Completed","EUR","-2,99","0,00","-2,99",,"","-2,99","6D433073US151762B",""
"24/10/2023","05:23:12","PDT","","General Card Deposit","Completed","EUR","2,99","0,00","2,99",,"","0,00","5NC71494LF5009604",""
"26/10/2023","05:13:20","PDT","Uber Payments BV","PreApproved Payment Bill User Payment","Completed","EUR","-29,80","0,00","-29,80",,"","-29,80","845495638P8257726",""
"26/10/2023","05:13:20","PDT","","General Card Deposit","Completed","EUR","29,80","0,00","29,80",,"","0,00","1BC56347P2532035U",""
"26/10/2023","16:32:43","PDT","Apple Services","PreApproved Payment Bill User Payment","Completed","EUR","-1,99","0,00","-1,99",,"","-1,99","8M367855JK6347138",""
"26/10/2023","16:32:43","PDT","","General Card Deposit","Completed","EUR","1,99","0,00","1,99",,"","0,00","7FB45402N55951359",""
"26/10/2023","16:35:03","PDT","Apple Services","PreApproved Payment Bill User Payment","Completed","EUR","-5,49","0,00","-5,49",,"","-5,49","7J7048984M616942R",""
"26/10/2023","16:35:03","PDT","","General Card Deposit","Completed","EUR","5,49","0,00","5,49",,"","0,00","7CR60778DL526235Y",""
"27/10/2023","06:29:33","PDT","Airbnb Payments Luxembourg S.A.","PreApproved Payment Bill User Payment","Completed","EUR","-158,40","0,00","-158,40",,"","-158,40","9GY5487329494771G",""
"27/10/2023","06:29:33","PDT","","General Card Deposit","Completed","EUR","158,40","0,00","158,40",,"","0,00","69S13033VK364661S",""
"28/10/2023","06:03:42","PDT","Google Payment Ireland Ltd.","PreApproved Payment Bill User Payment","Completed","EUR","-2,99","0,00","-2,99",,"","-2,99","8DC6415056573535H",""
"28/10/2023","06:03:42","PDT","","General Card Deposit","Completed","EUR","2,99","0,00","2,99",,"","0,00","8AD351530N516513C",""
"29/10/2023","18:53:56","PDT","Apple Services","PreApproved Payment Bill User Payment","Completed","EUR","-18,95","0,00","-18,95",,"","-18,95","34R29181PC975664S",""
"29/10/2023","18:53:56","PDT","","General Card Deposit","Completed","EUR","18,95","0,00","18,95",,"","0,00","8EK810876D3473707",""
"30/10/2023","07:09:35","PDT","Uber Payments BV","PreApproved Payment Bill User Payment","Completed","EUR","-8,16","0,00","-8,16",,"","-8,16","23W05205AA544143R",""
"30/10/2023","07:09:35","PDT","","General Card Deposit","Completed","EUR","8,16","0,00","8,16",,"","0,00","8BM076096T038863P",""
"30/10/2023","09:13:24","PDT","Uber Payments BV","PreApproved Payment Bill User Payment","Completed","EUR","-8,62","0,00","-8,62",,"","-8,62","0196566860549562Y",""
"30/10/2023","09:13:24","PDT","","General Card Deposit","Completed","EUR","8,62","0,00","8,62",,"","0,00","5SN57187SE798363B",""
"30/10/2023","09:14:01","PDT","Uber Payments BV","PreApproved Payment Bill User Payment","Completed","EUR","-1,00","0,00","-1,00",,"","-1,00","6CA94057PY402524G",""
"30/10/2023","09:14:01","PDT","","General Card Deposit","Completed","EUR","1,00","0,00","1,00",,"","0,00","1XB5145918748491W",""
"01/11/2023","02:40:31","PDT","Paddle.net","PreApproved Payment Bill User Payment","Completed","EUR","-39,95","0,00","-39,95",,"","-39,95","1FB24720KP844943J",""
"01/11/2023","02:40:31","PDT","","General Card Deposit","Completed","EUR","39,95","0,00","39,95",,"","0,00","083399781K3085356",""
"01/11/2023","06:25:35","PDT","Sony Interactive Entertainment Network Europe Limited","PreApproved Payment Bill User Payment","Completed","EUR","-8,99","0,00","-8,99",,"","-8,99","5SJ26181C5306772L",""
"01/11/2023","06:25:35","PDT","","General Card Deposit","Completed","EUR","8,99","0,00","8,99",,"","0,00","6SS78921VJ918460Y",""
"02/11/2023","06:21:16","PDT","Uber Payments BV","PreApproved Payment Bill User Payment","Completed","EUR","-29,80","0,00","-29,80",,"","-29,80","7A671448XG900110C",""
"02/11/2023","06:21:16","PDT","","General Card Deposit","Completed","EUR","29,80","0,00","29,80",,"","0,00","6GG57135NG747354J",""
"03/11/2023","04:58:57","PDT","Secretlab NL B.V.","Express Checkout Payment","Completed","EUR","-27,90","0,00","-27,90",,"","-27,90","3DP71285N33425934",""
"03/11/2023","04:58:57","PDT","","General Card Deposit","Completed","EUR","27,90","0,00","27,90",,"","0,00","60E064355D322844A",""
"05/11/2023","12:47:24","PST","Uber Payments BV","PreApproved Payment Bill User Payment","Completed","EUR","-60,49","0,00","-60,49",,"","-60,49","2S220343RT9961347",""
"05/11/2023","12:47:24","PST","","General Card Deposit","Completed","EUR","60,49","0,00","60,49",,"","0,00","49D52889X56212336",""
"09/11/2023","05:10:52","PST","Uber Payments BV","PreApproved Payment Bill User Payment","Completed","EUR","-29,80","0,00","-29,80",,"","-29,80","04W96604DX6496400",""
"09/11/2023","05:10:52","PST","","General Card Deposit","Completed","EUR","29,80","0,00","29,80",,"","0,00","1AS730327M604405H",""
"14/11/2023","02:59:07","PST","Paddle.net","Express Checkout Payment","Completed","USD","-22,13","0,00","-22,13",,"","-22,13","5FP081069C755001K",""
"14/11/2023","02:59:07","PST","","General Card Deposit","Completed","USD","22,13","0,00","22,13",,"","0,00","27621833HX885545V",""
"16/11/2023","05:31:29","PST","Uber Payments BV","PreApproved Payment Bill User Payment","Completed","EUR","-29,80","0,00","-29,80",,"","-29,80","4CR88627RP1471740",""
"16/11/2023","05:31:29","PST","","General Card Deposit","Completed","EUR","29,80","0,00","29,80",,"","0,00","5KY301420T200494M",""
"16/11/2023","12:03:02","PST","Uber Payments BV","PreApproved Payment Bill User Payment","Completed","EUR","-58,65","0,00","-58,65",,"","-58,65","6BN538063R727323V",""
"16/11/2023","12:03:02","PST","","General Card Deposit","Completed","EUR","58,65","0,00","58,65",,"","0,00","7X8107396N420340V",""
"16/11/2023","21:36:41","PST","Apple Services","PreApproved Payment Bill User Payment","Completed","EUR","-5,99","0,00","-5,99",,"","-5,99","43V36257DK199013X",""
"16/11/2023","21:36:41","PST","","General Card Deposit","Completed","EUR","5,99","0,00","5,99",,"","0,00","1A265712SG9468434",""
"17/11/2023","13:40:58","PST","Google","PreApproved Payment Bill User Payment","Completed","EUR","-8,49","0,00","-8,49",,"","-8,49","92Y04424KW666330F",""
"17/11/2023","13:40:58","PST","","General Card Deposit","Completed","EUR","8,49","0,00","8,49",,"","0,00","8FV29114V1684900K",""
"19/11/2023","05:33:36","PST","Uber Payments BV","PreApproved Payment Bill User Payment","Completed","EUR","-31,92","0,00","-31,92",,"","-31,92","22G08146WR6016834",""
"19/11/2023","05:33:36","PST","","General Card Deposit","Completed","EUR","31,92","0,00","31,92",,"","0,00","44E42752MC4516715",""
"20/11/2023","04:10:07","PST","Uber Payments BV","PreApproved Payment Bill User Payment","Completed","EUR","-4,99","0,00","-4,99",,"","-4,99","7RD24995R2446754T",""
"20/11/2023","04:10:07","PST","","General Card Deposit","Completed","EUR","4,99","0,00","4,99",,"","0,00","20M13917K7057774B",""
"24/11/2023","05:14:43","PST","Uber Payments BV","PreApproved Payment Bill User Payment","Completed","EUR","-29,80","0,00","-29,80",,"","-29,80","72S89822D47296016",""
"24/11/2023","05:14:43","PST","","General Card Deposit","Completed","EUR","29,80","0,00","29,80",,"","0,00","79789057GK6704533",""
"25/11/2023","13:06:52","PST","Uber Payments BV","PreApproved Payment Bill User Payment","Completed","EUR","-42,30","0,00","-42,30",,"","-42,30","5CG150938N592562Y",""
"25/11/2023","13:06:52","PST","","General Card Deposit","Completed","EUR","42,30","0,00","42,30",,"","0,00","07J1994474333941S",""
"26/11/2023","16:33:37","PST","Apple Services","PreApproved Payment Bill User Payment","Completed","EUR","-5,49","0,00","-5,49",,"","-5,49","0HD53051DR1596143",""
"26/11/2023","16:33:37","PST","","General Card Deposit","Completed","EUR","5,49","0,00","5,49",,"","0,00","4BC93110GN304601V",""
"26/11/2023","16:38:12","PST","Apple Services","PreApproved Payment Bill User Payment","Completed","EUR","-1,99","0,00","-1,99",,"","-1,99","0YD85915LR738343E",""
"26/11/2023","16:38:12","PST","","General Card Deposit","Completed","EUR","1,99","0,00","1,99",,"","0,00","6PH51407DF972873S",""
"27/11/2023","01:44:44","PST","LION OF PORCHES","Express Checkout Payment","Completed","EUR","-20,00","0,00","-20,00",,"","-20,00","9WV191510Y192060E",""
"27/11/2023","01:44:44","PST","","General Card Deposit","Completed","EUR","20,00","0,00","20,00",,"","0,00","56X35349FV0973242",""
"28/11/2023","05:06:16","PST","Google Payment Ireland Limited","PreApproved Payment Bill User Payment","Completed","EUR","-2,99","0,00","-2,99",,"","-2,99","5YX16534YC027873D",""
"28/11/2023","05:06:16","PST","","General Card Deposit","Completed","EUR","2,99","0,00","2,99",,"","0,00","0A068281YW981300J",""
"29/11/2023","18:53:41","PST","Apple Services","PreApproved Payment Bill User Payment","Completed","EUR","-18,95","0,00","-18,95",,"","-18,95","45111239Y7233352K",""
"29/11/2023","18:53:41","PST","","General Card Deposit","Completed","EUR","18,95","0,00","18,95",,"","0,00","05D353816V4266207",""
"01/12/2023","05:49:27","PST","Uber Payments BV","PreApproved Payment Bill User Payment","Completed","EUR","-49,74","0,00","-49,74",,"","-49,74","8DB4413202948864E",""
"01/12/2023","05:49:27","PST","","General Card Deposit","Completed","EUR","49,74","0,00","49,74",,"","0,00","2AC78302NN356903L",""
"02/12/2023","08:21:58","PST","Sony Interactive Entertainment Network Europe Limited","PreApproved Payment Bill User Payment","Completed","EUR","-10,00","0,00","-10,00",,"","-10,00","6XM54261RC450610U",""
"02/12/2023","08:21:58","PST","","General Card Deposit","Completed","EUR","10,00","0,00","10,00",,"","0,00","3AU937501H293074V",""
"04/12/2023","14:21:50","PST","Blueticket serviços de bilhetica, S.A.","Express Checkout Payment","Completed","EUR","-28,99","0,00","-28,99",,"","-28,99","2GB40688VG175410L",""
"04/12/2023","14:21:50","PST","","General Card Deposit","Completed","EUR","28,99","0,00","28,99",,"","0,00","8CT47285GP207121S",""
"07/12/2023","01:27:10","PST","Uber Payments BV","PreApproved Payment Bill User Payment","Completed","EUR","-9,91","0,00","-9,91",,"","-9,91","12653972TA9749318",""
"07/12/2023","01:27:10","PST","","General Card Deposit","Completed","EUR","9,91","0,00","9,91",,"","0,00","9KG49211KA681111C",""
"07/12/2023","05:12:13","PST","Uber Payments BV","PreApproved Payment Bill User Payment","Completed","EUR","-29,33","0,00","-29,33",,"","-29,33","089843609F520705V",""
"07/12/2023","05:12:13","PST","","General Card Deposit","Completed","EUR","29,33","0,00","29,33",,"","0,00","89C14622S63768841",""
"08/12/2023","00:24:52","PST","TRUST IN NEWS, UNIPESSOAL, LDA","Express Checkout Payment","Completed","EUR","-39,90","0,00","-39,90",,"","-39,90","1L7519848E919523G",""
"08/12/2023","00:24:52","PST","","General Card Deposit","Completed","EUR","39,90","0,00","39,90",,"","0,00","23069701UF140241C",""
"08/12/2023","06:03:00","PST","Uber Payments BV","PreApproved Payment Bill User Payment","Completed","EUR","-29,80","0,00","-29,80",,"","-29,80","8D548822RF8418324",""
"08/12/2023","06:03:00","PST","","General Card Deposit","Completed","EUR","29,80","0,00","29,80",,"","0,00","51G0541449894824S",""
"09/12/2023","06:56:01","PST","Sony Interactive Entertainment Network Europe Limited","PreApproved Payment Bill User Payment","Completed","EUR","-14,99","0,00","-14,99",,"","-14,99","52344709HP984321C",""
"09/12/2023","06:56:01","PST","","General Card Deposit","Completed","EUR","14,99","0,00","14,99",,"","0,00","5N7067008W4827354",""
"10/12/2023","05:03:49","PST","Uber Payments BV","PreApproved Payment Bill User Payment","Completed","EUR","-43,50","0,00","-43,50",,"","-43,50","26812842HA251004Y",""
"10/12/2023","05:03:49","PST","","General Card Deposit","Completed","EUR","43,50","0,00","43,50",,"","0,00","3UD09099HP9850012",""
"10/12/2023","15:19:15","PST","Apple Services","PreApproved Payment Bill User Payment","Completed","EUR","-3,99","0,00","-3,99",,"","-3,99","35X62344WP749435Y",""
"10/12/2023","15:19:15","PST","","General Card Deposit","Completed","EUR","3,99","0,00","3,99",,"","0,00","1G962949TW429280J",""
"14/12/2023","05:22:17","PST","Uber Payments BV","PreApproved Payment Bill User Payment","Completed","EUR","-33,20","0,00","-33,20",,"","-33,20","4JM56802LW3908037",""
"14/12/2023","05:22:17","PST","","General Card Deposit","Completed","EUR","33,20","0,00","33,20",,"","0,00","9L613423NL7594234",""
"16/12/2023","07:44:33","PST","Apple Services","PreApproved Payment Bill User Payment","Completed","EUR","-30,99","0,00","-30,99",,"","-30,99","3R536024NX395900T",""
"16/12/2023","07:44:33","PST","","General Card Deposit","Completed","EUR","30,99","0,00","30,99",,"","0,00","9NU82026TM163235R",""
"16/12/2023","21:34:51","PST","Apple Services","PreApproved Payment Bill User Payment","Completed","EUR","-5,99","0,00","-5,99",,"","-5,99","0YP23332FD9517709",""
"16/12/2023","21:34:51","PST","","General Card Deposit","Completed","EUR","5,99","0,00","5,99",,"","0,00","3R4002272A756802Y",""
"17/12/2023","13:40:57","PST","Google","PreApproved Payment Bill User Payment","Completed","EUR","-8,49","0,00","-8,49",,"","-8,49","9Y572461YP4247012",""
"17/12/2023","13:40:57","PST","","General Card Deposit","Completed","EUR","8,49","0,00","8,49",,"","0,00","89K74882DJ8160603",""
"20/12/2023","04:10:08","PST","Uber Payments BV","PreApproved Payment Bill User Payment","Completed","EUR","-4,99","0,00","-4,99",,"","-4,99","3D946494YN799102G",""
"20/12/2023","04:10:08","PST","","General Card Deposit","Completed","EUR","4,99","0,00","4,99",,"","0,00","5ED655953F6233343",""
"20/12/2023","12:08:56","PST","Uber Payments BV","PreApproved Payment Bill User Payment","Completed","EUR","-12,91","0,00","-12,91",,"","-12,91","95M33448XC5221544",""
"20/12/2023","12:08:56","PST","","General Card Deposit","Completed","EUR","12,91","0,00","12,91",,"","0,00","8KJ87553UT797564E",""
"20/12/2023","14:47:35","PST","Uber Payments BV","PreApproved Payment Bill User Payment","Completed","EUR","-11,29","0,00","-11,29",,"","-11,29","2X353694UC987041H",""
"20/12/2023","14:47:35","PST","","General Card Deposit","Completed","EUR","11,29","0,00","11,29",,"","0,00","4WV256581C660654M",""
"21/12/2023","05:05:22","PST","Uber Payments BV","PreApproved Payment Bill User Payment","Completed","EUR","-29,24","0,00","-29,24",,"","-29,24","1ER1977383277973J",""
"21/12/2023","05:05:22","PST","","General Card Deposit","Completed","EUR","29,24","0,00","29,24",,"","0,00","8AV63813PR492463L",""
"24/12/2023","06:43:15","PST","HOTELS.COM EMEA","Express Checkout Payment","Completed","EUR","-94,10","0,00","-94,10",,"","-94,10","3NM74934NG031063D",""
"24/12/2023","06:43:15","PST","","General Card Deposit","Completed","EUR","94,10","0,00","94,10",,"","0,00","2LV51791KR440361J",""
"26/12/2023","16:33:22","PST","Apple Services","PreApproved Payment Bill User Payment","Completed","EUR","-1,99","0,00","-1,99",,"","-1,99","0G156051Y0929621R",""
"26/12/2023","16:33:22","PST","","General Card Deposit","Completed","EUR","1,99","0,00","1,99",,"","0,00","8FV784313H332944X",""
"26/12/2023","16:33:58","PST","Apple Services","PreApproved Payment Bill User Payment","Completed","EUR","-5,49","0,00","-5,49",,"","-5,49","60025945D7014292P",""
"26/12/2023","16:33:58","PST","","General Card Deposit","Completed","EUR","5,49","0,00","5,49",,"","0,00","02B66663U5361794L",""
"27/12/2023","02:38:33","PST","Sony Interactive Entertainment Network Europe Limited","PreApproved Payment Bill User Payment","Completed","EUR","-55,99","0,00","-55,99",,"","-55,99","51L861075X4846509",""
"27/12/2023","02:38:33","PST","","General Card Deposit","Completed","EUR","55,99","0,00","55,99",,"","0,00","3TG96383EY429015T",""
"28/12/2023","03:12:52","PST","Sony Interactive Entertainment Network Europe Limited","PreApproved Payment Bill User Payment","Completed","EUR","-8,99","0,00","-8,99",,"","-8,99","6LU4035017044901P",""
"28/12/2023","03:12:52","PST","","General Card Deposit","Completed","EUR","8,99","0,00","8,99",,"","0,00","4H395219D48219648",""
"28/12/2023","04:46:21","PST","Uber Payments BV","PreApproved Payment Bill User Payment","Completed","EUR","-29,80","0,00","-29,80",,"","-29,80","6YG807049N518930E",""
"28/12/2023","04:46:21","PST","","General Card Deposit","Completed","EUR","29,80","0,00","29,80",,"","0,00","12252323TB080391R",""
"28/12/2023","05:03:54","PST","Google Payment Ireland Limited","PreApproved Payment Bill User Payment","Completed","EUR","-2,99","0,00","-2,99",,"","-2,99","4PY49867FW109431D",""
"28/12/2023","05:03:54","PST","","General Card Deposit","Completed","EUR","2,99","0,00","2,99",,"","0,00","4HK53869VW644823K",""
"29/12/2023","09:26:53","PST","Apple Services","PreApproved Payment Bill User Payment","Completed","EUR","-4,99","0,00","-4,99",,"","-4,99","3SA63843SN313492M",""
"29/12/2023","09:26:53","PST","","General Card Deposit","Completed","EUR","4,99","0,00","4,99",,"","0,00","26V441329S7051010",""
"29/12/2023","18:53:44","PST","Apple Services","PreApproved Payment Bill User Payment","Completed","EUR","-21,95","0,00","-21,95",,"","-21,95","98F35337KE028684M",""
"29/12/2023","18:53:44","PST","","General Card Deposit","Completed","EUR","21,95","0,00","21,95",,"","0,00","0J728962FU640925X",""
