Type,Product,date,Completed Date,description,amount,Fee,Currency,State,Balance
TOPUP,Current,2019-02-21 11:00:48,,Auth *4190,1,0,EUR,REVERTED,
TOPUP,Current,2019-02-21 11:01:06,2019-02-21 11:01:14,Top-Up by *4190,10,0,EUR,COMPLETED,10
TOPUP,Current,2019-02-21 11:45:21,,Auth *1071,1,0,EUR,REVERTED,
TOPUP,Current,2019-02-21 11:45:46,2019-02-21 11:45:53,Top-Up by *1071,50,0,EUR,COMPLETED,60
EXCHANGE,Current,2019-02-21 11:49:18,2019-02-21 11:49:18,Exchange to GBP,-21.35,0,EUR,COMPLETED,38.65
TRANSFER,Current,2019-02-21 11:51:57,2019-02-21 11:51:57,Transfer from Revolut user,11.05,0,EUR,COMPLETED,49.7
TRANSFER,Current,2019-02-21 12:08:28,2019-02-21 12:08:28,Transfer from Revolut user,8.55,0,EUR,COMPLETED,58.25
EXCHANGE,Current,2019-02-21 12:25:52,2019-02-21 12:25:52,Exchange to GBP,-22.44,0,EUR,COMPLETED,35.81
TRANSFER,Current,2019-02-21 13:05:18,2019-02-21 13:05:18,Transfer from Revolut user,11.85,0,EUR,COMPLETED,47.66
EXCHANGE,Current,2019-02-21 13:28:43,2019-02-21 13:28:43,Exchange to GBP,-9.03,0,EUR,COMPLETED,38.63
TOPUP,Current,2019-03-02 11:37:35,2019-03-02 11:37:48,Top-Up by *1071,50,0,EUR,COMPLETED,88.63
TRANSFER,Current,2019-03-02 11:38:09,2019-03-04 07:32:00,To Pedro Sousa,-50,0,EUR,COMPLETED,38.63
TRANSFER,Current,2019-03-06 07:43:44,2019-03-06 07:43:44,Transfer to Revolut user,-2.75,0,EUR,COMPLETED,35.88
TOPUP,Current,2019-03-07 13:41:10,2019-03-07 13:41:18,Top-Up by *1071,20,0,EUR,COMPLETED,55.88
FEE,Current,2019-03-07 19:31:56,2019-03-07 19:31:56,Card Delivery,-5.99,0,EUR,COMPLETED,49.89
REFUND,Current,2019-03-07 20:15:43,2019-03-07 20:15:43,Card Delivery Fee,5.99,0,EUR,COMPLETED,55.88
TOPUP,Current,2019-03-18 20:59:40,2019-03-18 20:59:46,Top-Up by *1071,30,0,EUR,COMPLETED,85.88
CARD_PAYMENT,Current,2019-03-21 12:13:29,2019-03-22 17:40:42,"Lxcooks, Lda.",-7.5,0,EUR,COMPLETED,78.38
TOPUP,Current,2019-03-24 12:02:40,,Auth *8673,1,0,EUR,REVERTED,
TOPUP,Current,2019-03-24 12:03:09,2019-03-24 12:03:16,Top-Up by *8673,120,0,EUR,COMPLETED,198.38
CARD_PAYMENT,Current,2019-03-24 12:19:41,2019-03-25 22:48:14,Cortefiel,-85.9,0,EUR,COMPLETED,112.48
CARD_PAYMENT,Current,2019-03-24 11:29:33,2019-03-25 22:48:15,Leroy Merlin,-27.99,0,EUR,COMPLETED,84.49
CARD_PAYMENT,Current,2019-03-24 11:46:02,2019-03-25 22:48:15,Jumbo,-5,0,EUR,COMPLETED,79.49
TOPUP,Current,2019-05-14 21:03:05,2019-05-14 21:03:06,Top-Up by *1071,100,0,EUR,COMPLETED,179.49
CARD_PAYMENT,Current,2019-05-18 19:48:10,2019-05-21 09:07:34,Starbucks,-28.59,0,EUR,COMPLETED,150.9
ATM,Current,2019-05-18 21:49:44,2019-05-21 09:07:34,Cash at Ha Ha Fresh -406429,-92.27,0,EUR,COMPLETED,58.63
TOPUP,Current,2019-06-07 18:37:28,2019-06-07 18:37:32,Top-Up by *1071,40,0,EUR,COMPLETED,98.63
CARD_PAYMENT,Current,2019-07-14 14:14:25,2019-07-17 00:03:04,Rua Luís de Camões,-14,0,EUR,COMPLETED,84.63
TOPUP,Current,2019-07-31 21:36:18,2019-07-31 21:36:20,Top-Up by *1071,20,0,EUR,COMPLETED,104.63
EXCHANGE,Current,2019-07-31 21:36:37,2019-07-31 21:36:37,Exchange to USD,-91.07,0,EUR,COMPLETED,13.56
TOPUP,Current,2019-07-31 22:59:50,2019-07-31 22:59:52,Top-Up by *1071,80,0,EUR,COMPLETED,93.56
TRANSFER,Current,2019-08-02 13:14:18,2019-08-02 13:14:18,Transfer to Revolut user,-50,0,EUR,COMPLETED,43.56
TOPUP,Current,2019-08-07 12:05:32,2019-08-07 12:05:34,Top-Up by *1071,100,0,EUR,COMPLETED,143.56
TRANSFER,Current,2019-08-07 12:06:01,2019-08-07 12:06:01,Transfer to Revolut user,-50,0,EUR,COMPLETED,93.56
TRANSFER,Current,2019-08-19 09:00:57,2019-08-19 09:00:57,Transfer to Revolut user,-50,0,EUR,COMPLETED,43.56
TOPUP,Current,2019-08-19 09:04:36,,Auth *2133,1,0,EUR,REVERTED,
TOPUP,Current,2019-08-19 09:04:45,2019-08-19 09:05:24,Top-Up by *2133,50,0,EUR,COMPLETED,93.56
TOPUP,Current,2019-08-20 22:52:33,2019-08-20 22:53:16,Top-Up by *2133,100,0,EUR,COMPLETED,193.56
TRANSFER,Current,2019-08-20 22:53:52,2019-08-20 22:53:52,Transfer to Revolut user,-100,0,EUR,COMPLETED,93.56
CARD_PAYMENT,Current,2019-09-11 13:19:32,,Rest Bufalo Grill,-13,0,EUR,REVERTED,
CARD_PAYMENT,Current,2019-09-21 15:36:26,,Ericeira Surf & Skate,-49.99,0,EUR,REVERTED,
TOPUP,Current,2019-09-21 15:36:55,2019-09-21 15:36:57,Top-Up by *2133,50,0,EUR,COMPLETED,143.56
CARD_PAYMENT,Current,2019-09-21 15:37:15,2019-09-24 00:12:26,Ericeira Surf & Skate,-49.99,0,EUR,COMPLETED,93.57
TRANSFER,Current,2019-09-24 13:23:49,2019-09-24 13:23:49,Transfer from Revolut user,11,0,EUR,COMPLETED,104.57
TRANSFER,Current,2019-10-07 12:17:39,2019-10-07 12:17:39,Transfer to Revolut user,-13.95,0,EUR,COMPLETED,90.62
TRANSFER,Current,2019-11-08 18:08:58,2019-11-08 18:08:58,Transfer to Revolut user,-3.5,0,EUR,COMPLETED,87.12
TRANSFER,Current,2019-11-08 18:09:56,2019-11-08 18:09:56,Transfer to Revolut user,-2.75,0,EUR,COMPLETED,84.37
TRANSFER,Current,2019-11-12 23:11:45,2019-11-12 23:11:45,Transfer to Revolut user,-50,0,EUR,COMPLETED,34.37
TOPUP,Current,2019-11-14 17:55:40,,Auth *5041,1,0,EUR,REVERTED,
TOPUP,Current,2020-01-29 07:58:57,2020-01-29 07:59:27,Top-Up by *5041,50,0,EUR,COMPLETED,84.37
CARD_PAYMENT,Current,2020-01-25 15:51:25,2020-01-29 13:09:00,CinemaCity,-11.9,0,EUR,COMPLETED,72.47
CARD_PAYMENT,Current,2020-02-08 20:17:12,2020-02-15 16:11:32,Amazon,-32.33,0,EUR,COMPLETED,40.14
CARD_PAYMENT,Current,2020-02-14 00:33:02,2020-02-16 03:24:39,Uber Eats,-0.5,0,EUR,COMPLETED,39.64
CARD_PAYMENT,Current,2020-02-14 00:12:53,2020-02-16 03:24:39,Uber,-8.19,0,EUR,COMPLETED,31.45
CARD_PAYMENT,Current,2020-02-18 12:09:00,,Uber Eats,-19.89,0,EUR,REVERTED,
TOPUP,Current,2020-02-18 17:06:04,,Auth *7017,1,0,EUR,REVERTED,
TOPUP,Current,2020-02-18 17:06:12,2020-02-18 17:07:29,Top-Up by *7017,80,0,EUR,COMPLETED,111.45
CARD_PAYMENT,Current,2020-02-19 12:24:11,2020-02-22 07:25:19,Uber Eats,-20.7,0,EUR,COMPLETED,90.75
CARD_PAYMENT,Current,2020-04-07 22:00:48,2020-04-08 15:15:06,Amazon,-6.99,0,EUR,COMPLETED,83.76
CARD_PAYMENT,Current,2020-08-27 08:29:19,2020-08-29 11:15:48,Audible,-11.65,0,EUR,COMPLETED,72.11
TRANSFER,Current,2020-09-03 13:57:18,2020-09-03 13:57:18,Transfer from Revolut user,24.87,0,EUR,COMPLETED,96.98
CARD_PAYMENT,Current,2020-09-16 22:48:49,2020-09-20 08:58:50,Audible,-12.66,0,EUR,COMPLETED,84.32
TRANSFER,Pocket,2021-12-01 10:30:58,2021-12-01 10:30:58,To EUR Bills,100,0,EUR,COMPLETED,100
TRANSFER,Pocket,2023-11-21 08:36:07,2023-11-21 08:36:07,Closing transaction,0,0,EUR,COMPLETED,100
TRANSFER,Current,2020-11-11 02:52:49,2020-11-11 02:52:49,Balance migration to another region or legal entity,-84.32,0,EUR,COMPLETED,0
TRANSFER,Current,2020-11-11 02:52:49,2020-11-11 02:52:49,Balance migration to another region or legal entity,84.32,0,EUR,COMPLETED,84.32
CARD_PAYMENT,Current,2020-12-01 20:03:58,2020-12-03 12:36:17,Gioseppo Oficial,-34.95,0,EUR,COMPLETED,49.37
TOPUP,Current,2021-02-04 13:09:09,2021-02-04 13:09:55,Top-Up by *7017,80,0,EUR,COMPLETED,129.37
CARD_PAYMENT,Current,2021-02-04 10:06:56,2021-02-06 10:16:17,Amazon,-30.43,0,EUR,COMPLETED,98.94
CARD_PAYMENT,Current,2021-09-02 10:23:38,2021-09-05 16:52:48,GoDaddy,-6.32,0,EUR,COMPLETED,92.62
TOPUP,Current,2021-11-09 12:05:25,2021-11-09 12:06:41,Top-Up by *7017,100,0,EUR,COMPLETED,192.62
CARD_PAYMENT,Current,2021-11-09 12:38:25,2021-11-10 16:43:35,4928code,-1.18,0,EUR,COMPLETED,191.44
CARD_PAYMENT,Current,2021-11-10 11:29:46,2021-11-11 15:54:13,PayPal,-0.45,0,EUR,COMPLETED,190.99
CARD_PAYMENT,Current,2021-11-10 11:36:13,2021-11-11 18:46:17,PayPal,-2.51,0,EUR,COMPLETED,188.48
CARD_PAYMENT,Current,2021-11-13 12:32:09,2021-11-14 14:36:23,Mercado de Algés,-4.3,0,EUR,COMPLETED,184.18
CARD_PAYMENT,Current,2021-11-13 13:09:17,2021-11-14 14:36:23,Mercado de Algés,-1.8,0,EUR,COMPLETED,182.38
TOPUP,Current,2021-11-15 09:07:26,2021-11-15 09:07:31,Apple Pay Top-Up by *6678,10,0,EUR,COMPLETED,192.38
CARD_PAYMENT,Current,2021-11-13 22:21:20,2021-11-15 19:44:54,Sangahnoona,-9.16,0.09,EUR,COMPLETED,183.13
TOPUP,Current,2021-11-17 14:49:22,2021-11-17 14:49:30,Apple Pay Top-Up by *6660,200,0,EUR,COMPLETED,383.13
CARD_PAYMENT,Current,2021-11-17 14:35:06,2021-11-18 14:39:16,Easypay Kuantokusta,-94.27,0,EUR,COMPLETED,288.86
TOPUP,Current,2021-11-19 22:52:46,2021-11-19 22:52:52,Apple Pay Top-Up by *6660,300,0,EUR,COMPLETED,588.86
CARD_PAYMENT,Current,2021-11-18 19:59:04,2021-11-20 14:32:11,Uber Eats,-39.59,0,EUR,COMPLETED,549.27
TRANSFER,Current,2021-11-20 19:56:19,2021-11-20 19:56:19,To EUR Savings,-0.3,0,EUR,COMPLETED,548.97
TOPUP,Current,2021-11-20 20:18:19,2021-11-20 20:18:21,Apple Pay Top-Up by *6660,50,0,EUR,COMPLETED,598.97
TOPUP,Current,2021-11-20 20:33:35,2021-11-20 20:33:42,Top-Up by *3256,750,0,EUR,COMPLETED,1348.97
TRANSFER,Current,2021-11-20 20:34:52,2021-11-20 20:34:52,To EUR Rainy day,-800,0,EUR,COMPLETED,548.97
TRANSFER,Current,2021-11-21 01:48:18,2021-11-21 01:48:18,To EUR Savings,-0.32,0,EUR,COMPLETED,548.65
TRANSFER,Current,2021-11-21 08:42:48,2021-11-21 08:42:48,To EUR Savings,-1,0,EUR,COMPLETED,547.65
CARD_PAYMENT,Current,2021-11-20 04:21:12,2021-11-21 14:15:26,Netflix,-15.99,0,EUR,COMPLETED,531.66
CARD_PAYMENT,Current,2021-11-20 14:01:18,2021-11-21 14:20:40,Mercado de Algés,-8.5,0,EUR,COMPLETED,523.16
CARD_PAYMENT,Current,2021-11-20 14:47:10,2021-11-21 14:20:40,Mercado de Algés,-2.7,0,EUR,COMPLETED,520.46
TRANSFER,Current,2021-11-21 15:33:17,2021-11-21 15:33:17,To EUR Savings,-0.35,0,EUR,COMPLETED,520.11
CARD_PAYMENT,Current,2021-11-20 20:07:23,2021-11-22 04:52:23,Minipreço,-2.68,0,EUR,COMPLETED,517.43
CARD_PAYMENT,Current,2021-11-21 14:56:22,2021-11-22 04:52:23,Rest California,-33.65,0,EUR,COMPLETED,483.78
CARD_PAYMENT,Current,2021-11-21 08:42:45,2021-11-22 07:36:47,Poke House - Miraflores,-3,0,EUR,COMPLETED,480.78
TRANSFER,Current,2021-11-22 13:12:14,2021-11-22 13:12:14,To EUR Savings,-20,0,EUR,COMPLETED,460.78
TOPUP,Current,2021-11-23 07:31:53,2021-11-23 07:31:53,Payment from Eng  Pedro Vasco Neves De Sousa,950,0,EUR,COMPLETED,1410.78
TRANSFER,Current,2021-11-23 08:10:20,2021-11-23 08:10:20,To EUR Rainy day,-950,0,EUR,COMPLETED,460.78
TRANSFER,Current,2021-11-23 12:46:00,2021-11-23 12:46:00,To EUR Savings,-0.83,0,EUR,COMPLETED,459.95
TRANSFER,Current,2021-11-23 19:53:08,2021-11-23 19:53:08,To EUR Savings,-0.61,0,EUR,COMPLETED,459.34
CARD_PAYMENT,Current,2021-11-23 12:45:41,2021-11-24 13:20:14,Uber Eats,-33.17,0,EUR,COMPLETED,426.17
TRANSFER,Current,2021-11-25 08:00:00,2021-11-25 08:02:39,To GALP Power,-5,0,EUR,COMPLETED,421.17
CARD_PAYMENT,Current,2021-11-23 19:43:28,2021-11-25 13:14:45,Uber Eats,-43.39,0,EUR,COMPLETED,377.78
TRANSFER,Current,2021-11-27 03:27:02,2021-11-27 03:27:02,To EUR Savings,-0.51,0,EUR,COMPLETED,377.27
TRANSFER,Current,2021-11-27 03:29:41,2021-11-27 03:29:41,To EUR Savings,-0.01,0,EUR,COMPLETED,377.26
TRANSFER,Current,2021-11-27 20:51:59,2021-11-27 20:51:59,To EUR Savings,-0.01,0,EUR,COMPLETED,377.25
CARD_PAYMENT,Current,2021-11-27 00:33:33,2021-11-28 09:18:46,Apple,-5.49,0,EUR,COMPLETED,371.76
CARD_PAYMENT,Current,2021-11-27 00:32:23,2021-11-28 09:18:46,Apple,-1.99,0,EUR,COMPLETED,369.77
TRANSFER,Current,2021-11-29 07:29:24,2021-11-29 07:29:24,To EUR Savings,-20,0,EUR,COMPLETED,349.77
TRANSFER,Current,2021-11-29 08:00:00,2021-11-29 08:32:13,To Edp Comercial Comercializacao De Energia S.a,-12,0,EUR,COMPLETED,337.77
CARD_PAYMENT,Current,2021-11-27 20:51:59,2021-11-29 12:39:44,Apple,-13.99,0,EUR,COMPLETED,323.78
TRANSFER,Current,2021-11-29 13:03:44,2021-11-29 13:03:44,To EUR Savings,-0.01,0,EUR,COMPLETED,323.77
CARD_PAYMENT,Current,2021-11-29 13:03:43,2021-11-30 12:25:08,Google,-2.99,0,EUR,COMPLETED,320.78
TOPUP,Current,2021-12-01 07:40:42,2021-12-01 07:40:44,Apple Pay Top-Up by *6660,500,0,EUR,COMPLETED,820.78
TRANSFER,Current,2021-12-01 10:30:58,2021-12-01 10:30:58,To EUR Bills,-100,0,EUR,COMPLETED,720.78
TRANSFER,Current,2021-12-06 07:31:17,2021-12-06 07:31:17,To EUR Savings,-20,0,EUR,COMPLETED,700.78
TRANSFER,Current,2021-12-06 08:00:00,2021-12-06 08:04:49,To GALP Power,-22.7,0,EUR,COMPLETED,678.08
TRANSFER,Current,2021-12-08 03:37:25,2021-12-08 03:37:25,To EUR Savings,-0.01,0,EUR,COMPLETED,678.07
TRANSFER,Current,2021-12-08 08:51:04,2021-12-08 08:51:04,To EUR Savings,-0.01,0,EUR,COMPLETED,678.06
TRANSFER,Current,2021-12-09 06:34:09,2021-12-09 06:34:09,To EUR Savings,-0.01,0,EUR,COMPLETED,678.05
CARD_PAYMENT,Current,2021-12-08 08:51:03,2021-12-09 12:30:51,Apple,-0.99,0,EUR,COMPLETED,677.06
CARD_PAYMENT,Current,2021-12-08 03:37:25,2021-12-09 12:32:59,Apple,-3.99,0,EUR,COMPLETED,673.07
TRANSFER,Current,2021-12-10 12:35:11,2021-12-10 12:35:11,To EUR Savings,-0.1,0,EUR,COMPLETED,672.97
TOPUP,Current,2021-12-10 12:36:54,2021-12-10 12:36:56,Apple Pay Top-Up by *6660,500,0,EUR,COMPLETED,1172.97
TRANSFER,Savings,2021-11-20 19:56:19,2021-11-20 19:56:19,To EUR Savings,0.3,0,EUR,COMPLETED,0.3
TRANSFER,Savings,2021-11-20 20:34:52,2021-11-20 20:34:52,To EUR Rainy day,800,0,EUR,COMPLETED,800.3
TRANSFER,Savings,2021-11-21 01:48:18,2021-11-21 01:48:18,To EUR Savings,0.32,0,EUR,COMPLETED,800.62
TRANSFER,Savings,2021-11-21 08:42:48,2021-11-21 08:42:48,To EUR Savings,1,0,EUR,COMPLETED,801.62
TRANSFER,Savings,2021-11-21 15:33:17,2021-11-21 15:33:17,To EUR Savings,0.35,0,EUR,COMPLETED,801.97
TRANSFER,Savings,2021-11-22 13:12:14,2021-11-22 13:12:14,To EUR Savings,20,0,EUR,COMPLETED,821.97
TRANSFER,Savings,2021-11-23 08:10:20,2021-11-23 08:10:20,To EUR Rainy day,950,0,EUR,COMPLETED,1771.97
TRANSFER,Savings,2021-11-23 12:46:00,2021-11-23 12:46:00,To EUR Savings,0.83,0,EUR,COMPLETED,1772.8
TRANSFER,Savings,2021-11-23 19:53:08,2021-11-23 19:53:08,To EUR Savings,0.61,0,EUR,COMPLETED,1773.41
TRANSFER,Savings,2021-11-27 03:27:02,2021-11-27 03:27:02,To EUR Savings,0.51,0,EUR,COMPLETED,1773.92
TRANSFER,Savings,2021-11-27 03:29:41,2021-11-27 03:29:41,To EUR Savings,0.01,0,EUR,COMPLETED,1773.93
TRANSFER,Savings,2021-11-27 20:51:59,2021-11-27 20:51:59,To EUR Savings,0.01,0,EUR,COMPLETED,1773.94
TRANSFER,Savings,2021-11-29 07:29:24,2021-11-29 07:29:24,To EUR Savings,20,0,EUR,COMPLETED,1793.94
TRANSFER,Savings,2021-11-29 13:03:44,2021-11-29 13:03:44,To EUR Savings,0.01,0,EUR,COMPLETED,1793.95
TRANSFER,Savings,2021-12-06 07:31:17,2021-12-06 07:31:17,To EUR Savings,20,0,EUR,COMPLETED,1813.95
TRANSFER,Savings,2021-12-08 03:37:25,2021-12-08 03:37:25,To EUR Savings,0.01,0,EUR,COMPLETED,1813.96
TRANSFER,Savings,2021-12-08 08:51:04,2021-12-08 08:51:04,To EUR Savings,0.01,0,EUR,COMPLETED,1813.97
TRANSFER,Savings,2021-12-09 06:34:09,2021-12-09 06:34:09,To EUR Savings,0.01,0,EUR,COMPLETED,1813.98
EXCHANGE,Savings,2021-12-09 14:37:02,2021-12-09 14:37:02,Exchange to EUR,0.88,0,EUR,COMPLETED,1814.86
TRANSFER,Savings,2021-12-10 12:35:11,2021-12-10 12:35:11,To EUR Savings,0.1,0,EUR,COMPLETED,1814.96
TRANSFER,Pocket,2021-12-10 12:38:03,2021-12-10 12:38:03,Balance migration to another region or legal entity,-100,0,EUR,COMPLETED,0
TRANSFER,Pocket,2021-12-10 12:38:03,2021-12-10 12:38:03,Balance migration to another region or legal entity,100,0,EUR,COMPLETED,100
TRANSFER,Pocket,2022-01-01 10:31:08,2022-01-01 10:31:08,To EUR Bills,100,0,EUR,COMPLETED,200
TRANSFER,Pocket,2022-01-24 08:00:00,2022-01-24 08:29:22,To GALP Power,-94.49,0,EUR,COMPLETED,105.51
TRANSFER,Pocket,2022-01-25 08:00:00,2022-01-25 08:19:44,To GALP Power,-5,0,EUR,COMPLETED,100.51
TRANSFER,Pocket,2022-01-28 08:00:00,2022-01-28 08:08:19,To Edp Comercial Comercializacao De Energia S.a,-12,0,EUR,COMPLETED,88.51
TRANSFER,Pocket,2022-02-01 10:31:28,2022-02-01 10:31:28,To EUR Bills,100,0,EUR,COMPLETED,188.51
TRANSFER,Pocket,2022-02-07 08:00:00,2022-02-07 08:08:45,To GALP Power,-39.8,0,EUR,COMPLETED,148.71
CARD_PAYMENT,Pocket,2022-02-20 03:38:48,2022-02-22 05:42:54,Netflix,-15.99,0,EUR,COMPLETED,132.72
TRANSFER,Pocket,2022-03-01 10:31:28,2022-03-01 10:31:28,To EUR Bills,100,0,EUR,COMPLETED,232.72
TRANSFER,Pocket,2022-03-09 08:00:00,2022-03-09 08:02:05,To GALP Power,-35.44,0,EUR,COMPLETED,197.28
CARD_PAYMENT,Pocket,2022-03-20 03:18:36,2022-03-21 10:42:23,Netflix,-15.99,0,EUR,COMPLETED,181.29
TRANSFER,Pocket,2022-04-01 11:33:39,2022-04-01 11:33:39,To EUR Bills,100,0,EUR,COMPLETED,281.29
TRANSFER,Pocket,2022-04-04 08:00:00,2022-04-04 08:27:37,To GALP Power,-22.54,0,EUR,COMPLETED,258.75
CARD_PAYMENT,Pocket,2022-04-20 05:04:32,2022-04-21 09:41:11,Netflix,-15.99,0,EUR,COMPLETED,242.76
TRANSFER,Pocket,2022-05-01 11:31:44,2022-05-01 11:31:44,To EUR Bills,100,0,EUR,COMPLETED,342.76
TRANSFER,Pocket,2022-05-03 08:00:00,2022-05-03 08:36:03,To GALP Power,-18.85,0,EUR,COMPLETED,323.91
CARD_PAYMENT,Pocket,2022-05-20 03:50:59,2022-05-22 01:27:06,Netflix,-15.99,0,EUR,COMPLETED,307.92
TRANSFER,Pocket,2022-06-01 11:33:28,2022-06-01 11:33:28,To EUR Bills,100,0,EUR,COMPLETED,407.92
TRANSFER,Pocket,2022-06-03 08:00:00,2022-06-03 08:15:07,To GALP Power,-21.52,0,EUR,COMPLETED,386.4
CARD_PAYMENT,Pocket,2022-06-20 04:19:43,2022-06-21 17:36:12,Netflix,-15.99,0,EUR,COMPLETED,370.41
TRANSFER,Pocket,2022-07-01 11:34:50,2022-07-01 11:34:50,To EUR Bills,100,0,EUR,COMPLETED,470.41
TRANSFER,Pocket,2022-07-07 08:00:00,2022-07-07 08:24:05,To GALP Power,-19.62,0,EUR,COMPLETED,450.79
CARD_PAYMENT,Pocket,2022-07-20 05:33:59,2022-07-21 10:44:20,Netflix,-15.99,0,EUR,COMPLETED,434.8
TRANSFER,Pocket,2022-08-01 11:33:49,2022-08-01 11:33:49,To EUR Bills,100,0,EUR,COMPLETED,534.8
TRANSFER,Pocket,2022-08-02 08:00:00,2022-08-02 08:07:08,To GALP Power,-20.32,0,EUR,COMPLETED,514.48
CARD_PAYMENT,Pocket,2022-08-20 03:54:05,2022-08-21 10:22:19,Netflix,-15.99,0,EUR,COMPLETED,498.49
TRANSFER,Pocket,2022-08-29 08:00:00,2022-08-29 08:05:13,To GALP Power,-17.33,0,EUR,COMPLETED,481.16
TRANSFER,Pocket,2022-09-01 11:34:56,2022-09-01 11:34:56,To EUR Bills,100,0,EUR,COMPLETED,581.16
CARD_PAYMENT,Pocket,2022-09-20 03:39:45,2022-09-21 12:05:30,Netflix,-15.99,0,EUR,COMPLETED,565.17
TRANSFER,Pocket,2022-10-01 11:34:19,2022-10-01 11:34:19,To EUR Bills,100,0,EUR,COMPLETED,665.17
CARD_PAYMENT,Pocket,2022-10-20 03:39:24,2022-10-21 11:40:30,Netflix,-15.99,0,EUR,COMPLETED,649.18
TRANSFER,Pocket,2022-11-01 10:35:01,2022-11-01 10:35:01,To EUR Bills,100,0,EUR,COMPLETED,749.18
CARD_PAYMENT,Pocket,2022-11-20 03:20:13,2022-11-21 09:16:38,Netflix,-15.99,0,EUR,COMPLETED,733.19
TRANSFER,Pocket,2022-12-01 16:21:24,2022-12-01 16:21:24,To EUR Bills,100,0,EUR,COMPLETED,833.19
CARD_PAYMENT,Pocket,2022-12-20 04:30:46,2022-12-21 09:31:17,Netflix,-15.99,0,EUR,COMPLETED,817.2
TRANSFER,Pocket,2023-01-01 10:36:28,2023-01-01 10:36:28,To EUR Bills,100,0,EUR,COMPLETED,917.2
CARD_PAYMENT,Pocket,2023-01-20 04:11:37,2023-01-21 08:53:52,Netflix,-15.99,0,EUR,COMPLETED,901.21
TRANSFER,Pocket,2023-02-01 16:32:25,2023-02-01 16:32:25,To EUR Bills,100,0,EUR,COMPLETED,1001.21
TRANSFER,Pocket,2023-11-21 08:36:07,2023-11-21 08:36:07,To EUR,-1001.21,0,EUR,COMPLETED,0
TRANSFER,Pocket,2023-11-21 08:36:07,2023-11-21 08:36:07,Closing transaction,0,0,EUR,COMPLETED,0
TRANSFER,Pocket,2023-11-21 08:39:34,2023-11-21 08:39:34,To EUR Subscriptions,100,0,EUR,COMPLETED,100
CARD_PAYMENT,Pocket,2023-11-27 00:38:12,2023-11-28 10:38:26,Apple,-1.99,0,EUR,COMPLETED,98.01
CARD_PAYMENT,Pocket,2023-11-27 00:33:38,2023-11-28 10:49:16,Apple,-5.49,0,EUR,COMPLETED,92.52
CARD_PAYMENT,Pocket,2023-11-30 02:53:41,2023-12-01 11:42:31,Apple,-18.95,0,EUR,COMPLETED,73.57
CARD_PAYMENT,Pocket,2023-12-10 23:19:16,2023-12-12 11:49:13,Apple,-3.99,0,EUR,COMPLETED,69.58
CARD_PAYMENT,Pocket,2023-12-16 15:44:34,2023-12-17 12:39:23,Apple,-30.99,0,EUR,COMPLETED,38.59
TRANSFER,Pocket,2023-12-21 10:07:05,2023-12-21 10:07:05,To EUR Subscriptions,100,0,EUR,COMPLETED,138.59
CARD_PAYMENT,Pocket,2023-12-27 00:33:23,2023-12-28 11:56:14,Apple,-1.99,0,EUR,COMPLETED,136.6
CARD_PAYMENT,Pocket,2023-12-27 00:33:59,2023-12-28 11:56:25,Apple,-5.49,0,EUR,COMPLETED,131.11
CARD_PAYMENT,Pocket,2023-12-29 17:26:54,2023-12-31 10:40:34,Apple,-4.99,0,EUR,COMPLETED,126.12
CARD_PAYMENT,Pocket,2024-01-08 09:36:11,2024-01-09 11:02:29,Apple,-59,0,EUR,COMPLETED,67.12
CARD_PAYMENT,Pocket,2024-01-17 05:34:52,2024-01-18 08:55:08,Apple,-5.99,0,EUR,COMPLETED,61.13
TRANSFER,Pocket,2024-01-21 10:03:53,2024-01-21 10:03:53,To EUR Subscriptions,100,0,EUR,COMPLETED,161.13
CARD_PAYMENT,Pocket,2024-01-29 13:51:56,2024-01-30 10:35:20,Apple,-5.49,0,EUR,COMPLETED,155.64
CARD_PAYMENT,Pocket,2024-02-06 08:34:50,2024-02-07 09:56:14,Apple,-35,0,EUR,COMPLETED,120.64
CARD_PAYMENT,Pocket,2024-02-12 16:54:39,2024-02-15 14:58:47,Apple,-3.99,0,EUR,COMPLETED,116.65
CARD_PAYMENT,Pocket,2024-02-17 05:36:37,2024-02-18 10:16:48,Apple,-5.99,0,EUR,COMPLETED,110.66
TRANSFER,Pocket,2024-02-21 10:04:52,2024-02-21 10:04:52,To EUR Subscriptions,100,0,EUR,COMPLETED,210.66
CARD_PAYMENT,Pocket,2024-02-29 02:54:05,2024-03-01 11:55:57,Apple,-21.95,0,EUR,COMPLETED,188.71
TRANSFER,Pocket,2024-03-21 10:08:45,2024-03-21 10:08:45,To EUR Subscriptions,100,0,EUR,COMPLETED,288.71
CARD_PAYMENT,Pocket,2024-03-30 01:53:37,2024-04-01 10:27:16,Apple,-21.95,0,EUR,COMPLETED,266.76
CARD_PAYMENT,Pocket,2024-04-01 22:23:55,2024-04-04 11:14:52,Apple,-3.99,0,EUR,COMPLETED,262.77
CARD_PAYMENT,Pocket,2024-04-09 01:01:52,2024-04-11 10:42:07,Apple,-35.99,0,EUR,COMPLETED,226.78
CARD_PAYMENT,Pocket,2024-04-13 12:22:43,2024-04-15 10:35:58,Apple,-27.49,0,EUR,COMPLETED,199.29
TRANSFER,Pocket,2024-04-21 11:04:21,2024-04-21 11:04:21,To EUR Subscriptions,100,0,EUR,COMPLETED,299.29
CARD_PAYMENT,Pocket,2024-04-30 02:53:43,2024-05-02 11:36:05,Apple,-21.95,0,EUR,COMPLETED,277.34
CARD_PAYMENT,Pocket,2024-04-29 05:52:44,2024-05-02 11:54:28,Apple,-5.49,0,EUR,COMPLETED,271.85
CARD_PAYMENT,Pocket,2024-05-06 09:31:07,2024-05-07 10:51:24,Apple,-59,0,EUR,COMPLETED,212.85
TRANSFER,Pocket,2024-05-21 11:05:25,2024-05-21 11:05:25,To EUR Subscriptions,100,0,EUR,COMPLETED,312.85
CARD_PAYMENT,Pocket,2024-05-25 20:27:31,2024-05-27 10:34:30,Apple,-2.49,0,EUR,COMPLETED,310.36
CARD_PAYMENT,Pocket,2024-05-30 02:53:56,2024-05-31 10:17:24,Apple,-21.95,0,EUR,COMPLETED,288.41
CARD_PAYMENT,Pocket,2024-06-17 20:58:27,2024-06-20 10:34:55,Apple,-3.99,0,EUR,COMPLETED,284.42
TRANSFER,Pocket,2024-06-21 11:12:13,2024-06-21 11:12:13,To EUR Subscriptions,100,0,EUR,COMPLETED,384.42
CARD_PAYMENT,Pocket,2024-06-23 21:25:50,2024-06-25 10:59:04,Apple,-59,0,EUR,COMPLETED,325.42
CARD_PAYMENT,Pocket,2024-06-29 05:52:31,2024-06-30 10:51:16,Apple,-5.49,0,EUR,COMPLETED,319.93
CARD_PAYMENT,Pocket,2024-06-30 02:53:40,2024-07-02 10:19:40,Apple,-21.95,0,EUR,COMPLETED,297.98
TRANSFER,Pocket,2024-07-21 11:03:52,2024-07-21 11:03:52,To EUR Subscriptions,100,0,EUR,COMPLETED,397.98
CARD_PAYMENT,Pocket,2024-07-29 05:52:31,2024-07-30 11:12:56,Apple,-5.49,0,EUR,COMPLETED,392.49
CARD_PAYMENT,Pocket,2024-07-30 02:53:37,2024-07-31 09:44:47,Apple,-21.95,0,EUR,COMPLETED,370.54
CARD_PAYMENT,Pocket,2024-08-15 17:20:20,2024-08-18 08:52:04,Apple,-3.99,0,EUR,COMPLETED,366.55
TRANSFER,Pocket,2024-08-21 11:04:54,2024-08-21 11:04:54,To EUR Subscriptions,100,0,EUR,COMPLETED,466.55
CARD_PAYMENT,Pocket,2024-08-29 05:52:04,2024-08-30 09:51:38,Apple,-5.49,0,EUR,COMPLETED,461.06
CARD_PAYMENT,Pocket,2024-08-30 02:55:24,2024-08-31 09:44:16,Apple,-21.95,0,EUR,COMPLETED,439.11
CARD_PAYMENT,Pocket,2024-09-13 22:42:12,2024-09-16 09:16:58,Apple,-3.99,0,EUR,COMPLETED,435.12
TRANSFER,Pocket,2024-09-19 09:04:29,2024-09-19 09:04:29,To EUR,-435.12,0,EUR,COMPLETED,0
TRANSFER,Pocket,2024-09-19 09:04:29,2024-09-19 09:04:29,Closing transaction,0,0,EUR,COMPLETED,0
TRANSFER,Current,2021-12-10 12:38:03,2021-12-10 12:38:03,Balance migration to another region or legal entity,-923.08,0,EUR,COMPLETED,249.89
TRANSFER,Current,2021-12-10 12:38:03,2021-12-10 12:38:03,Balance migration to another region or legal entity,923.08,0,EUR,COMPLETED,1172.97
CARD_PAYMENT,Current,2021-12-09 06:34:08,2021-12-11 15:16:17,Apple,-4.99,0,EUR,COMPLETED,1167.98
CARD_PAYMENT,Current,2021-12-10 12:35:02,2021-12-11 19:48:45,Pcdiga,-244.9,0,EUR,COMPLETED,923.08
TRANSFER,Current,2021-12-12 07:48:03,2021-12-12 07:48:03,To EUR Savings,-0.01,0,EUR,COMPLETED,923.07
TRANSFER,Current,2021-12-13 07:32:05,2021-12-13 07:32:05,To EUR Savings,-20,0,EUR,COMPLETED,903.07
CARD_PAYMENT,Current,2021-12-12 07:48:03,2021-12-13 12:22:57,PayPal,-160.99,0,EUR,COMPLETED,742.08
TRANSFER,Current,2021-12-16 10:32:44,2021-12-16 10:32:44,To EUR Savings,-0.55,0,EUR,COMPLETED,741.53
CARD_PAYMENT,Current,2021-12-16 10:32:15,2021-12-17 05:48:44,Minipreço,-5.45,0,EUR,COMPLETED,736.08
TRANSFER,Current,2021-12-17 21:40:57,2021-12-17 21:40:57,To EUR Savings,-0.51,0,EUR,COMPLETED,735.57
CARD_PAYMENT,Current,2021-12-17 21:40:57,2021-12-19 12:44:54,YouTube,-8.49,0,EUR,COMPLETED,727.08
TRANSFER,Current,2021-12-20 07:34:47,2021-12-20 07:34:47,To EUR Savings,-20,0,EUR,COMPLETED,707.08
TRANSFER,Current,2021-12-20 17:41:15,2021-12-20 17:41:15,To EUR Savings,-0.21,0,EUR,COMPLETED,706.87
TRANSFER,Current,2021-12-22 11:46:40,2021-12-22 11:46:40,To EUR Savings,-1,0,EUR,COMPLETED,705.87
CARD_PAYMENT,Current,2021-12-20 17:41:15,2021-12-23 06:42:04,Google Zierlyn,-0.79,0,EUR,COMPLETED,705.08
TRANSFER,Current,2021-12-23 08:00:00,2021-12-23 08:02:34,To GALP Power,-73.86,0,EUR,COMPLETED,631.22
CARD_PAYMENT,Current,2021-12-22 11:46:29,2021-12-23 19:55:14,Poupafarma,-51,0,EUR,COMPLETED,580.22
TRANSFER,Current,2021-12-27 07:36:08,2021-12-27 07:36:08,To EUR Savings,-20,0,EUR,COMPLETED,560.22
TRANSFER,Current,2021-12-27 08:00:00,2021-12-27 08:15:33,To GALP Power,-5,0,EUR,COMPLETED,555.22
TRANSFER,Current,2021-12-29 08:00:00,2021-12-29 08:25:54,To Edp Comercial Comercializacao De Energia S.a,-12,0,EUR,COMPLETED,543.22
TRANSFER,Current,2021-12-29 13:03:49,2021-12-29 13:03:49,To EUR Savings,-0.01,0,EUR,COMPLETED,543.21
CARD_PAYMENT,Current,2021-12-29 13:03:43,2021-12-30 10:36:49,Google,-2.99,0,EUR,COMPLETED,540.22
TRANSFER,Current,2021-12-30 12:44:33,2021-12-30 12:44:33,To EUR Savings,-0.1,0,EUR,COMPLETED,540.12
CARD_PAYMENT,Current,2021-12-30 12:44:26,2021-12-31 11:33:46,Steam,-18.9,0,EUR,COMPLETED,521.22
TRANSFER,Current,2021-12-31 18:26:51,2021-12-31 18:26:51,To EUR Savings,-0.01,0,EUR,COMPLETED,521.21
TRANSFER,Current,2022-01-01 00:14:17,2022-01-01 00:14:17,To EUR Savings,-0.4,0,EUR,COMPLETED,520.81
TRANSFER,Current,2022-01-01 00:15:04,2022-01-01 00:15:04,To EUR Savings,-0.06,0,EUR,COMPLETED,520.75
TRANSFER,Current,2022-01-01 00:21:41,2022-01-01 00:21:41,To EUR Savings,-0.6,0,EUR,COMPLETED,520.15
TOPUP,Current,2022-01-01 10:26:32,2022-01-01 10:26:37,Apple Pay Top-Up by *6660,500,0,EUR,COMPLETED,1020.15
TRANSFER,Current,2022-01-01 10:31:08,2022-01-01 10:31:08,To EUR Bills,-100,0,EUR,COMPLETED,920.15
CARD_PAYMENT,Current,2021-12-31 18:26:46,2022-01-01 12:26:47,Google,-17.99,0,EUR,COMPLETED,902.16
CARD_PAYMENT,Current,2022-01-01 00:21:41,2022-01-02 09:47:55,PayPal,-34.4,0,EUR,COMPLETED,867.76
TRANSFER,Current,2022-01-03 07:39:35,2022-01-03 07:39:35,To EUR Savings,-20,0,EUR,COMPLETED,847.76
TRANSFER,Current,2022-01-03 08:00:00,2022-01-03 10:05:00,To GALP Power,-31.09,0,EUR,COMPLETED,816.67
TRANSFER,Current,2022-01-06 21:14:09,2022-01-06 21:14:09,To EUR Savings,-1,0,EUR,COMPLETED,815.67
CARD_PAYMENT,Current,2022-01-06 21:14:09,2022-01-08 11:07:39,PayPal,-51,0,EUR,COMPLETED,764.67
TRANSFER,Current,2022-01-10 07:44:55,2022-01-10 07:44:55,To EUR Savings,-20,0,EUR,COMPLETED,744.67
TRANSFER,Current,2022-01-10 10:10:24,2022-01-10 10:10:24,To EUR Savings,-0.02,0,EUR,COMPLETED,744.65
CARD_PAYMENT,Current,2022-01-10 10:10:23,2022-01-11 11:40:01,Pedrohierro,-71.98,0,EUR,COMPLETED,672.67
TEMP_BLOCK,Current,2022-01-12 09:30:23,,To Vasco,-92,0,EUR,REVERTED,
TRANSFER,Current,2022-01-12 09:32:09,2022-01-12 09:32:09,Revolut Bank UAB,-92,0,EUR,COMPLETED,580.67
TRANSFER,Current,2022-01-12 20:47:45,2022-01-12 20:47:45,To EUR Savings,-0.01,0,EUR,COMPLETED,580.66
CARD_PAYMENT,Current,2022-01-12 20:47:45,2022-01-14 11:08:59,Google,-19.99,0,EUR,COMPLETED,560.67
TRANSFER,Current,2022-01-15 10:02:38,2022-01-15 10:02:38,To EUR Savings,-0.62,0,EUR,COMPLETED,560.05
TRANSFER,Current,2022-01-15 14:33:34,2022-01-15 14:33:34,To EUR Savings,-0.33,0,EUR,COMPLETED,559.72
CARD_PAYMENT,Current,2022-01-15 10:01:46,2022-01-16 05:31:08,Auchan,-22.38,0,EUR,COMPLETED,537.34
CARD_PAYMENT,Current,2022-01-15 14:03:20,2022-01-16 11:21:28,Autodoc Ag 6,-107.67,0,EUR,COMPLETED,429.67
TRANSFER,Current,2022-01-16 13:04:42,2022-01-16 13:04:42,To EUR Savings,-0.7,0,EUR,COMPLETED,428.97
TRANSFER,Current,2022-01-16 14:07:40,2022-01-16 14:07:40,To EUR Savings,-0.05,0,EUR,COMPLETED,428.92
CARD_PAYMENT,Current,2022-01-16 14:07:21,2022-01-17 05:24:50,Hosp. Vivemos Gato,-22.95,0,EUR,COMPLETED,405.97
CARD_PAYMENT,Current,2022-01-16 13:04:25,2022-01-17 05:26:32,Mercado de Algés,-3.3,0,EUR,COMPLETED,402.67
TRANSFER,Current,2022-01-17 07:43:09,2022-01-17 07:43:09,To EUR Savings,-20,0,EUR,COMPLETED,382.67
TRANSFER,Current,2022-01-17 08:41:15,2022-01-17 08:41:15,To EUR Savings,-0.79,0,EUR,COMPLETED,381.88
TRANSFER,Current,2022-01-17 21:41:03,2022-01-17 21:41:03,To EUR Savings,-0.51,0,EUR,COMPLETED,381.37
CARD_PAYMENT,Current,2022-01-17 08:41:09,2022-01-18 05:30:24,Minipreço,-10.21,0,EUR,COMPLETED,371.16
CARD_PAYMENT,Current,2022-01-17 21:40:57,2022-01-19 10:51:04,YouTube,-8.49,0,EUR,COMPLETED,362.67
TOPUP,Current,2022-01-19 23:02:19,2022-01-19 23:02:24,Apple Pay Top-Up by *6660,300,0,EUR,COMPLETED,662.67
TRANSFER,Current,2022-01-21 16:22:09,2022-01-21 16:22:09,To EUR Savings,-0.9,0,EUR,COMPLETED,661.77
TRANSFER,Current,2022-01-22 08:36:45,2022-01-22 08:36:45,To EUR Savings,-1,0,EUR,COMPLETED,660.77
CARD_PAYMENT,Current,2022-01-21 14:25:15,2022-01-22 12:45:07,Nos Cinemas,-7.1,0,EUR,COMPLETED,653.67
TRANSFER,Current,2022-01-22 14:40:04,2022-01-22 14:40:04,To EUR Savings,-0.7,0,EUR,COMPLETED,652.97
CARD_PAYMENT,Current,2022-01-22 08:36:45,2022-01-23 04:42:59,Poke House - Miraflores,-3,0,EUR,COMPLETED,649.97
CARD_PAYMENT,Current,2022-01-22 13:16:46,2022-01-23 04:42:59,Rua Luís de Camões,-22.3,0,EUR,COMPLETED,627.67
TRANSFER,Current,2022-01-23 08:26:32,2022-01-23 08:26:32,To EUR Savings,-1,0,EUR,COMPLETED,626.67
TRANSFER,Current,2022-01-23 08:34:44,2022-01-23 08:34:44,To EUR Savings,-0.41,0,EUR,COMPLETED,626.26
TRANSFER,Current,2022-01-23 14:11:30,2022-01-23 14:11:30,To EUR Savings,-0.5,0,EUR,COMPLETED,625.76
TRANSFER,Current,2022-01-23 14:26:33,2022-01-23 14:26:33,To EUR Savings,-0.2,0,EUR,COMPLETED,625.56
CARD_PAYMENT,Current,2022-01-23 08:34:44,2022-01-24 05:28:22,Minipreço,-5.59,0,EUR,COMPLETED,619.97
CARD_PAYMENT,Current,2022-01-23 13:55:09,2022-01-24 05:40:48,Saisish,-11.5,0,EUR,COMPLETED,608.47
CARD_PAYMENT,Current,2022-01-23 14:07:39,2022-01-24 05:40:48,Rest Naipe D Emocoes,-4.8,0,EUR,COMPLETED,603.67
TRANSFER,Current,2022-01-24 07:45:17,2022-01-24 07:45:17,To EUR Savings,-20,0,EUR,COMPLETED,583.67
TRANSFER,Current,2022-01-24 13:13:20,2022-01-24 13:13:20,To EUR Savings,-1,0,EUR,COMPLETED,582.67
CARD_PAYMENT,Current,2022-01-24 12:47:27,2022-01-25 13:33:27,Farmacialor,-48,0,EUR,COMPLETED,534.67
CARD_PAYMENT,Current,2022-01-23 08:26:31,2022-01-26 11:16:12,Calzedonia,-28,0,EUR,COMPLETED,506.67
TRANSFER,Current,2022-01-28 13:48:50,2022-01-28 13:48:50,To EUR Savings,-0.12,0,EUR,COMPLETED,506.55
TRANSFER,Current,2022-01-28 17:11:56,2022-01-28 17:11:56,To EUR Savings,-0.59,0,EUR,COMPLETED,505.96
TOPUP,Current,2022-01-28 20:23:12,2022-01-28 20:23:19,Apple Pay Top-Up by *6660,500,0,EUR,COMPLETED,1005.96
TRANSFER,Current,2022-01-29 08:40:24,2022-01-29 08:40:24,To EUR Savings,-1,0,EUR,COMPLETED,1004.96
TRANSFER,Current,2022-01-29 14:03:06,2022-01-29 14:03:06,To EUR Savings,-0.01,0,EUR,COMPLETED,1004.95
TRANSFER,Current,2022-01-29 14:42:18,2022-01-29 14:42:18,To EUR Savings,-0.5,0,EUR,COMPLETED,1004.45
TRANSFER,Current,2022-01-29 14:46:25,2022-01-29 14:46:25,To EUR Savings,-1,0,EUR,COMPLETED,1003.45
TRANSFER,Current,2022-01-29 19:19:51,2022-01-29 19:19:51,To EUR Savings,-1,0,EUR,COMPLETED,1002.45
CARD_PAYMENT,Current,2022-01-28 12:40:32,2022-01-29 20:15:18,Uber Eats,-15.88,0,EUR,COMPLETED,986.57
CARD_PAYMENT,Current,2022-01-28 14:10:52,2022-01-29 20:33:16,Uber Eats,-1.41,0,EUR,COMPLETED,985.16
TRANSFER,Current,2022-01-31 07:52:57,2022-01-31 07:52:57,To EUR Savings,-20,0,EUR,COMPLETED,965.16
CARD_PAYMENT,Current,2022-01-29 08:40:23,2022-01-31 11:56:51,Poke House - Miraflores,-3,0,EUR,COMPLETED,962.16
CARD_PAYMENT,Current,2022-01-29 16:26:14,2022-01-31 11:56:51,National Coach Museum,-24,0,EUR,COMPLETED,938.16
CARD_PAYMENT,Current,2022-01-29 13:33:59,2022-01-31 11:56:51,Saisish,-23,0,EUR,COMPLETED,915.16
CARD_PAYMENT,Current,2022-01-29 13:31:08,2022-01-31 11:56:51,Mercado de Algés,-1.5,0,EUR,COMPLETED,913.66
TRANSFER,Current,2022-01-31 15:50:56,2022-01-31 15:50:56,To EUR Savings,-0.5,0,EUR,COMPLETED,913.16
CARD_PAYMENT,Current,2022-01-29 13:03:40,2022-01-31 17:12:23,Google,-2.99,0,EUR,COMPLETED,910.17
TRANSFER,Current,2022-02-01 10:31:28,2022-02-01 10:31:28,To EUR Bills,-100,0,EUR,COMPLETED,810.17
CARD_REFUND,Current,2022-02-01 00:00:00,2022-02-01 21:49:37,Calzedonia,8.8,0,EUR,COMPLETED,818.97
CARD_PAYMENT,Current,2022-01-31 14:13:59,2022-02-01 22:32:34,Nos Cinemas,-35.5,0,EUR,COMPLETED,783.47
TRANSFER,Current,2022-02-02 10:10:11,2022-02-02 10:10:11,To EUR Savings,-0.01,0,EUR,COMPLETED,783.46
TRANSFER,Current,2022-02-02 13:08:56,2022-02-02 13:08:56,To EUR Savings,-0.86,0,EUR,COMPLETED,782.6
TRANSFER,Current,2022-02-02 13:36:26,2022-02-02 13:36:26,To EUR Savings,-0.13,0,EUR,COMPLETED,782.47
CARD_PAYMENT,Current,2022-02-02 12:41:10,2022-02-03 12:16:38,Uber Eats,-20.87,0,EUR,COMPLETED,761.6
CARD_PAYMENT,Current,2022-02-02 10:04:36,2022-02-03 12:40:40,PayPal,-16.99,0,EUR,COMPLETED,744.61
CARD_PAYMENT,Current,2022-02-02 12:24:34,2022-02-03 12:50:47,Amazon,-9.14,0,EUR,COMPLETED,735.47
TRANSFER,Current,2022-02-04 19:35:38,2022-02-04 19:35:38,To EUR Savings,-0.51,0,EUR,COMPLETED,734.96
CARD_PAYMENT,Current,2022-02-04 18:08:55,2022-02-05 06:16:27,Minipreço,-23.49,0,EUR,COMPLETED,711.47
TRANSFER,Current,2022-02-05 08:49:34,2022-02-05 08:49:34,To EUR Savings,-1,0,EUR,COMPLETED,710.47
TRANSFER,Current,2022-02-05 13:13:26,2022-02-05 13:13:26,To EUR Savings,-0.1,0,EUR,COMPLETED,710.37
TRANSFER,Current,2022-02-05 13:22:56,2022-02-05 13:22:56,To EUR Savings,-0.3,0,EUR,COMPLETED,710.07
TRANSFER,Current,2022-02-05 15:54:39,2022-02-05 15:54:39,To EUR Savings,-1,0,EUR,COMPLETED,709.07
TRANSFER,Current,2022-02-05 20:38:30,2022-02-05 20:38:30,To EUR Savings,-0.71,0,EUR,COMPLETED,708.36
TRANSFER,Current,2022-02-05 22:40:35,2022-02-05 22:40:35,To EUR Savings,-0.65,0,EUR,COMPLETED,707.71
CARD_PAYMENT,Current,2022-02-05 13:13:16,2022-02-06 07:19:34,Rua Luís de Camões,-9.9,0,EUR,COMPLETED,697.81
CARD_PAYMENT,Current,2022-02-05 15:53:55,2022-02-06 07:19:34,Music Factory,-8,0,EUR,COMPLETED,689.81
CARD_PAYMENT,Current,2022-02-05 08:49:34,2022-02-06 07:19:34,Poke House - Miraflores,-3,0,EUR,COMPLETED,686.81
CARD_PAYMENT,Current,2022-02-05 13:22:40,2022-02-06 07:19:34,Rest Naipe D Emocoes,-3.7,0,EUR,COMPLETED,683.11
TRANSFER,Current,2022-02-06 09:20:09,2022-02-06 09:20:09,To EUR Savings,-1,0,EUR,COMPLETED,682.11
TRANSFER,Current,2022-02-06 15:19:25,2022-02-06 15:19:25,To EUR Savings,-0.62,0,EUR,COMPLETED,681.49
TRANSFER,Current,2022-02-06 16:44:34,2022-02-06 16:44:34,To EUR Savings,-0.01,0,EUR,COMPLETED,681.48
TOPUP,Current,2022-02-06 16:45:08,2022-02-06 16:45:12,Apple Pay Top-Up by *6660,500,0,EUR,COMPLETED,1181.48
CARD_PAYMENT,Current,2022-02-05 20:38:27,2022-02-07 04:43:11,Minipreço,-3.29,0,EUR,COMPLETED,1178.19
CARD_PAYMENT,Current,2022-02-06 15:19:25,2022-02-07 04:43:12,LISBOA,-73.38,0,EUR,COMPLETED,1104.81
CARD_PAYMENT,Current,2022-02-06 09:20:08,2022-02-07 04:56:30,Poke House - Miraflores,-3,0,EUR,COMPLETED,1101.81
TRANSFER,Current,2022-02-07 07:51:27,2022-02-07 07:51:27,To EUR Savings,-20,0,EUR,COMPLETED,1081.81
TRANSFER,Current,2022-02-07 08:41:42,2022-02-07 08:41:42,To EUR Savings,-0.65,0,EUR,COMPLETED,1081.16
CARD_PAYMENT,Current,2022-02-05 22:40:29,2022-02-07 12:56:40,Amazon,-13.35,0,EUR,COMPLETED,1067.81
TRANSFER,Current,2022-02-08 08:50:59,2022-02-08 08:50:59,To EUR Savings,-0.01,0,EUR,COMPLETED,1067.8
TRANSFER,Current,2022-02-08 09:30:10,2022-02-08 09:30:10,To EUR Savings,-0.7,0,EUR,COMPLETED,1067.1
CARD_PAYMENT,Current,2022-02-07 08:41:42,2022-02-08 23:19:25,Minipreço,-4.35,0,EUR,COMPLETED,1062.75
CARD_PAYMENT,Current,2022-02-06 16:44:34,2022-02-09 03:37:44,Apple,-199.99,0,EUR,COMPLETED,862.76
TRANSFER,Current,2022-02-09 08:33:32,2022-02-09 08:33:32,To EUR Savings,-0.68,0,EUR,COMPLETED,862.08
CARD_PAYMENT,Current,2022-02-08 09:30:06,2022-02-09 14:53:37,Minipreço,-4.3,0,EUR,COMPLETED,857.78
CARD_PAYMENT,Current,2022-02-08 08:50:54,2022-02-09 19:00:34,Apple,-0.99,0,EUR,COMPLETED,856.79
CARD_PAYMENT,Current,2022-02-09 08:33:32,2022-02-10 07:53:57,Minipreço,-2.32,0,EUR,COMPLETED,854.47
TRANSFER,Current,2022-02-11 12:03:16,2022-02-11 12:03:16,To EUR Savings,-0.55,0,EUR,COMPLETED,853.92
TRANSFER,Current,2022-02-11 14:13:04,2022-02-11 14:13:04,To EUR Savings,-1,0,EUR,COMPLETED,852.92
CARD_PAYMENT,Current,2022-02-11 13:40:21,2022-02-12 06:18:35,Brasa De Sassoeiros,-19,0,EUR,COMPLETED,833.92
TRANSFER,Current,2022-02-12 09:14:03,2022-02-12 09:14:03,To EUR Savings,-1,0,EUR,COMPLETED,832.92
CARD_PAYMENT,Current,2022-02-11 11:55:19,2022-02-12 11:51:45,Uber,-4.45,0,EUR,COMPLETED,828.47
TRANSFER,Current,2022-02-12 14:03:13,2022-02-12 14:03:13,To EUR Savings,-0.1,0,EUR,COMPLETED,828.37
TRANSFER,Current,2022-02-12 22:50:25,2022-02-12 22:50:25,To EUR Savings,-1,0,EUR,COMPLETED,827.37
TRANSFER,Current,2022-02-13 09:16:11,2022-02-13 09:16:11,To EUR Savings,-1,0,EUR,COMPLETED,826.37
TRANSFER,Current,2022-02-13 13:07:44,2022-02-13 13:07:44,To EUR Savings,-0.62,0,EUR,COMPLETED,825.75
CARD_PAYMENT,Current,2022-02-12 09:14:02,2022-02-13 21:13:38,Poke House - Miraflores,-3,0,EUR,COMPLETED,822.75
CARD_PAYMENT,Current,2022-02-12 13:13:45,2022-02-13 21:13:38,Rua Luís de Camões,-9.9,0,EUR,COMPLETED,812.85
CARD_PAYMENT,Current,2022-02-13 13:07:42,2022-02-14 05:09:27,Minipreço,-6.38,0,EUR,COMPLETED,806.47
CARD_PAYMENT,Current,2022-02-13 09:16:10,2022-02-14 05:21:17,Poke House - Miraflores,-3,0,EUR,COMPLETED,803.47
CARD_PAYMENT,Current,2022-02-12 21:22:46,2022-02-14 05:21:17,Cockpit bar,-51,0,EUR,COMPLETED,752.47
TRANSFER,Current,2022-02-14 07:52:15,2022-02-14 07:52:15,To EUR Savings,-20,0,EUR,COMPLETED,732.47
TRANSFER,Current,2022-02-14 12:42:09,2022-02-14 12:42:09,To EUR Savings,-0.75,0,EUR,COMPLETED,731.72
TRANSFER,Current,2022-02-14 20:22:03,2022-02-14 20:22:03,To EUR Savings,-0.39,0,EUR,COMPLETED,731.33
TRANSFER,Current,2022-02-15 08:28:30,2022-02-15 08:28:30,To EUR Savings,-0.27,0,EUR,COMPLETED,731.06
CARD_PAYMENT,Current,2022-02-14 12:41:45,2022-02-15 12:49:44,Uber Eats,-15.25,0,EUR,COMPLETED,715.81
TRANSFER,Current,2022-02-15 12:54:50,2022-02-15 12:54:50,To EUR Savings,-0.01,0,EUR,COMPLETED,715.8
TRANSFER,Current,2022-02-15 13:19:05,2022-02-15 13:19:05,To EUR Savings,-1,0,EUR,COMPLETED,714.8
CARD_PAYMENT,Current,2022-02-15 08:28:24,2022-02-16 05:09:48,Minipreço,-10.73,0,EUR,COMPLETED,704.07
CARD_PAYMENT,Current,2022-02-14 20:21:57,2022-02-16 05:23:53,Pingo Doce,-9.61,0,EUR,COMPLETED,694.46
CARD_PAYMENT,Current,2022-02-15 12:54:34,2022-02-16 18:53:39,Elevensport,-11.99,0,EUR,COMPLETED,682.47
CARD_PAYMENT,Current,2022-02-15 13:18:43,2022-02-17 12:02:26,Apple,-25,0,EUR,COMPLETED,657.47
TRANSFER,Current,2022-02-17 21:44:07,2022-02-17 21:44:07,To EUR Savings,-0.51,0,EUR,COMPLETED,656.96
TRANSFER,Current,2022-02-19 08:31:56,2022-02-19 08:31:56,To EUR Savings,-1,0,EUR,COMPLETED,655.96
CARD_PAYMENT,Current,2022-02-17 21:40:57,2022-02-19 11:09:52,YouTube,-8.49,0,EUR,COMPLETED,647.47
TRANSFER,Current,2022-02-19 19:21:23,2022-02-19 19:21:23,To EUR Savings,-0.42,0,EUR,COMPLETED,647.05
CARD_PAYMENT,Current,2022-02-19 08:31:56,2022-02-20 07:25:11,A Padaria Portuguesa,-3,0,EUR,COMPLETED,644.05
TRANSFER,Current,2022-02-20 10:10:48,2022-02-20 10:10:48,To EUR Savings,-0.05,0,EUR,COMPLETED,644
TRANSFER,Current,2022-02-20 13:13:08,2022-02-20 13:13:08,To EUR Savings,-0.5,0,EUR,COMPLETED,643.5
TRANSFER,Current,2022-02-20 13:20:42,2022-02-20 13:20:42,To EUR Savings,-0.8,0,EUR,COMPLETED,642.7
TRANSFER,Current,2022-02-20 13:47:09,2022-02-20 13:47:09,To EUR Savings,-0.2,0,EUR,COMPLETED,642.5
TRANSFER,Current,2022-02-20 20:55:17,2022-02-20 20:55:17,To EUR Savings,-0.01,0,EUR,COMPLETED,642.49
CARD_PAYMENT,Current,2022-02-20 10:10:47,2022-02-21 05:26:37,Pingo Doce,-12.95,0,EUR,COMPLETED,629.54
CARD_PAYMENT,Current,2022-02-20 13:46:59,2022-02-21 05:26:37,Rest Naipe D Emocoes,-1.8,0,EUR,COMPLETED,627.74
CARD_PAYMENT,Current,2022-02-20 13:20:30,2022-02-21 05:26:37,Rest Naipe D Emocoes,-5.2,0,EUR,COMPLETED,622.54
CARD_PAYMENT,Current,2022-02-20 13:12:50,2022-02-21 05:26:37,Receita Pomposa,-10.5,0,EUR,COMPLETED,612.04
TRANSFER,Current,2022-02-21 07:53:57,2022-02-21 07:53:57,To EUR Savings,-20,0,EUR,COMPLETED,592.04
TRANSFER,Current,2022-02-21 10:17:32,2022-02-21 10:17:32,To EUR Savings,-0.58,0,EUR,COMPLETED,591.46
CARD_PAYMENT,Current,2022-02-19 19:21:15,2022-02-22 05:50:35,Amazon,-36.58,0,EUR,COMPLETED,554.88
CARD_PAYMENT,Current,2022-02-21 10:17:31,2022-02-22 07:58:27,Minipreço,-10.42,0,EUR,COMPLETED,544.46
CARD_PAYMENT,Current,2022-02-20 20:55:12,2022-02-22 13:21:22,iTunes,-2.99,0,EUR,COMPLETED,541.47
TRANSFER,Current,2022-02-22 14:11:25,2022-02-22 14:11:25,To EUR Savings,-0.75,0,EUR,COMPLETED,540.72
TRANSFER,Current,2022-02-23 10:13:02,2022-02-23 10:13:02,To EUR Savings,-0.59,0,EUR,COMPLETED,540.13
CARD_PAYMENT,Current,2022-02-22 13:31:54,2022-02-23 10:18:37,Uber Eats,-15.25,0,EUR,COMPLETED,524.88
CARD_PAYMENT,Current,2022-02-23 10:13:01,2022-02-24 05:47:58,Minipreço,-5.41,0,EUR,COMPLETED,519.47
TRANSFER,Current,2022-02-24 12:55:33,2022-02-24 12:55:33,To EUR Savings,-0.75,0,EUR,COMPLETED,518.72
TRANSFER,Current,2022-02-25 10:03:58,2022-02-25 10:03:58,To EUR Savings,-0.17,0,EUR,COMPLETED,518.55
CARD_PAYMENT,Current,2022-02-24 12:55:18,2022-02-25 11:32:55,Uber Eats,-15.25,0,EUR,COMPLETED,503.3
TRANSFER,Current,2022-02-25 13:02:21,2022-02-25 13:02:21,To EUR Savings,-0.09,0,EUR,COMPLETED,503.21
CARD_PAYMENT,Current,2022-02-25 12:24:07,2022-02-26 04:35:21,Minipreço,-5.91,0,EUR,COMPLETED,497.3
CARD_PAYMENT,Current,2022-02-25 10:03:57,2022-02-26 04:35:21,Minipreço,-7.83,0,EUR,COMPLETED,489.47
TRANSFER,Current,2022-02-26 08:45:33,2022-02-26 08:45:33,To EUR Savings,-1,0,EUR,COMPLETED,488.47
TOPUP,Current,2022-02-26 09:06:04,2022-02-26 09:06:07,Apple Pay Top-Up by *6660,500,0,EUR,COMPLETED,988.47
TRANSFER,Current,2022-02-26 09:06:29,2022-02-26 09:06:29,To EUR Rainy day,-250,0,EUR,COMPLETED,738.47
TRANSFER,Current,2022-02-26 20:47:45,2022-02-26 20:47:45,To EUR Savings,-0.58,0,EUR,COMPLETED,737.89
TRANSFER,Current,2022-02-27 00:32:37,2022-02-27 00:32:37,To EUR Savings,-0.01,0,EUR,COMPLETED,737.88
TRANSFER,Current,2022-02-27 00:35:37,2022-02-27 00:35:37,To EUR Savings,-0.51,0,EUR,COMPLETED,737.37
CARD_PAYMENT,Current,2022-02-26 08:45:33,2022-02-27 07:18:14,Poke House - Miraflores,-3,0,EUR,COMPLETED,734.37
TRANSFER,Current,2022-02-27 08:58:57,2022-02-27 08:58:57,To EUR Savings,-0.5,0,EUR,COMPLETED,733.87
TRANSFER,Current,2022-02-27 13:19:10,2022-02-27 13:19:10,To EUR Savings,-0.3,0,EUR,COMPLETED,733.57
TRANSFER,Current,2022-02-27 14:01:40,2022-02-27 14:01:40,To EUR Savings,-0.3,0,EUR,COMPLETED,733.27
CARD_PAYMENT,Current,2022-02-27 14:01:40,2022-02-28 04:26:05,Mercado de Algés,-2.7,0,EUR,COMPLETED,730.57
CARD_PAYMENT,Current,2022-02-27 08:58:57,2022-02-28 04:26:05,Poke House - Miraflores,-3.5,0,EUR,COMPLETED,727.07
CARD_PAYMENT,Current,2022-02-27 13:19:09,2022-02-28 04:27:16,Rest Naipe D Emocoes,-10.7,0,EUR,COMPLETED,716.37
TRANSFER,Current,2022-02-28 08:15:12,2022-02-28 08:15:12,To EUR Savings,-20,0,EUR,COMPLETED,696.37
CARD_PAYMENT,Current,2022-02-27 00:32:36,2022-02-28 11:26:41,Apple,-1.99,0,EUR,COMPLETED,694.38
CARD_PAYMENT,Current,2022-02-27 00:35:37,2022-02-28 11:44:36,Apple,-5.49,0,EUR,COMPLETED,688.89
CARD_PAYMENT,Current,2022-02-26 20:47:45,2022-02-28 11:48:41,Amazon,-19.42,0,EUR,COMPLETED,669.47
TRANSFER,Current,2022-02-28 13:03:47,2022-02-28 13:03:47,To EUR Savings,-0.01,0,EUR,COMPLETED,669.46
TRANSFER,Current,2022-03-01 07:56:23,2022-03-01 07:56:23,To EUR Savings,-1,0,EUR,COMPLETED,668.46
TRANSFER,Current,2022-03-01 10:31:28,2022-03-01 10:31:28,To EUR Bills,-100,0,EUR,COMPLETED,568.46
CARD_PAYMENT,Current,2022-02-28 13:03:43,2022-03-01 11:03:39,Google,-2.99,0,EUR,COMPLETED,565.47
TRANSFER,Current,2022-03-01 14:13:44,2022-03-01 14:13:44,To EUR Savings,-0.7,0,EUR,COMPLETED,564.77
TRANSFER,Current,2022-03-01 14:55:46,2022-03-01 14:55:46,To EUR Savings,-0.2,0,EUR,COMPLETED,564.57
CARD_PAYMENT,Current,2022-03-01 07:56:22,2022-03-02 07:29:50,Poke House - Miraflores,-3,0,EUR,COMPLETED,561.57
CARD_PAYMENT,Current,2022-03-01 14:13:44,2022-03-02 07:29:50,Rua Luís de Camões,-22.3,0,EUR,COMPLETED,539.27
CARD_PAYMENT,Current,2022-03-01 14:55:46,2022-03-02 07:29:50,Rest Naipe D Emocoes,-1.8,0,EUR,COMPLETED,537.47
TRANSFER,Current,2022-03-02 10:15:17,2022-03-02 10:15:17,To EUR Savings,-0.99,0,EUR,COMPLETED,536.48
CARD_PAYMENT,Current,2022-03-02 10:15:17,2022-03-03 05:24:34,Minipreço,-15.01,0,EUR,COMPLETED,521.47
TRANSFER,Current,2022-03-05 08:38:02,2022-03-05 08:38:02,To EUR Savings,-1,0,EUR,COMPLETED,520.47
CARD_PAYMENT,Current,2022-03-05 08:38:01,2022-03-06 07:25:57,Poke House - Miraflores,-3,0,EUR,COMPLETED,517.47
TRANSFER,Current,2022-03-06 08:45:00,2022-03-06 08:45:00,To EUR Savings,-1,0,EUR,COMPLETED,516.47
TRANSFER,Current,2022-03-06 09:53:35,2022-03-06 09:53:35,To EUR Savings,-0.02,0,EUR,COMPLETED,516.45
TRANSFER,Current,2022-03-06 14:31:50,2022-03-06 14:31:50,To EUR Savings,-0.2,0,EUR,COMPLETED,516.25
TRANSFER,Current,2022-03-06 14:36:16,2022-03-06 14:36:16,To EUR Savings,-0.1,0,EUR,COMPLETED,516.15
CARD_PAYMENT,Current,2022-03-06 08:44:59,2022-03-07 07:24:48,Poke House - Miraflores,-3,0,EUR,COMPLETED,513.15
CARD_PAYMENT,Current,2022-03-06 14:36:16,2022-03-07 07:24:48,Mercado de Algés,-0.9,0,EUR,COMPLETED,512.25
CARD_PAYMENT,Current,2022-03-06 09:53:34,2022-03-07 07:24:48,Pingo Doce,-22.98,0,EUR,COMPLETED,489.27
CARD_PAYMENT,Current,2022-03-06 14:31:49,2022-03-07 07:24:48,Mercado de Algés,-1.8,0,EUR,COMPLETED,487.47
TRANSFER,Current,2022-03-07 07:59:09,2022-03-07 07:59:09,To EUR Savings,-20,0,EUR,COMPLETED,467.47
TRANSFER,Current,2022-03-07 22:08:34,2022-03-07 22:08:34,To EUR Savings,-0.1,0,EUR,COMPLETED,467.37
TRANSFER,Current,2022-03-08 08:51:02,2022-03-08 08:51:02,To EUR Savings,-0.01,0,EUR,COMPLETED,467.36
CARD_PAYMENT,Current,2022-03-08 08:51:01,2022-03-09 10:39:19,Apple,-0.99,0,EUR,COMPLETED,466.37
CARD_PAYMENT,Current,2022-03-07 22:08:34,2022-03-09 10:47:24,El Corte Inglés,-69.9,0,EUR,COMPLETED,396.47
TRANSFER,Current,2022-03-11 12:03:10,2022-03-11 12:03:10,To EUR Savings,-0.02,0,EUR,COMPLETED,396.45
TRANSFER,Current,2022-03-11 12:35:05,2022-03-11 12:35:05,To EUR Savings,-1,0,EUR,COMPLETED,395.45
TRANSFER,Current,2022-03-11 12:58:01,2022-03-11 12:58:01,To EUR Savings,-1,0,EUR,COMPLETED,394.45
TRANSFER,Current,2022-03-11 13:51:20,2022-03-11 13:51:20,To EUR Savings,-0.23,0,EUR,COMPLETED,394.22
TOPUP,Current,2022-03-11 14:10:50,2022-03-11 14:10:53,Apple Pay Top-Up by *6660,200,0,EUR,COMPLETED,594.22
CARD_PAYMENT,Current,2022-03-11 12:58:00,2022-03-12 07:39:56,Esplanada Cafe,-11,0,EUR,COMPLETED,583.22
TRANSFER,Current,2022-03-12 08:38:27,2022-03-12 08:38:27,To EUR Savings,-1,0,EUR,COMPLETED,582.22
TRANSFER,Current,2022-03-12 10:01:03,2022-03-12 10:01:03,To EUR Savings,-0.75,0,EUR,COMPLETED,581.47
CARD_PAYMENT,Current,2022-03-11 12:03:10,2022-03-12 11:36:27,Uber,-7.98,0,EUR,COMPLETED,573.49
CARD_PAYMENT,Current,2022-03-11 12:35:03,2022-03-12 11:37:29,Uber,-1,0,EUR,COMPLETED,572.49
CARD_PAYMENT,Current,2022-03-11 13:51:04,2022-03-12 12:02:34,Uber,-12.77,0,EUR,COMPLETED,559.72
TRANSFER,Current,2022-03-12 13:12:04,2022-03-12 13:12:04,To EUR Savings,-0.75,0,EUR,COMPLETED,558.97
TRANSFER,Current,2022-03-12 20:41:49,2022-03-12 20:41:49,To EUR Savings,-0.55,0,EUR,COMPLETED,558.42
CARD_PAYMENT,Current,2022-03-12 10:01:02,2022-03-13 05:14:54,Minipreço,-13.25,0,EUR,COMPLETED,545.17
CARD_PAYMENT,Current,2022-03-12 08:38:26,2022-03-13 07:17:29,Poke House - Miraflores,-3,0,EUR,COMPLETED,542.17
TRANSFER,Current,2022-03-13 08:27:29,2022-03-13 08:27:29,To EUR Savings,-1,0,EUR,COMPLETED,541.17
CARD_PAYMENT,Current,2022-03-12 13:12:03,2022-03-13 09:22:09,Uber Eats,-15.25,0,EUR,COMPLETED,525.92
TRANSFER,Current,2022-03-13 13:23:13,2022-03-13 13:23:13,To EUR Savings,-0.2,0,EUR,COMPLETED,525.72
TRANSFER,Current,2022-03-13 14:25:42,2022-03-13 14:25:42,To EUR Savings,-0.2,0,EUR,COMPLETED,525.52
CARD_PAYMENT,Current,2022-03-13 13:23:13,2022-03-14 06:21:43,Mercado de Algés,-5.8,0,EUR,COMPLETED,519.72
CARD_PAYMENT,Current,2022-03-13 14:25:41,2022-03-14 06:21:43,Mercado de Algés,-1.8,0,EUR,COMPLETED,517.92
CARD_PAYMENT,Current,2022-03-13 08:27:29,2022-03-14 06:21:43,Poke House - Miraflores,-3,0,EUR,COMPLETED,514.92
TRANSFER,Current,2022-03-14 07:59:26,2022-03-14 07:59:26,To EUR Savings,-20,0,EUR,COMPLETED,494.92
CARD_PAYMENT,Current,2022-03-12 20:41:49,2022-03-14 11:50:25,PayPal,-37.45,0,EUR,COMPLETED,457.47
TRANSFER,Current,2022-03-15 12:54:43,2022-03-15 12:54:43,To EUR Savings,-0.01,0,EUR,COMPLETED,457.46
TRANSFER,Current,2022-03-15 13:01:55,2022-03-15 13:01:55,To EUR Savings,-0.75,0,EUR,COMPLETED,456.71
CARD_PAYMENT,Current,2022-03-15 13:01:55,2022-03-16 10:17:38,Uber Eats,-15.25,0,EUR,COMPLETED,441.46
CARD_PAYMENT,Current,2022-03-15 12:54:43,2022-03-16 10:19:42,Elevensport,-11.99,0,EUR,COMPLETED,429.47
TRANSFER,Current,2022-03-16 13:11:31,2022-03-16 13:11:31,To EUR Savings,-0.27,0,EUR,COMPLETED,429.2
CARD_PAYMENT,Current,2022-03-16 13:11:31,2022-03-17 05:07:40,Minipreço,-2.73,0,EUR,COMPLETED,426.47
TRANSFER,Current,2022-03-17 12:52:00,2022-03-17 12:52:00,To EUR Savings,-0.75,0,EUR,COMPLETED,425.72
TRANSFER,Current,2022-03-17 21:40:58,2022-03-17 21:40:58,To EUR Savings,-0.51,0,EUR,COMPLETED,425.21
CARD_PAYMENT,Current,2022-03-17 12:51:59,2022-03-18 11:58:46,Uber Eats,-15.25,0,EUR,COMPLETED,409.96
CARD_PAYMENT,Current,2022-03-18 19:53:49,,Airbnb,-394.2,0,EUR,REVERTED,
TRANSFER,Current,2022-03-18 19:53:49,2022-03-18 19:53:49,To EUR Savings,-0.8,0,EUR,COMPLETED,409.16
TRANSFER,Current,2022-03-19 08:28:17,2022-03-19 08:28:17,To EUR Savings,-1,0,EUR,COMPLETED,408.16
CARD_PAYMENT,Current,2022-03-17 21:40:57,2022-03-19 12:37:38,YouTube,-8.49,0,EUR,COMPLETED,399.67
TRANSFER,Current,2022-03-20 00:09:34,2022-03-20 00:09:34,To EUR Savings,-0.01,0,EUR,COMPLETED,399.66
TRANSFER,Current,2022-03-20 08:10:40,2022-03-20 08:10:40,To EUR Savings,-1,0,EUR,COMPLETED,398.66
CARD_PAYMENT,Current,2022-03-19 08:28:16,2022-03-20 15:50:40,Poke House - Miraflores,-3,0,EUR,COMPLETED,395.66
CARD_PAYMENT,Current,2022-03-20 08:10:40,2022-03-21 06:12:10,Poke House - Miraflores,-3,0,EUR,COMPLETED,392.66
TRANSFER,Current,2022-03-21 08:01:05,2022-03-21 08:01:05,To EUR Savings,-20,0,EUR,COMPLETED,372.66
CARD_PAYMENT,Current,2022-03-20 00:09:34,2022-03-21 10:43:30,Apple,-0.99,0,EUR,COMPLETED,371.67
TRANSFER,Current,2022-03-22 09:55:56,2022-03-22 09:55:56,To EUR Savings,-0.01,0,EUR,COMPLETED,371.66
TRANSFER,Current,2022-03-22 12:45:31,2022-03-22 12:45:31,To EUR Savings,-0.75,0,EUR,COMPLETED,370.91
CARD_PAYMENT,Current,2022-03-22 09:55:55,2022-03-23 06:12:57,Leroy Merlin,-10.99,0,EUR,COMPLETED,359.92
CARD_PAYMENT,Current,2022-03-22 12:45:31,2022-03-23 10:26:37,Uber Eats,-15.25,0,EUR,COMPLETED,344.67
TRANSFER,Current,2022-03-26 08:47:04,2022-03-26 08:47:04,To EUR Savings,-1,0,EUR,COMPLETED,343.67
TRANSFER,Current,2022-03-26 23:32:44,2022-03-26 23:32:44,To EUR Savings,-0.01,0,EUR,COMPLETED,343.66
TRANSFER,Current,2022-03-26 23:34:55,2022-03-26 23:34:55,To EUR Savings,-0.51,0,EUR,COMPLETED,343.15
CARD_PAYMENT,Current,2022-03-26 08:47:04,2022-03-27 08:10:14,Poke House - Miraflores,-3,0,EUR,COMPLETED,340.15
TRANSFER,Current,2022-03-28 09:05:50,2022-03-28 09:05:50,To EUR Savings,-20,0,EUR,COMPLETED,320.15
CARD_PAYMENT,Current,2022-03-26 23:34:55,2022-03-28 11:43:22,Apple,-5.49,0,EUR,COMPLETED,314.66
CARD_PAYMENT,Current,2022-03-26 23:32:43,2022-03-28 11:43:22,Apple,-1.99,0,EUR,COMPLETED,312.67
TRANSFER,Current,2022-03-28 14:03:42,2022-03-28 14:03:42,To EUR Savings,-0.01,0,EUR,COMPLETED,312.66
TOPUP,Current,2022-03-29 07:02:31,2022-03-29 07:02:31,"Payment from Galp Power, S.a.",107.38,0,EUR,COMPLETED,420.04
CARD_PAYMENT,Current,2022-03-28 14:03:41,2022-03-29 10:45:50,Google,-2.99,0,EUR,COMPLETED,417.05
TRANSFER,Current,2022-03-29 12:43:39,2022-03-29 12:43:39,To EUR Savings,-0.9,0,EUR,COMPLETED,416.15
CARD_PAYMENT,Current,2022-03-29 12:43:39,2022-03-30 10:11:58,Uber Eats,-30.1,0,EUR,COMPLETED,386.05
TRANSFER,Current,2022-03-31 20:05:26,2022-03-31 20:05:26,To EUR Savings,-0.01,0,EUR,COMPLETED,386.04
TRANSFER,Current,2022-04-01 11:33:39,2022-04-01 11:33:39,To EUR Bills,-100,0,EUR,COMPLETED,286.04
TRANSFER,Current,2022-04-02 09:29:07,2022-04-02 09:29:07,To EUR Savings,-0.6,0,EUR,COMPLETED,285.44
CARD_PAYMENT,Current,2022-03-31 20:05:25,2022-04-02 11:16:02,Google,-20.99,0,EUR,COMPLETED,264.45
TRANSFER,Current,2022-04-02 13:57:08,2022-04-02 13:57:08,To EUR Savings,-0.2,0,EUR,COMPLETED,264.25
CARD_PAYMENT,Current,2022-04-02 09:29:06,2022-04-03 07:18:46,Pingo Doce,-20.4,0,EUR,COMPLETED,243.85
CARD_PAYMENT,Current,2022-04-02 13:57:08,2022-04-03 07:18:46,Mercado de Algés,-1.8,0,EUR,COMPLETED,242.05
TRANSFER,Current,2022-04-03 15:18:51,2022-04-03 15:18:51,To EUR Savings,-0.8,0,EUR,COMPLETED,241.25
TOPUP,Current,2022-04-03 21:37:18,2022-04-03 21:37:24,Apple Pay Top-Up by *6660,200,0,EUR,COMPLETED,441.25
CARD_PAYMENT,Current,2022-04-03 15:18:51,2022-04-04 05:26:47,Mercado de Algés,-5.2,0,EUR,COMPLETED,436.05
TRANSFER,Current,2022-04-04 09:06:17,2022-04-04 09:06:17,To EUR Savings,-20,0,EUR,COMPLETED,416.05
TRANSFER,Current,2022-04-04 13:42:36,2022-04-04 13:42:36,To EUR Savings,-0.55,0,EUR,COMPLETED,415.5
CARD_PAYMENT,Current,2022-04-04 13:42:36,2022-04-05 12:00:58,PayPal,-45.45,0,EUR,COMPLETED,370.05
TRANSFER,Current,2022-04-05 12:46:05,2022-04-05 12:46:05,To EUR Savings,-0.9,0,EUR,COMPLETED,369.15
CARD_PAYMENT,Current,2022-04-05 12:46:01,2022-04-06 09:44:59,Uber Eats,-30.1,0,EUR,COMPLETED,339.05
TRANSFER,Current,2022-04-06 10:48:36,2022-04-06 10:48:36,To EUR Savings,-0.01,0,EUR,COMPLETED,339.04
TRANSFER,Current,2022-04-06 10:57:36,2022-04-06 10:57:36,To EUR Savings,-0.53,0,EUR,COMPLETED,338.51
TRANSFER,Current,2022-04-06 11:13:28,2022-04-06 11:13:28,To EUR Savings,-0.3,0,EUR,COMPLETED,338.21
TRANSFER,Current,2022-04-06 11:21:09,2022-04-06 11:21:09,To EUR Savings,-0.2,0,EUR,COMPLETED,338.01
TRANSFER,Current,2022-04-06 13:21:04,2022-04-06 13:21:04,To EUR Savings,-0.5,0,EUR,COMPLETED,337.51
TRANSFER,Current,2022-04-06 13:31:44,2022-04-06 13:31:44,To EUR Savings,-0.3,0,EUR,COMPLETED,337.21
TRANSFER,Current,2022-04-06 14:19:35,2022-04-06 14:19:35,To EUR Savings,-0.85,0,EUR,COMPLETED,336.36
TRANSFER,Current,2022-04-06 17:45:21,2022-04-06 17:45:21,To EUR Savings,-0.15,0,EUR,COMPLETED,336.21
TRANSFER,Current,2022-04-06 17:50:11,2022-04-06 17:50:11,To EUR Savings,-0.2,0,EUR,COMPLETED,336.01
TRANSFER,Current,2022-04-06 22:41:20,2022-04-06 22:41:20,To EUR Savings,-0.36,0,EUR,COMPLETED,335.65
TRANSFER,Current,2022-04-06 23:00:16,2022-04-06 23:00:16,To EUR Savings,-0.15,0,EUR,COMPLETED,335.5
CARD_PAYMENT,Current,2022-04-06 17:50:11,2022-04-07 05:41:32,areas,-3.8,0,EUR,COMPLETED,331.7
CARD_PAYMENT,Current,2022-04-06 17:45:20,2022-04-07 05:41:32,areas,-2.85,0,EUR,COMPLETED,328.85
CARD_PAYMENT,Current,2022-04-06 10:48:35,2022-04-07 05:41:32,Sport Zone,-3.99,0,EUR,COMPLETED,324.86
CARD_PAYMENT,Current,2022-04-06 13:31:43,2022-04-07 05:41:32,Rest Naipe D Emocoes,-10.7,0,EUR,COMPLETED,314.16
CARD_PAYMENT,Current,2022-04-06 11:21:09,2022-04-07 05:41:32,Intimissimi,-99.8,0,EUR,COMPLETED,214.36
CARD_PAYMENT,Current,2022-04-06 13:21:04,2022-04-07 05:41:33,Rua Luís de Camões,-10.5,0,EUR,COMPLETED,203.86
CARD_PAYMENT,Current,2022-04-06 11:13:28,2022-04-07 05:41:33,Rockport,-80.7,0,EUR,COMPLETED,123.16
CARD_PAYMENT,Current,2022-04-06 10:57:36,2022-04-07 05:41:33,Sport Zone,-12.47,0,EUR,COMPLETED,110.69
CARD_PAYMENT,Current,2022-04-06 14:19:34,2022-04-07 05:41:33,Pingo Doce,-9.15,0,EUR,COMPLETED,101.54
TOPUP,Current,2022-04-07 07:30:41,2022-04-07 07:30:48,Apple Pay Top-Up by *6660,500,0,EUR,COMPLETED,601.54
TRANSFER,Current,2022-04-07 08:03:31,2022-04-07 08:03:31,To EUR Savings,-0.4,0,EUR,COMPLETED,601.14
TRANSFER,Current,2022-04-07 09:38:28,2022-04-07 09:38:28,To EUR Savings,-0.23,0,EUR,COMPLETED,600.91
TRANSFER,Current,2022-04-07 10:25:53,2022-04-07 10:25:53,To EUR Savings,-0.65,0,EUR,COMPLETED,600.26
TRANSFER,Current,2022-04-07 12:55:36,2022-04-07 12:55:36,To EUR Savings,-0.89,0,EUR,COMPLETED,599.37
TRANSFER,Current,2022-04-07 13:17:54,2022-04-07 13:17:54,To EUR Savings,-0.87,0,EUR,COMPLETED,598.5
TRANSFER,Current,2022-04-07 13:45:13,2022-04-07 13:45:13,To EUR Savings,-0.33,0,EUR,COMPLETED,598.17
TRANSFER,Current,2022-04-07 16:50:20,2022-04-07 16:50:20,To EUR Savings,-0.02,0,EUR,COMPLETED,598.15
TRANSFER,Current,2022-04-07 17:33:21,2022-04-07 17:33:21,To EUR Savings,-0.5,0,EUR,COMPLETED,597.65
CARD_PAYMENT,Current,2022-04-07 12:55:35,2022-04-08 05:09:14,Torvehallerne,-12.11,0,EUR,COMPLETED,585.54
CARD_PAYMENT,Current,2022-04-06 23:00:16,2022-04-08 05:09:14,Kobenhavns Metro,-4.85,0,EUR,COMPLETED,580.69
CARD_PAYMENT,Current,2022-04-07 13:45:13,2022-04-08 05:09:14,Espresso House,-7.67,0,EUR,COMPLETED,573.02
CARD_PAYMENT,Current,2022-04-07 13:17:54,2022-04-08 05:09:14,Torvehallerne,-14.13,0,EUR,COMPLETED,558.89
CARD_PAYMENT,Current,2022-04-07 10:25:53,2022-04-08 05:09:14,Espresso House,-8.35,0,EUR,COMPLETED,550.54
CARD_PAYMENT,Current,2022-04-07 16:50:19,2022-04-08 05:09:14,The Black Diamond Cafe,-11.98,0,EUR,COMPLETED,538.56
CARD_PAYMENT,Current,2022-04-06 22:41:20,2022-04-08 05:09:14,Caffeine,-10.64,0,EUR,COMPLETED,527.92
CARD_PAYMENT,Current,2022-04-07 17:33:21,2022-04-08 05:09:14,SuperBrugsen,-14.5,0,EUR,COMPLETED,513.42
TRANSFER,Current,2022-04-08 07:57:38,2022-04-08 07:57:38,To EUR Savings,-0.95,0,EUR,COMPLETED,512.47
TRANSFER,Current,2022-04-08 08:39:40,2022-04-08 08:39:40,To EUR Savings,-0.35,0,EUR,COMPLETED,512.12
TRANSFER,Current,2022-04-08 08:55:34,2022-04-08 08:55:34,To EUR Savings,-0.01,0,EUR,COMPLETED,512.11
TRANSFER,Current,2022-04-08 08:59:45,2022-04-08 08:59:45,To EUR Savings,-0.23,0,EUR,COMPLETED,511.88
TRANSFER,Current,2022-04-08 09:40:32,2022-04-08 09:40:32,To EUR Savings,-0.82,0,EUR,COMPLETED,511.06
TRANSFER,Current,2022-04-08 09:42:06,2022-04-08 09:42:06,To EUR Savings,-0.82,0,EUR,COMPLETED,510.24
TOPUP,Current,2022-04-08 10:00:13,2022-04-08 10:00:17,Apple Pay Top-Up by *6660,500,0,EUR,COMPLETED,1010.24
TRANSFER,Current,2022-04-08 13:37:49,2022-04-08 13:37:49,To EUR Savings,-0.1,0,EUR,COMPLETED,1010.14
TRANSFER,Current,2022-04-08 14:25:45,2022-04-08 14:25:45,To EUR Savings,-0.29,0,EUR,COMPLETED,1009.85
CARD_PAYMENT,Current,2022-04-07 08:03:30,2022-04-08 15:01:09,Cobracph V. Konsjo,-20.6,0,EUR,COMPLETED,989.25
TRANSFER,Current,2022-04-08 15:25:50,2022-04-08 15:25:50,To EUR Savings,-0.41,0,EUR,COMPLETED,988.84
TRANSFER,Current,2022-04-08 15:38:46,2022-04-08 15:38:46,To EUR Savings,-0.01,0,EUR,COMPLETED,988.83
TRANSFER,Current,2022-04-08 18:45:41,2022-04-08 18:45:41,To EUR Savings,-0.4,0,EUR,COMPLETED,988.43
CARD_PAYMENT,Current,2022-04-07 09:38:28,2022-04-09 05:14:32,7-Eleven,-3.77,0,EUR,COMPLETED,984.66
CARD_PAYMENT,Current,2022-04-08 09:40:31,2022-04-09 05:14:32,Espresso House,-4.18,0,EUR,COMPLETED,980.48
CARD_PAYMENT,Current,2022-04-08 09:42:06,2022-04-09 05:14:32,Espresso House,-4.18,0,EUR,COMPLETED,976.3
CARD_PAYMENT,Current,2022-04-08 16:22:23,2022-04-09 05:14:32,Hart Bageri,-9.15,0,EUR,COMPLETED,967.15
CARD_PAYMENT,Current,2022-04-08 18:45:40,2022-04-09 05:14:32,Rema 1000,-8.6,0,EUR,COMPLETED,958.55
CARD_PAYMENT,Current,2022-04-08 14:25:45,2022-04-09 05:14:33,Østerberg Ice Cream,-11.71,0,EUR,COMPLETED,946.84
CARD_PAYMENT,Current,2022-04-08 13:37:49,2022-04-09 05:14:33,Restaurant Pal�,-61.9,0,EUR,COMPLETED,884.94
CARD_PAYMENT,Current,2022-04-08 15:25:49,2022-04-09 05:20:07,Cisternerne,-27.59,0,EUR,COMPLETED,857.35
CARD_PAYMENT,Current,2022-04-08 07:57:38,2022-04-09 07:56:35,Cobracph V Ko,-20.05,0,EUR,COMPLETED,837.3
CARD_PAYMENT,Current,2022-04-08 08:53:31,2022-04-09 11:00:21,Apple,-0.99,0,EUR,COMPLETED,836.31
TRANSFER,Current,2022-04-09 11:11:01,2022-04-09 11:11:01,To EUR Savings,-0.87,0,EUR,COMPLETED,835.44
TRANSFER,Current,2022-04-09 14:20:29,2022-04-09 14:20:29,To EUR Savings,-0.19,0,EUR,COMPLETED,835.25
CARD_PAYMENT,Current,2022-04-08 08:59:45,2022-04-09 18:12:40,DOT - Din Offentlige Transport,-10.77,0,EUR,COMPLETED,824.48
CARD_PAYMENT,Current,2022-04-08 08:39:40,2022-04-09 18:21:29,Citybreak,-26.65,0,EUR,COMPLETED,797.83
TRANSFER,Current,2022-04-09 18:23:00,2022-04-09 18:23:00,To EUR Savings,-0.44,0,EUR,COMPLETED,797.39
TRANSFER,Current,2022-04-09 20:24:41,2022-04-09 20:24:41,To EUR Savings,-0.1,0,EUR,COMPLETED,797.29
CARD_PAYMENT,Current,2022-04-09 11:11:00,2022-04-10 05:01:29,sj.se,-3.13,0.03,EUR,COMPLETED,794.13
CARD_PAYMENT,Current,2022-04-09 18:23:00,2022-04-10 08:28:11,O’Connell’s Irish Pub,-17.56,0.18,EUR,COMPLETED,776.39
TRANSFER,Current,2022-04-10 09:05:43,2022-04-10 09:05:43,To EUR Savings,-0.83,0,EUR,COMPLETED,775.56
CARD_PAYMENT,Current,2022-04-09 07:29:11,2022-04-10 09:45:36,Cobracph V. Konsjo,-27.11,0.27,EUR,COMPLETED,748.18
CARD_PAYMENT,Current,2022-04-08 15:38:45,2022-04-10 10:53:24,Google,-19.99,0,EUR,COMPLETED,728.19
TRANSFER,Current,2022-04-10 12:37:26,2022-04-10 12:37:26,To EUR Savings,-0.68,0,EUR,COMPLETED,727.51
TRANSFER,Current,2022-04-10 12:55:09,2022-04-10 12:55:09,To EUR Savings,-0.25,0,EUR,COMPLETED,727.26
TRANSFER,Current,2022-04-10 13:49:18,2022-04-10 13:49:18,To EUR Savings,-0.83,0,EUR,COMPLETED,726.43
TRANSFER,Current,2022-04-10 16:26:01,2022-04-10 16:26:01,To EUR Savings,-0.21,0,EUR,COMPLETED,726.22
CARD_PAYMENT,Current,2022-04-09 14:20:29,2022-04-10 17:24:23,Ab Storstockholms Loka,-3.81,0.04,EUR,COMPLETED,722.37
CARD_PAYMENT,Current,2022-04-09 14:09:44,2022-04-10 17:24:23,Ab Storstockholms Loka,-16.1,0.16,EUR,COMPLETED,706.11
TRANSFER,Current,2022-04-10 23:19:04,2022-04-10 23:19:04,To EUR Savings,-0.15,0,EUR,COMPLETED,705.96
CARD_PAYMENT,Current,2022-04-10 11:05:03,2022-04-11 05:09:55,Rosendals Trädgårdskafé,-24.39,0.24,EUR,COMPLETED,681.33
CARD_PAYMENT,Current,2022-04-09 12:56:38,2022-04-11 05:09:55,sj.se,-2.15,0.02,EUR,COMPLETED,679.16
CARD_PAYMENT,Current,2022-04-10 09:05:42,2022-04-11 07:06:15,Vasamuseet,-33.17,0.33,EUR,COMPLETED,645.66
CARD_PAYMENT,Current,2022-04-10 12:55:09,2022-04-11 07:06:15,T-Jarlen AB,-12.75,0.13,EUR,COMPLETED,632.78
CARD_PAYMENT,Current,2022-04-10 08:26:22,2022-04-11 07:07:13,Fabrique Stock,-9.76,0.1,EUR,COMPLETED,622.92
CARD_PAYMENT,Current,2022-04-09 20:24:40,2022-04-11 07:07:13,Greek Taverna G,-43.9,0.44,EUR,COMPLETED,578.58
CARD_PAYMENT,Current,2022-04-10 12:37:26,2022-04-11 07:07:13,Fabrique Stock,-11.32,0.11,EUR,COMPLETED,567.15
TRANSFER,Current,2022-04-11 09:34:58,2022-04-11 09:34:58,To EUR Savings,-20,0,EUR,COMPLETED,547.15
TRANSFER,Current,2022-04-11 12:02:26,2022-04-11 12:02:26,To EUR Savings,-0.85,0,EUR,COMPLETED,546.3
TRANSFER,Current,2022-04-11 12:17:14,2022-04-11 12:17:14,To EUR Savings,-0.29,0,EUR,COMPLETED,546.01
TRANSFER,Current,2022-04-11 14:55:00,2022-04-11 14:55:00,To EUR Savings,-0.89,0,EUR,COMPLETED,545.12
TRANSFER,Current,2022-04-11 17:01:32,2022-04-11 17:01:32,To EUR Savings,-0.85,0,EUR,COMPLETED,544.27
TRANSFER,Current,2022-04-11 17:31:53,2022-04-11 17:31:53,To EUR Savings,-0.9,0,EUR,COMPLETED,543.37
TRANSFER,Current,2022-04-11 21:22:52,2022-04-11 21:22:52,To EUR Savings,-0.24,0,EUR,COMPLETED,543.13
TRANSFER,Current,2022-04-11 21:59:08,2022-04-11 21:59:08,To EUR Savings,-0.61,0,EUR,COMPLETED,542.52
CARD_PAYMENT,Current,2022-04-10 13:49:18,2022-04-11 22:37:52,Arlanda Express,-29.17,0.29,EUR,COMPLETED,513.06
CARD_PAYMENT,Current,2022-04-10 16:26:01,2022-04-12 09:21:12,News and Fine Food,-7.79,0.08,EUR,COMPLETED,505.19
CARD_PAYMENT,Current,2022-04-11 12:17:13,2022-04-12 09:42:14,Pingo Doce,-11.71,0,EUR,COMPLETED,493.48
CARD_PAYMENT,Current,2022-04-10 23:19:04,2022-04-12 09:43:15,1st Café,-2.85,0,EUR,COMPLETED,490.63
TRANSFER,Current,2022-04-12 12:42:59,2022-04-12 12:42:59,To EUR Savings,-0.2,0,EUR,COMPLETED,490.43
CARD_PAYMENT,Current,2022-04-12 12:42:59,2022-04-13 10:16:28,Uber Eats,-15.8,0,EUR,COMPLETED,474.63
TRANSFER,Current,2022-04-13 19:02:06,2022-04-13 19:02:06,To EUR Savings,-0.85,0,EUR,COMPLETED,473.78
CARD_PAYMENT,Current,2022-04-13 19:02:05,2022-04-15 10:27:20,Kiwoko. Mundo Animal,-72.15,0,EUR,COMPLETED,401.63
TRANSFER,Current,2022-04-16 09:52:46,2022-04-16 09:52:46,To EUR Savings,-0.8,0,EUR,COMPLETED,400.83
TRANSFER,Current,2022-04-16 13:32:57,2022-04-16 13:32:57,To EUR Savings,-0.2,0,EUR,COMPLETED,400.63
TRANSFER,Current,2022-04-16 14:32:44,2022-04-16 14:32:44,To EUR Savings,-0.25,0,EUR,COMPLETED,400.38
CARD_PAYMENT,Current,2022-04-16 13:32:57,2022-04-17 07:12:58,Rest Naipe D Emocoes,-1.8,0,EUR,COMPLETED,398.58
CARD_PAYMENT,Current,2022-04-16 09:52:46,2022-04-17 09:35:42,Amazon,-12.2,0,EUR,COMPLETED,386.38
CARD_PAYMENT,Current,2022-04-16 14:32:43,2022-04-17 09:53:39,PayPal,-24.75,0,EUR,COMPLETED,361.63
TRANSFER,Current,2022-04-17 10:15:30,2022-04-17 10:15:30,To EUR Savings,-0.1,0,EUR,COMPLETED,361.53
TRANSFER,Current,2022-04-17 13:56:49,2022-04-17 13:56:49,To EUR Savings,-0.2,0,EUR,COMPLETED,361.33
TRANSFER,Current,2022-04-17 21:40:57,2022-04-17 21:40:57,To EUR Savings,-0.51,0,EUR,COMPLETED,360.82
CARD_PAYMENT,Current,2022-04-17 10:15:29,2022-04-18 05:39:50,Jean Louis David,-17.9,0,EUR,COMPLETED,342.92
CARD_PAYMENT,Current,2022-04-17 13:56:49,2022-04-18 05:39:50,Mercado de Algés,-1.8,0,EUR,COMPLETED,341.12
TRANSFER,Current,2022-04-18 09:09:01,2022-04-18 09:09:01,To EUR Savings,-20,0,EUR,COMPLETED,321.12
TRANSFER,Current,2022-04-19 09:40:20,2022-04-19 09:40:20,To EUR Savings,-0.7,0,EUR,COMPLETED,320.42
CARD_PAYMENT,Current,2022-04-17 21:40:57,2022-04-19 09:43:07,YouTube,-8.49,0,EUR,COMPLETED,311.93
TRANSFER,Current,2022-04-19 12:53:18,2022-04-19 12:53:18,To EUR Savings,-0.2,0,EUR,COMPLETED,311.73
CARD_PAYMENT,Current,2022-04-19 09:40:20,2022-04-20 05:05:15,Minipreço,-19.3,0,EUR,COMPLETED,292.43
CARD_PAYMENT,Current,2022-04-19 12:53:18,2022-04-20 10:25:10,Uber Eats,-15.8,0,EUR,COMPLETED,276.63
TOPUP,Current,2022-04-22 13:35:11,2022-04-22 13:35:12,Apple Pay Top-Up by *6660,500,0,EUR,COMPLETED,776.63
TRANSFER,Current,2022-04-23 15:42:43,2022-04-23 15:42:43,To EUR Savings,-0.1,0,EUR,COMPLETED,776.53
CARD_PAYMENT,Current,2022-04-23 15:42:43,2022-04-24 06:22:30,Ponte Vista Restaura,-33.9,0,EUR,COMPLETED,742.63
TRANSFER,Current,2022-04-24 16:34:25,2022-04-24 16:34:25,To EUR Savings,-1,0,EUR,COMPLETED,741.63
CARD_PAYMENT,Current,2022-04-24 16:34:25,2022-04-25 07:12:09,Repsol,-40,0,EUR,COMPLETED,701.63
TRANSFER,Current,2022-04-25 09:12:56,2022-04-25 09:12:56,To EUR Savings,-20,0,EUR,COMPLETED,681.63
TRANSFER,Current,2022-04-25 21:31:53,2022-04-25 21:31:53,To EUR Savings,-0.2,0,EUR,COMPLETED,681.43
TRANSFER,Current,2022-04-26 13:07:21,2022-04-26 13:07:21,To EUR Savings,-0.2,0,EUR,COMPLETED,681.23
TRANSFER,Current,2022-04-27 00:32:29,2022-04-27 00:32:29,To EUR Savings,-0.01,0,EUR,COMPLETED,681.22
TRANSFER,Current,2022-04-27 00:34:07,2022-04-27 00:34:07,To EUR Savings,-0.51,0,EUR,COMPLETED,680.71
CARD_PAYMENT,Current,2022-04-25 21:31:53,2022-04-27 04:54:59,Restaurant,-64.8,0,EUR,COMPLETED,615.91
CARD_PAYMENT,Current,2022-04-26 13:07:21,2022-04-27 11:29:20,Uber Eats,-15.8,0,EUR,COMPLETED,600.11
CARD_PAYMENT,Current,2022-04-27 00:34:06,2022-04-28 09:09:43,Apple,-5.49,0,EUR,COMPLETED,594.62
CARD_PAYMENT,Current,2022-04-27 00:32:29,2022-04-28 09:09:43,Apple,-1.99,0,EUR,COMPLETED,592.63
TRANSFER,Current,2022-04-28 14:03:43,2022-04-28 14:03:43,To EUR Savings,-0.01,0,EUR,COMPLETED,592.62
TRANSFER,Current,2022-04-28 15:57:42,2022-04-28 15:57:42,To EUR Savings,-0.5,0,EUR,COMPLETED,592.12
CARD_PAYMENT,Current,2022-04-28 15:57:42,2022-04-29 08:59:04,Trustinnews,-32.5,0,EUR,COMPLETED,559.62
CARD_PAYMENT,Current,2022-04-28 14:03:43,2022-04-29 09:00:04,Google,-2.99,0,EUR,COMPLETED,556.63
TRANSFER,Current,2022-04-29 12:52:23,2022-04-29 12:52:23,To EUR Savings,-0.2,0,EUR,COMPLETED,556.43
CARD_PAYMENT,Current,2022-04-29 12:52:22,2022-04-30 09:00:04,Uber Eats,-15.8,0,EUR,COMPLETED,540.63
TRANSFER,Current,2022-04-30 11:55:00,2022-04-30 11:55:00,Revolut Bank UAB,-75,0,EUR,COMPLETED,465.63
TRANSFER,Current,2022-05-01 11:31:44,2022-05-01 11:31:44,To EUR Bills,-100,0,EUR,COMPLETED,365.63
TRANSFER,Current,2022-05-01 23:21:52,2022-05-01 23:21:53,Revolut Bank UAB,120,0,EUR,COMPLETED,485.63
TRANSFER,Current,2022-05-02 03:14:48,2022-05-02 03:14:48,To EUR Savings,-0.01,0,EUR,COMPLETED,485.62
TRANSFER,Current,2022-05-02 09:16:21,2022-05-02 09:16:21,To EUR Savings,-20,0,EUR,COMPLETED,465.62
TRANSFER,Current,2022-05-02 12:34:47,2022-05-02 12:34:47,To EUR Savings,-0.23,0,EUR,COMPLETED,465.39
CARD_PAYMENT,Current,2022-05-02 03:14:48,2022-05-03 09:46:09,Apple,-4.99,0,EUR,COMPLETED,460.4
CARD_PAYMENT,Current,2022-05-02 12:34:47,2022-05-03 10:02:18,Uber,-11.77,0,EUR,COMPLETED,448.63
TRANSFER,Current,2022-05-03 12:50:18,2022-05-03 12:50:18,To EUR Savings,-0.35,0,EUR,COMPLETED,448.28
TRANSFER,Current,2022-05-03 23:21:12,2022-05-03 23:21:12,To EUR Savings,-0.3,0,EUR,COMPLETED,447.98
CARD_PAYMENT,Current,2022-05-03 12:50:18,2022-05-04 10:00:57,Uber Eats,-30.65,0,EUR,COMPLETED,417.33
TRANSFER,Current,2022-05-04 12:34:56,2022-05-04 12:34:56,To EUR Savings,-0.3,0,EUR,COMPLETED,417.03
TRANSFER,Current,2022-05-04 14:35:29,2022-05-04 14:35:29,To EUR Savings,-0.65,0,EUR,COMPLETED,416.38
TRANSFER,Current,2022-05-04 14:41:28,2022-05-04 14:41:28,To EUR Savings,-0.83,0,EUR,COMPLETED,415.55
CARD_PAYMENT,Current,2022-05-04 14:35:28,2022-05-05 04:35:22,Varandas Romanticas,-15.35,0,EUR,COMPLETED,400.2
CARD_PAYMENT,Current,2022-05-03 23:21:12,2022-05-05 09:54:41,PayPal,-53.7,0,EUR,COMPLETED,346.5
CARD_PAYMENT,Current,2022-05-04 12:34:56,2022-05-05 09:56:34,Uber,-7.76,0,EUR,COMPLETED,338.74
CARD_PAYMENT,Current,2022-05-04 14:41:28,2022-05-05 10:25:17,Uber,-11.17,0,EUR,COMPLETED,327.57
TRANSFER,Current,2022-05-06 19:39:37,2022-05-06 19:39:37,To EUR Savings,-0.01,0,EUR,COMPLETED,327.56
TRANSFER,Current,2022-05-08 08:51:14,2022-05-08 08:51:14,To EUR Savings,-0.01,0,EUR,COMPLETED,327.55
CARD_PAYMENT,Current,2022-05-06 19:39:37,2022-05-08 10:26:24,PlayStation,-13.99,0,EUR,COMPLETED,313.56
TRANSFER,Current,2022-05-09 09:14:44,2022-05-09 09:14:44,To EUR Savings,-20,0,EUR,COMPLETED,293.56
CARD_PAYMENT,Current,2022-05-08 08:51:13,2022-05-09 10:18:49,Apple,-0.99,0,EUR,COMPLETED,292.57
TRANSFER,Current,2022-05-10 12:48:47,2022-05-10 12:48:47,To EUR Savings,-0.8,0,EUR,COMPLETED,291.77
CARD_PAYMENT,Current,2022-05-10 12:48:46,2022-05-11 10:07:01,Uber Eats,-31.2,0,EUR,COMPLETED,260.57
TOPUP,Current,2022-05-12 08:38:45,2022-05-12 08:38:49,Apple Pay Top-Up by *6660,200,0,EUR,COMPLETED,460.57
TRANSFER,Current,2022-05-13 12:38:14,2022-05-13 12:38:14,To EUR Savings,-0.1,0,EUR,COMPLETED,460.47
TRANSFER,Current,2022-05-15 10:43:10,2022-05-15 10:43:10,To EUR Savings,-0.54,0,EUR,COMPLETED,459.93
TOPUP,Current,2022-05-15 10:45:29,2022-05-15 10:45:35,Apple Pay Top-Up by *6660,200,0,EUR,COMPLETED,659.93
TRANSFER,Current,2022-05-15 11:46:43,2022-05-15 11:46:43,To EUR Savings,-1,0,EUR,COMPLETED,658.93
TRANSFER,Current,2022-05-16 09:17:32,2022-05-16 09:17:32,To EUR Savings,-20,0,EUR,COMPLETED,638.93
CARD_PAYMENT,Current,2022-05-15 11:46:42,2022-05-16 10:37:34,Starwash,-42,0,EUR,COMPLETED,596.93
CARD_PAYMENT,Current,2022-05-15 10:43:09,2022-05-16 11:59:55,Cortefiel,-121.46,0,EUR,COMPLETED,475.47
CARD_PAYMENT,Current,2022-05-13 12:38:11,2022-05-17 10:26:59,Calzedonia,-41.9,0,EUR,COMPLETED,433.57
TRANSFER,Current,2022-05-17 12:51:55,2022-05-17 12:51:55,To EUR Savings,-0.8,0,EUR,COMPLETED,432.77
TRANSFER,Current,2022-05-17 21:40:58,2022-05-17 21:40:58,To EUR Savings,-0.51,0,EUR,COMPLETED,432.26
CARD_PAYMENT,Current,2022-05-17 12:51:54,2022-05-18 09:50:10,Uber Eats,-31.2,0,EUR,COMPLETED,401.06
CARD_PAYMENT,Current,2022-05-17 21:40:58,2022-05-19 15:52:04,YouTube,-8.49,0,EUR,COMPLETED,392.57
TRANSFER,Current,2022-05-19 15:53:17,2022-05-19 15:53:17,To EUR Savings,-0.13,0,EUR,COMPLETED,392.44
TRANSFER,Current,2022-05-21 07:53:03,2022-05-21 07:53:03,To EUR Savings,-0.85,0,EUR,COMPLETED,391.59
TRANSFER,Current,2022-05-21 09:17:19,2022-05-21 09:17:19,To EUR Savings,-1,0,EUR,COMPLETED,390.59
TRANSFER,Current,2022-05-21 14:03:30,2022-05-21 14:03:30,To EUR Savings,-1,0,EUR,COMPLETED,389.59
CARD_PAYMENT,Current,2022-05-19 15:53:17,2022-05-21 17:54:00,Asuscloudco,-28.87,0,EUR,COMPLETED,360.72
TRANSFER,Current,2022-05-22 08:01:11,2022-05-22 08:01:11,To EUR Savings,-0.85,0,EUR,COMPLETED,359.87
TRANSFER,Current,2022-05-22 12:33:37,2022-05-22 12:33:37,To EUR Savings,-0.65,0,EUR,COMPLETED,359.22
TRANSFER,Current,2022-05-22 22:29:15,2022-05-22 22:29:15,To EUR Savings,-0.01,0,EUR,COMPLETED,359.21
CARD_PAYMENT,Current,2022-05-21 07:53:03,2022-05-23 03:25:39,Pad Port Miraflores,-3.15,0,EUR,COMPLETED,356.06
CARD_PAYMENT,Current,2022-05-21 14:03:29,2022-05-23 03:27:05,Saisish,-36,0,EUR,COMPLETED,320.06
CARD_PAYMENT,Current,2022-05-21 09:17:19,2022-05-23 03:28:11,Pingo Doce,-25,0,EUR,COMPLETED,295.06
TRANSFER,Current,2022-05-23 09:17:57,2022-05-23 09:17:57,To EUR Savings,-20,0,EUR,COMPLETED,275.06
CARD_PAYMENT,Current,2022-05-22 12:33:37,2022-05-23 22:38:06,Uber Eats,-16.35,0,EUR,COMPLETED,258.71
CARD_PAYMENT,Current,2022-05-22 08:01:10,2022-05-24 00:04:57,Pad Port Miraflores,-3.15,0,EUR,COMPLETED,255.56
TRANSFER,Current,2022-05-24 12:45:27,2022-05-24 12:45:27,To EUR Savings,-0.65,0,EUR,COMPLETED,254.91
TRANSFER,Current,2022-05-24 12:56:40,2022-05-24 12:56:40,To EUR Savings,-0.87,0,EUR,COMPLETED,254.04
CARD_PAYMENT,Current,2022-05-22 22:29:15,2022-05-24 13:37:04,Apple,-3.99,0,EUR,COMPLETED,250.05
CARD_PAYMENT,Current,2022-05-24 12:45:27,2022-05-25 10:20:11,Uber Eats,-16.35,0,EUR,COMPLETED,233.7
TOPUP,Current,2022-05-25 18:33:16,2022-05-25 18:33:19,Apple Pay Top-Up by *6660,500,0,EUR,COMPLETED,733.7
TOPUP,Current,2022-05-25 21:32:58,2022-05-25 21:33:01,Apple Pay Top-Up by *6660,500,0,EUR,COMPLETED,1233.7
TRANSFER,Current,2022-05-25 21:33:36,2022-05-25 21:33:36,To EUR Rainy day,-1000,0,EUR,COMPLETED,233.7
TRANSFER,Current,2022-05-26 08:46:01,2022-05-26 08:46:01,To EUR Savings,-0.53,0,EUR,COMPLETED,233.17
TRANSFER,Current,2022-05-26 08:53:23,2022-05-26 08:53:23,To EUR Savings,-0.4,0,EUR,COMPLETED,232.77
CARD_PAYMENT,Current,2022-05-24 12:56:40,2022-05-26 10:25:44,Amazon,-21.13,0,EUR,COMPLETED,211.64
TOPUP,Current,2022-05-26 21:54:37,2022-05-26 21:54:40,Apple Pay Top-Up by *6660,200,0,EUR,COMPLETED,411.64
TRANSFER,Current,2022-05-27 00:32:20,2022-05-27 00:32:20,To EUR Savings,-0.01,0,EUR,COMPLETED,411.63
TRANSFER,Current,2022-05-27 00:34:53,2022-05-27 00:34:53,To EUR Savings,-0.51,0,EUR,COMPLETED,411.12
CARD_PAYMENT,Current,2022-05-26 08:53:23,2022-05-27 10:52:52,Minipreço,-3.6,0,EUR,COMPLETED,407.52
CARD_PAYMENT,Current,2022-05-26 08:46:01,2022-05-27 10:52:52,Minipreço,-16.47,0,EUR,COMPLETED,391.05
TRANSFER,Current,2022-05-27 20:17:02,2022-05-27 20:17:02,To EUR Savings,-1,0,EUR,COMPLETED,390.05
TRANSFER,Current,2022-05-28 08:34:32,2022-05-28 08:34:32,To EUR Savings,-0.85,0,EUR,COMPLETED,389.2
TRANSFER,Current,2022-05-28 09:57:28,2022-05-28 09:57:28,To EUR Savings,-0.72,0,EUR,COMPLETED,388.48
TRANSFER,Current,2022-05-28 13:08:01,2022-05-28 13:08:01,To EUR Savings,-0.01,0,EUR,COMPLETED,388.47
TRANSFER,Current,2022-05-28 14:03:43,2022-05-28 14:03:43,To EUR Savings,-0.01,0,EUR,COMPLETED,388.46
TRANSFER,Current,2022-05-28 20:28:18,2022-05-28 20:28:18,To EUR Savings,-0.3,0,EUR,COMPLETED,388.16
CARD_PAYMENT,Current,2022-05-27 00:34:52,2022-05-28 21:46:22,Apple,-5.49,0,EUR,COMPLETED,382.67
CARD_PAYMENT,Current,2022-05-27 00:32:20,2022-05-28 21:50:59,Apple,-1.99,0,EUR,COMPLETED,380.68
ATM,Current,2022-05-27 08:48:08,2022-05-28 22:41:11,Cash at Largo Comandante August,-40,0,EUR,COMPLETED,340.68
TRANSFER,Current,2022-05-29 09:06:11,2022-05-29 09:06:11,To EUR Savings,-0.85,0,EUR,COMPLETED,339.83
CARD_PAYMENT,Current,2022-05-28 13:08:00,2022-05-29 11:09:36,Uber Eats,-43.99,0,EUR,COMPLETED,295.84
CARD_PAYMENT,Current,2022-05-28 14:03:43,2022-05-29 12:06:40,Google,-2.99,0,EUR,COMPLETED,292.85
TRANSFER,Current,2022-05-29 12:43:18,2022-05-29 12:43:18,To EUR Savings,-1,0,EUR,COMPLETED,291.85
CARD_PAYMENT,Current,2022-05-28 09:57:28,2022-05-29 13:03:03,Pingo Doce,-17.28,0,EUR,COMPLETED,274.57
CARD_PAYMENT,Current,2022-05-27 20:17:02,2022-05-29 13:03:34,Saisish,-90,0,EUR,COMPLETED,184.57
CARD_PAYMENT,Current,2022-05-28 08:34:32,2022-05-29 13:04:08,Pad Port Miraflores,-3.15,0,EUR,COMPLETED,181.42
TRANSFER,Current,2022-05-29 13:29:48,2022-05-29 13:29:48,To EUR Savings,-0.2,0,EUR,COMPLETED,181.22
TRANSFER,Current,2022-05-29 17:59:55,2022-05-29 17:59:55,To EUR Savings,-0.12,0,EUR,COMPLETED,181.1
TRANSFER,Current,2022-05-29 18:06:09,2022-05-29 18:06:09,To EUR Savings,-0.23,0,EUR,COMPLETED,180.87
TRANSFER,Current,2022-05-29 18:19:18,2022-05-29 18:19:18,To EUR Savings,-0.26,0,EUR,COMPLETED,180.61
TRANSFER,Current,2022-05-30 08:43:20,2022-05-30 08:43:20,To EUR Savings,-0.25,0,EUR,COMPLETED,180.36
CARD_PAYMENT,Current,2022-05-28 20:28:18,2022-05-30 09:45:35,PayPal,-53.7,0,EUR,COMPLETED,126.66
CARD_PAYMENT,Current,2022-05-29 18:19:18,2022-05-30 09:51:43,Auto Rana Lda Post,-70.74,0,EUR,COMPLETED,55.92
CARD_PAYMENT,Current,2022-05-29 17:59:55,2022-05-30 12:37:22,Pingo Doce,-1.88,0,EUR,COMPLETED,54.04
CARD_PAYMENT,Current,2022-05-29 12:43:17,2022-05-30 12:39:16,Saisish,-26,0,EUR,COMPLETED,28.04
CARD_PAYMENT,Current,2022-05-29 13:29:48,2022-05-30 12:39:36,Mercado de Algés,-1.8,0,EUR,COMPLETED,26.24
CARD_PAYMENT,Current,2022-05-29 09:06:11,2022-05-30 12:39:57,Pad Port Miraflores,-3.15,0,EUR,COMPLETED,23.09
TRANSFER,Current,2022-05-30 16:50:02,2022-05-30 16:50:02,To EUR Savings,-1,0,EUR,COMPLETED,22.09
TRANSFER,Current,2022-05-31 08:40:24,2022-05-31 08:40:24,To EUR Savings,-0.98,0,EUR,COMPLETED,21.11
CARD_PAYMENT,Current,2022-05-30 16:50:01,2022-05-31 09:49:47,Parques Tejo,-6,0,EUR,COMPLETED,15.11
CARD_PAYMENT,Current,2022-05-29 18:05:21,2022-05-31 14:56:37,Uber,-3.77,0,EUR,COMPLETED,11.34
CARD_PAYMENT,Current,2022-05-30 08:43:19,2022-05-31 16:32:52,Minipreço,-6.75,0,EUR,COMPLETED,4.59
TOPUP,Current,2022-06-01 08:15:19,2022-06-01 08:15:22,Apple Pay Top-Up by *6660,400,0,EUR,COMPLETED,404.59
TRANSFER,Current,2022-06-01 08:37:06,2022-06-01 08:37:06,To EUR Savings,-0.39,0,EUR,COMPLETED,404.2
CARD_PAYMENT,Current,2022-05-31 08:40:23,2022-06-01 11:04:01,Minipreço,-3.02,0,EUR,COMPLETED,401.18
TRANSFER,Current,2022-06-01 11:33:28,2022-06-01 11:33:28,To EUR Bills,-100,0,EUR,COMPLETED,301.18
TRANSFER,Current,2022-06-02 08:56:45,2022-06-02 08:56:45,To EUR Savings,-0.23,0,EUR,COMPLETED,300.95
CARD_PAYMENT,Current,2022-06-01 08:37:06,2022-06-02 10:25:59,Minipreço,-6.61,0,EUR,COMPLETED,294.34
TRANSFER,Current,2022-06-02 11:01:21,2022-06-02 11:01:21,To EUR Savings,-0.74,0,EUR,COMPLETED,293.6
TRANSFER,Current,2022-06-03 08:42:49,2022-06-03 08:42:49,To EUR Savings,-0.33,0,EUR,COMPLETED,293.27
CARD_PAYMENT,Current,2022-06-03 12:42:18,,Uber Eats,-31.7,0,EUR,REVERTED,
TRANSFER,Current,2022-06-03 12:42:23,2022-06-03 12:42:23,To EUR Savings,-0.3,0,EUR,COMPLETED,292.97
TRANSFER,Current,2022-06-03 12:52:48,2022-06-03 12:52:48,To EUR Savings,-0.09,0,EUR,COMPLETED,292.88
CARD_PAYMENT,Current,2022-06-02 08:56:45,2022-06-03 22:52:42,Minipreço,-3.77,0,EUR,COMPLETED,289.11
CARD_PAYMENT,Current,2022-06-02 11:01:20,2022-06-03 22:52:43,Minipreço,-10.26,0,EUR,COMPLETED,278.85
TRANSFER,Current,2022-06-04 09:46:53,2022-06-04 09:46:53,To EUR Savings,-0.2,0,EUR,COMPLETED,278.65
TRANSFER,Current,2022-06-04 10:11:40,2022-06-04 10:11:40,To EUR Savings,-0.61,0,EUR,COMPLETED,278.04
CARD_PAYMENT,Current,2022-06-03 12:52:44,2022-06-04 11:18:02,Uber Eats,-27.91,0,EUR,COMPLETED,250.13
CARD_PAYMENT,Current,2022-06-03 08:42:49,2022-06-04 12:11:37,Minipreço,-11.67,0,EUR,COMPLETED,238.46
TRANSFER,Current,2022-06-05 07:15:56,2022-06-05 07:15:56,To EUR Savings,-0.77,0,EUR,COMPLETED,237.69
TRANSFER,Current,2022-06-05 09:54:42,2022-06-05 09:54:42,To EUR Savings,-0.3,0,EUR,COMPLETED,237.39
CARD_PAYMENT,Current,2022-06-04 09:46:53,2022-06-05 10:14:15,Controlauto Miraflores,-31.8,0,EUR,COMPLETED,205.59
CARD_PAYMENT,Current,2022-06-04 10:11:39,2022-06-05 10:14:35,Pingo Doce,-24.39,0,EUR,COMPLETED,181.2
TRANSFER,Current,2022-06-05 10:14:44,2022-06-05 10:14:44,To EUR,500,0,EUR,COMPLETED,681.2
TRANSFER,Current,2022-06-05 12:14:37,2022-06-05 12:14:37,To EUR Savings,-0.56,0,EUR,COMPLETED,680.64
TRANSFER,Current,2022-06-05 23:30:00,2022-06-05 23:30:00,To EUR Savings,-1,0,EUR,COMPLETED,679.64
TRANSFER,Current,2022-06-06 08:36:22,2022-06-06 08:36:22,To EUR Savings,-0.94,0,EUR,COMPLETED,678.7
TRANSFER,Current,2022-06-06 09:22:52,2022-06-06 09:22:52,To EUR Savings,-20,0,EUR,COMPLETED,658.7
CARD_PAYMENT,Current,2022-06-05 12:14:37,2022-06-06 10:03:58,Amazon,-27.44,0,EUR,COMPLETED,631.26
ATM,Current,2022-06-05 08:10:56,2022-06-06 11:06:31,Cash at Pingo Doce - Rebelva,-50,0,EUR,COMPLETED,581.26
TRANSFER,Current,2022-06-06 12:29:26,2022-06-06 12:29:26,To EUR Savings,-1,0,EUR,COMPLETED,580.26
CARD_PAYMENT,Current,2022-06-05 09:54:42,2022-06-06 12:42:12,Quiosque Dos Sabores,-0.7,0,EUR,COMPLETED,579.56
CARD_PAYMENT,Current,2022-06-05 07:15:56,2022-06-06 12:43:03,Repsol,-78.23,0,EUR,COMPLETED,501.33
TRANSFER,Current,2022-06-06 13:51:01,2022-06-06 13:51:01,To EUR Savings,-0.3,0,EUR,COMPLETED,501.03
CARD_PAYMENT,Current,2022-06-06 12:29:26,2022-06-07 09:47:32,Saisish,-18,0,EUR,COMPLETED,483.03
CARD_PAYMENT,Current,2022-06-06 13:51:01,2022-06-07 09:49:15,Mercado de Algés,-2.7,0,EUR,COMPLETED,480.33
CARD_PAYMENT,Current,2022-06-05 23:29:59,2022-06-07 11:37:53,Apple,-49,0,EUR,COMPLETED,431.33
TRANSFER,Current,2022-06-07 12:50:51,2022-06-07 12:50:51,To EUR Savings,-0.8,0,EUR,COMPLETED,430.53
CARD_PAYMENT,Current,2022-06-06 08:36:22,2022-06-08 00:26:31,Minipreço,-2.06,0,EUR,COMPLETED,428.47
TRANSFER,Current,2022-06-08 08:45:13,2022-06-08 08:45:13,To EUR Savings,-0.25,0,EUR,COMPLETED,428.22
TRANSFER,Current,2022-06-08 08:52:38,2022-06-08 08:52:38,To EUR Savings,-0.01,0,EUR,COMPLETED,428.21
TRANSFER,Current,2022-06-09 08:24:33,2022-06-09 08:24:33,To EUR Savings,-0.85,0,EUR,COMPLETED,427.36
TRANSFER,Current,2022-06-09 10:28:47,2022-06-09 10:28:47,To EUR,500,0,EUR,COMPLETED,927.36
TRANSFER,Current,2022-06-09 10:29:16,2022-06-09 10:29:16,To EUR Savings,-0.2,0,EUR,COMPLETED,927.16
TRANSFER,Current,2022-06-09 14:59:48,2022-06-09 14:59:48,To EUR Savings,-0.9,0,EUR,COMPLETED,926.26
CARD_PAYMENT,Current,2022-06-07 12:49:57,2022-06-10 02:16:47,Uber Eats,-31.2,0,EUR,COMPLETED,895.06
TRANSFER,Current,2022-06-10 10:28:52,2022-06-10 10:28:52,To EUR Savings,-1,0,EUR,COMPLETED,894.06
CARD_PAYMENT,Current,2022-06-08 08:52:37,2022-06-10 11:38:00,Apple,-0.99,0,EUR,COMPLETED,893.07
CARD_PAYMENT,Current,2022-06-08 08:45:13,2022-06-10 13:42:11,Minipreço,-5.75,0,EUR,COMPLETED,887.32
TRANSFER,Current,2022-06-10 21:23:25,2022-06-10 21:23:25,To EUR Savings,-1,0,EUR,COMPLETED,886.32
CARD_PAYMENT,Current,2022-06-09 10:29:16,2022-06-10 23:36:30,PCDIGA,-577.8,0,EUR,COMPLETED,308.52
CARD_PAYMENT,Current,2022-06-09 14:59:47,2022-06-11 04:56:55,Restaurante Vidal,-38.1,0,EUR,COMPLETED,270.42
CARD_PAYMENT,Current,2022-06-09 08:24:33,2022-06-11 04:57:47,Pad Port Miraflores,-3.15,0,EUR,COMPLETED,267.27
TOPUP,Current,2022-06-11 08:40:22,2022-06-11 08:40:24,Apple Pay Top-Up by *6660,200,0,EUR,COMPLETED,467.27
TRANSFER,Current,2022-06-11 10:23:25,2022-06-11 10:23:25,To EUR Savings,-1,0,EUR,COMPLETED,466.27
TRANSFER,Current,2022-06-11 14:23:34,2022-06-11 14:23:34,To EUR Savings,-0.9,0,EUR,COMPLETED,465.37
TRANSFER,Current,2022-06-11 14:45:17,2022-06-11 14:45:17,To EUR Savings,-1,0,EUR,COMPLETED,464.37
CARD_PAYMENT,Current,2022-06-10 10:28:51,2022-06-11 19:36:57,Classica Livraria E,-14,0,EUR,COMPLETED,450.37
TRANSFER,Current,2022-06-11 21:41:38,2022-06-11 21:41:38,To EUR Savings,-0.01,0,EUR,COMPLETED,450.36
TRANSFER,Current,2022-06-12 10:13:06,2022-06-12 10:13:06,To EUR Savings,-0.5,0,EUR,COMPLETED,449.86
CARD_PAYMENT,Current,2022-06-11 14:23:30,2022-06-12 13:17:23,Davide Manuel Martin,-25.1,0,EUR,COMPLETED,424.76
CARD_PAYMENT,Current,2022-06-11 14:45:17,2022-06-12 13:19:48,Parque Arqueológico do Vale do Côa,-14,0,EUR,COMPLETED,410.76
CARD_PAYMENT,Current,2022-06-11 10:21:51,2022-06-12 13:19:49,Gaspe Combustiveis,-90,0,EUR,COMPLETED,320.76
CARD_PAYMENT,Current,2022-06-10 21:23:24,2022-06-12 13:19:49,Taberna Carro,-50,0,EUR,COMPLETED,270.76
TRANSFER,Current,2022-06-12 16:08:07,2022-06-12 16:08:07,To EUR Savings,-0.8,0,EUR,COMPLETED,269.96
TRANSFER,Current,2022-06-13 08:57:04,2022-06-13 08:57:04,To EUR Savings,-0.85,0,EUR,COMPLETED,269.11
TRANSFER,Current,2022-06-13 09:23:20,2022-06-13 09:23:20,To EUR Savings,-20,0,EUR,COMPLETED,249.11
CARD_PAYMENT,Current,2022-06-12 10:13:06,2022-06-13 11:18:05,BP,-3.5,0,EUR,COMPLETED,245.61
TRANSFER,Current,2022-06-13 12:06:00,2022-06-13 12:06:00,To EUR Savings,-0.8,0,EUR,COMPLETED,244.81
CARD_PAYMENT,Current,2022-06-12 16:08:04,2022-06-13 12:24:55,Brisa,-2.2,0,EUR,COMPLETED,242.61
CARD_PAYMENT,Current,2022-06-11 21:41:38,2022-06-13 23:44:06,Apple,-6.99,0,EUR,COMPLETED,235.62
CARD_PAYMENT,Current,2022-06-13 08:57:04,2022-06-14 11:17:14,Pad Port Miraflores,-3.15,0,EUR,COMPLETED,232.47
CARD_PAYMENT,Current,2022-06-13 12:05:56,2022-06-14 17:53:11,Uber Eats,-31.2,0,EUR,COMPLETED,201.27
TRANSFER,Current,2022-06-14 18:59:02,2022-06-14 18:59:02,To EUR Savings,-0.43,0,EUR,COMPLETED,200.84
TRANSFER,Current,2022-06-15 20:26:32,2022-06-15 20:26:32,To EUR Savings,-0.77,0,EUR,COMPLETED,200.07
TOPUP,Current,2022-06-15 21:50:44,2022-06-15 21:50:46,Apple Pay Top-Up by *6660,200,0,EUR,COMPLETED,400.07
CARD_PAYMENT,Current,2022-06-14 18:59:02,2022-06-15 22:53:03,Minipreço,-8.57,0,EUR,COMPLETED,391.5
TRANSFER,Current,2022-06-16 08:44:05,2022-06-16 08:44:05,To EUR Savings,-0.38,0,EUR,COMPLETED,391.12
TRANSFER,Current,2022-06-17 08:47:33,2022-06-17 08:47:33,To EUR Savings,-0.94,0,EUR,COMPLETED,390.18
CARD_PAYMENT,Current,2022-06-15 20:26:32,2022-06-17 18:23:42,Minipreço,-6.23,0,EUR,COMPLETED,383.95
CARD_PAYMENT,Current,2022-06-16 08:44:05,2022-06-17 18:23:43,Minipreço,-5.62,0,EUR,COMPLETED,378.33
TRANSFER,Current,2022-06-17 21:40:58,2022-06-17 21:40:58,To EUR Savings,-0.51,0,EUR,COMPLETED,377.82
TRANSFER,Current,2022-06-18 07:56:26,2022-06-18 07:56:26,To EUR Savings,-0.85,0,EUR,COMPLETED,376.97
CARD_PAYMENT,Current,2022-06-17 08:47:33,2022-06-18 10:30:15,Minipreço,-5.06,0,EUR,COMPLETED,371.91
TRANSFER,Current,2022-06-18 10:47:33,2022-06-18 10:47:33,To EUR Savings,-1,0,EUR,COMPLETED,370.91
TRANSFER,Current,2022-06-18 10:57:01,2022-06-18 10:57:01,To EUR Savings,-0.55,0,EUR,COMPLETED,370.36
TRANSFER,Current,2022-06-19 08:54:51,2022-06-19 08:54:51,To EUR Savings,-0.85,0,EUR,COMPLETED,369.51
TRANSFER,Current,2022-06-19 10:59:41,2022-06-19 10:59:41,To EUR Savings,-0.56,0,EUR,COMPLETED,368.95
TRANSFER,Current,2022-06-19 12:22:54,2022-06-19 12:22:54,To EUR Savings,-0.5,0,EUR,COMPLETED,368.45
TRANSFER,Current,2022-06-19 12:25:01,2022-06-19 12:25:01,To EUR Savings,-0.1,0,EUR,COMPLETED,368.35
TRANSFER,Current,2022-06-19 12:32:07,2022-06-19 12:32:07,To EUR Savings,-1,0,EUR,COMPLETED,367.35
TRANSFER,Current,2022-06-19 13:01:14,2022-06-19 13:01:14,To EUR Savings,-0.2,0,EUR,COMPLETED,367.15
TRANSFER,Current,2022-06-19 14:02:15,2022-06-19 14:02:15,To EUR Savings,-0.2,0,EUR,COMPLETED,366.95
TRANSFER,Current,2022-06-19 15:11:07,2022-06-19 15:11:07,To EUR Savings,-1,0,EUR,COMPLETED,365.95
CARD_PAYMENT,Current,2022-06-18 07:56:26,2022-06-19 16:15:51,Pad Port Miraflores,-3.15,0,EUR,COMPLETED,362.8
CARD_PAYMENT,Current,2022-06-18 10:28:25,2022-06-19 16:16:02,Auchan,-75.45,0,EUR,COMPLETED,287.35
CARD_PAYMENT,Current,2022-06-18 10:08:22,2022-06-19 16:16:02,Ericeira Surf & Skate,-5,0,EUR,COMPLETED,282.35
TRANSFER,Current,2022-06-19 22:18:19,2022-06-19 22:18:19,To EUR Savings,-0.9,0,EUR,COMPLETED,281.45
CARD_PAYMENT,Current,2022-06-17 21:40:58,2022-06-20 01:06:51,YouTube,-8.49,0,EUR,COMPLETED,272.96
TRANSFER,Current,2022-06-20 08:28:58,2022-06-20 08:28:58,To EUR Savings,-0.85,0,EUR,COMPLETED,272.11
TRANSFER,Current,2022-06-20 09:26:32,2022-06-20 09:26:32,To EUR Savings,-20,0,EUR,COMPLETED,252.11
TRANSFER,Current,2022-06-20 11:40:14,2022-06-20 11:40:14,To EUR Savings,-1,0,EUR,COMPLETED,251.11
TRANSFER,Current,2022-06-20 12:19:26,2022-06-20 12:19:26,To EUR Savings,-0.2,0,EUR,COMPLETED,250.91
CARD_PAYMENT,Current,2022-06-19 10:59:41,2022-06-20 13:14:11,Minipreço,-38.44,0,EUR,COMPLETED,212.47
TRANSFER,Current,2022-06-20 14:10:49,2022-06-20 14:10:49,To EUR Savings,-0.7,0,EUR,COMPLETED,211.77
CARD_PAYMENT,Current,2022-06-19 08:54:51,2022-06-20 14:53:03,Pad Port Miraflores,-3.15,0,EUR,COMPLETED,208.62
CARD_PAYMENT,Current,2022-06-19 12:22:54,2022-06-20 14:54:07,Saisish,-12.5,0,EUR,COMPLETED,196.12
CARD_PAYMENT,Current,2022-06-19 12:25:01,2022-06-20 14:54:07,Receita Pomposa,-14.9,0,EUR,COMPLETED,181.22
CARD_PAYMENT,Current,2022-06-19 13:01:14,2022-06-20 14:54:22,Mercado de Algés,-1.8,0,EUR,COMPLETED,179.42
CARD_PAYMENT,Current,2022-06-19 12:32:07,2022-06-20 14:54:22,Mercado de Algés,-4,0,EUR,COMPLETED,175.42
CARD_PAYMENT,Current,2022-06-19 14:02:15,2022-06-20 14:54:53,Mercado de Algés,-1.8,0,EUR,COMPLETED,173.62
CARD_PAYMENT,Current,2022-06-19 15:11:06,2022-06-20 14:55:10,Gelados Santini,-7,0,EUR,COMPLETED,166.62
TOPUP,Current,2022-06-21 08:30:33,2022-06-21 08:30:36,Apple Pay Top-Up by *6660,200,0,EUR,COMPLETED,366.62
TRANSFER,Current,2022-06-21 08:34:38,2022-06-21 08:34:38,To EUR Savings,-0.85,0,EUR,COMPLETED,365.77
CARD_PAYMENT,Current,2022-06-20 11:40:14,2022-06-21 09:12:01,Starwash,-35,0,EUR,COMPLETED,330.77
CARD_PAYMENT,Current,2022-06-20 08:28:58,2022-06-21 11:08:17,Pad Port Miraflores,-3.15,0,EUR,COMPLETED,327.62
CARD_PAYMENT,Current,2022-06-20 12:19:25,2022-06-21 11:09:06,Controlauto Aboboda,-31.8,0,EUR,COMPLETED,295.82
CARD_PAYMENT,Current,2022-06-20 14:10:49,2022-06-21 11:09:41,Britavola,-32.3,0,EUR,COMPLETED,263.52
TRANSFER,Current,2022-06-21 13:14:19,2022-06-21 13:14:19,To EUR Savings,-1,0,EUR,COMPLETED,262.52
TRANSFER,Current,2022-06-21 14:45:36,2022-06-21 14:45:36,To EUR Savings,-0.4,0,EUR,COMPLETED,262.12
CARD_PAYMENT,Current,2022-06-19 22:18:19,2022-06-21 18:01:18,Nos Cinemas,-7.1,0,EUR,COMPLETED,255.02
TRANSFER,Current,2022-06-21 19:07:19,2022-06-21 19:07:19,To EUR Savings,-0.66,0,EUR,COMPLETED,254.36
CARD_PAYMENT,Current,2022-06-21 08:34:37,2022-06-22 10:40:22,Pad Port Miraflores,-3.15,0,EUR,COMPLETED,251.21
CARD_PAYMENT,Current,2022-06-21 13:14:19,2022-06-22 10:41:17,Saisish,-27,0,EUR,COMPLETED,224.21
CARD_PAYMENT,Current,2022-06-21 14:45:35,2022-06-22 10:42:00,Padaria Lisboa,-7.6,0,EUR,COMPLETED,216.61
CARD_PAYMENT,Current,2022-06-21 19:07:18,2022-06-22 10:43:43,Pingo Doce,-24.34,0,EUR,COMPLETED,192.27
TRANSFER,Current,2022-06-22 11:55:17,2022-06-22 11:55:17,To EUR Savings,-0.15,0,EUR,COMPLETED,192.12
TRANSFER,Current,2022-06-22 15:15:56,2022-06-22 15:15:56,To EUR Savings,-0.2,0,EUR,COMPLETED,191.92
TRANSFER,Current,2022-06-23 08:20:35,2022-06-23 08:20:35,To EUR Savings,-0.85,0,EUR,COMPLETED,191.07
TOPUP,Current,2022-06-23 12:23:55,2022-06-23 12:23:58,Apple Pay Top-Up by *6660,200,0,EUR,COMPLETED,391.07
CARD_PAYMENT,Current,2022-06-22 11:55:16,2022-06-23 12:39:56,Pingo Doce,-32.85,0,EUR,COMPLETED,358.22
CARD_PAYMENT,Current,2022-06-22 15:15:55,2022-06-23 12:41:00,Summerafternoon,-48.8,0,EUR,COMPLETED,309.42
TRANSFER,Current,2022-06-23 14:40:18,2022-06-23 14:40:18,To EUR Savings,-0.84,0,EUR,COMPLETED,308.58
TRANSFER,Current,2022-06-23 16:23:35,2022-06-23 16:23:35,To EUR Savings,-0.5,0,EUR,COMPLETED,308.08
TRANSFER,Current,2022-06-23 17:55:17,2022-06-23 17:55:17,To EUR Savings,-0.01,0,EUR,COMPLETED,308.07
TRANSFER,Current,2022-06-23 20:24:38,2022-06-23 20:24:38,To EUR Savings,-0.81,0,EUR,COMPLETED,307.26
TRANSFER,Current,2022-06-24 09:13:27,2022-06-24 09:13:27,To EUR Savings,-0.85,0,EUR,COMPLETED,306.41
CARD_PAYMENT,Current,2022-06-23 16:23:35,2022-06-24 13:50:12,Nata Lisboa,-6.5,0,EUR,COMPLETED,299.91
CARD_PAYMENT,Current,2022-06-23 14:40:18,2022-06-24 13:51:00,Poco Das Fontainhas,-162.16,0,EUR,COMPLETED,137.75
CARD_PAYMENT,Current,2022-06-23 08:20:35,2022-06-24 15:21:39,Pad Port Miraflores,-3.15,0,EUR,COMPLETED,134.6
TRANSFER,Current,2022-06-24 18:13:28,2022-06-24 18:13:28,To EUR Savings,-0.5,0,EUR,COMPLETED,134.1
TRANSFER,Current,2022-06-25 08:42:33,2022-06-25 08:42:33,To EUR Savings,-0.85,0,EUR,COMPLETED,133.25
TRANSFER,Current,2022-06-25 14:47:41,2022-06-25 14:47:41,To EUR Savings,-0.1,0,EUR,COMPLETED,133.15
TOPUP,Current,2022-06-25 15:35:45,2022-06-25 15:35:48,Apple Pay Top-Up by *6660,200,0,EUR,COMPLETED,333.15
TRANSFER,Current,2022-06-25 23:49:04,2022-06-25 23:49:04,To EUR Savings,-0.8,0,EUR,COMPLETED,332.35
TRANSFER,Current,2022-06-26 07:27:10,2022-06-26 07:27:10,To EUR Savings,-0.89,0,EUR,COMPLETED,331.46
TRANSFER,Current,2022-06-26 07:45:08,2022-06-26 07:45:08,To EUR Savings,-0.85,0,EUR,COMPLETED,330.61
TRANSFER,Current,2022-06-26 09:22:57,2022-06-26 09:22:57,To EUR Savings,-0.5,0,EUR,COMPLETED,330.11
TRANSFER,Current,2022-06-26 09:28:37,2022-06-26 09:28:37,To EUR Savings,-0.51,0,EUR,COMPLETED,329.6
CARD_PAYMENT,Current,2022-06-23 17:55:13,2022-06-26 19:46:00,Apple,-5.99,0,EUR,COMPLETED,323.61
CARD_PAYMENT,Current,2022-06-24 18:12:48,2022-06-26 20:53:52,Windsurf Cafe,-8.5,0,EUR,COMPLETED,315.11
CARD_PAYMENT,Current,2022-06-26 22:45:44,,Uber,-8,0,EUR,REVERTED,
TRANSFER,Current,2022-06-26 22:45:44,2022-06-26 22:45:44,To EUR Savings,-1,0,EUR,COMPLETED,314.11
TRANSFER,Current,2022-06-26 22:47:02,2022-06-26 22:47:02,To EUR Savings,-0.8,0,EUR,COMPLETED,313.31
TOPUP,Current,2022-06-26 22:53:52,2022-06-26 22:54:00,Apple Pay Top-Up by *6660,200,0,EUR,COMPLETED,513.31
CARD_PAYMENT,Current,2022-06-23 20:24:38,2022-06-26 23:39:43,Auchan,-41.19,0,EUR,COMPLETED,472.12
CARD_PAYMENT,Current,2022-06-24 09:12:19,2022-06-26 23:40:44,Pad Port Miraflores,-3.15,0,EUR,COMPLETED,468.97
TRANSFER,Current,2022-06-27 00:32:54,2022-06-27 00:32:54,To EUR Savings,-0.01,0,EUR,COMPLETED,468.96
TRANSFER,Current,2022-06-27 00:35:50,2022-06-27 00:35:50,To EUR Savings,-0.51,0,EUR,COMPLETED,468.45
TRANSFER,Current,2022-06-27 09:28:06,2022-06-27 09:28:06,To EUR Savings,-20,0,EUR,COMPLETED,448.45
TRANSFER,Current,2022-06-27 09:37:01,2022-06-27 09:37:01,To EUR Savings,-0.85,0,EUR,COMPLETED,447.6
CARD_PAYMENT,Current,2022-06-25 08:42:33,2022-06-27 14:23:42,Pad Port Miraflores,-3.15,0,EUR,COMPLETED,444.45
CARD_PAYMENT,Current,2022-06-25 14:47:41,2022-06-27 14:24:31,Fund Calouste Gulben,-9.9,0,EUR,COMPLETED,434.55
TRANSFER,Current,2022-06-27 16:09:57,2022-06-27 16:13:22,Revolut Bank UAB,-60,0,EUR,COMPLETED,374.55
TRANSFER,Current,2022-06-27 16:31:56,2022-06-27 16:31:56,To EUR Savings,-0.65,0,EUR,COMPLETED,373.9
TRANSFER,Current,2022-06-27 20:08:46,2022-06-27 20:08:46,To EUR Savings,-0.66,0,EUR,COMPLETED,373.24
CARD_PAYMENT,Current,2022-06-25 23:49:04,2022-06-28 02:39:11,Uber,-10.2,0,EUR,COMPLETED,363.04
CARD_PAYMENT,Current,2022-06-26 07:27:09,2022-06-28 06:01:46,Repsol,-82.11,0,EUR,COMPLETED,280.93
CARD_PAYMENT,Current,2022-06-26 09:28:37,2022-06-28 06:01:46,Gleba,-4.49,0,EUR,COMPLETED,276.44
CARD_PAYMENT,Current,2022-06-26 09:22:57,2022-06-28 06:01:46,Auchan,-10.5,0,EUR,COMPLETED,265.94
CARD_PAYMENT,Current,2022-06-26 07:45:08,2022-06-28 06:01:46,Pad Port Miraflores,-3.15,0,EUR,COMPLETED,262.79
TRANSFER,Current,2022-06-28 09:16:19,2022-06-28 09:16:19,To EUR Savings,-0.85,0,EUR,COMPLETED,261.94
TRANSFER,Current,2022-06-28 10:19:37,2022-06-28 10:19:37,To EUR Savings,-0.1,0,EUR,COMPLETED,261.84
TRANSFER,Current,2022-06-28 10:50:03,2022-06-28 10:50:03,To EUR Savings,-0.05,0,EUR,COMPLETED,261.79
TOPUP,Current,2022-06-28 10:51:20,2022-06-28 10:51:23,Apple Pay Top-Up by *6660,200,0,EUR,COMPLETED,461.79
TRANSFER,Current,2022-06-28 13:11:30,2022-06-28 13:11:30,To EUR Savings,-1,0,EUR,COMPLETED,460.79
TRANSFER,Current,2022-06-28 14:03:43,2022-06-28 14:03:43,To EUR Savings,-0.01,0,EUR,COMPLETED,460.78
TRANSFER,Current,2022-06-28 14:06:19,2022-06-28 14:06:19,To EUR Savings,-0.2,0,EUR,COMPLETED,460.58
CARD_PAYMENT,Current,2022-06-26 22:47:02,2022-06-28 19:26:54,Uber,-7.2,0,EUR,COMPLETED,453.38
CARD_PAYMENT,Current,2022-06-27 00:35:50,2022-06-28 19:42:14,Apple,-5.49,0,EUR,COMPLETED,447.89
CARD_PAYMENT,Current,2022-06-27 00:32:54,2022-06-28 20:09:50,Apple,-1.99,0,EUR,COMPLETED,445.9
CARD_PAYMENT,Current,2022-06-27 16:31:56,2022-06-28 21:23:27,Minipreço,-6.35,0,EUR,COMPLETED,439.55
CARD_PAYMENT,Current,2022-06-27 09:37:01,2022-06-28 22:53:18,A Padaria Portuguesa,-3.15,0,EUR,COMPLETED,436.4
TRANSFER,Current,2022-06-29 09:27:52,2022-06-29 09:27:52,To EUR Savings,-0.85,0,EUR,COMPLETED,435.55
CARD_PAYMENT,Current,2022-06-28 14:03:42,2022-06-29 12:43:01,Google,-2.99,0,EUR,COMPLETED,432.56
CARD_PAYMENT,Current,2022-06-27 20:08:46,2022-06-29 15:24:34,Pingo Doce,-18.34,0,EUR,COMPLETED,414.22
CARD_PAYMENT,Current,2022-06-28 09:16:18,2022-06-29 15:25:22,Pad Port Miraflores,-3.15,0,EUR,COMPLETED,411.07
CARD_PAYMENT,Current,2022-06-28 10:19:37,2022-06-29 15:25:43,Jean Louis David,-17.9,0,EUR,COMPLETED,393.17
CARD_PAYMENT,Current,2022-06-28 10:50:03,2022-06-29 15:25:43,Massimo Dutti,-49.95,0,EUR,COMPLETED,343.22
CARD_PAYMENT,Current,2022-06-28 13:11:30,2022-06-29 15:26:39,Saisish,-29,0,EUR,COMPLETED,314.22
CARD_PAYMENT,Current,2022-06-28 14:06:19,2022-06-29 15:27:08,Mercado de Algés,-1.8,0,EUR,COMPLETED,312.42
TRANSFER,Current,2022-06-30 10:39:45,2022-06-30 10:39:45,To EUR Savings,-0.71,0,EUR,COMPLETED,311.71
TRANSFER,Current,2022-06-30 10:43:17,2022-06-30 10:43:17,To EUR Savings,-0.45,0,EUR,COMPLETED,311.26
TOPUP,Current,2022-06-30 10:44:19,2022-06-30 10:44:22,Apple Pay Top-Up by *6660,200,0,EUR,COMPLETED,511.26
CARD_PAYMENT,Current,2022-06-29 09:27:51,2022-06-30 12:35:45,A Padaria Portuguesa,-3.15,0,EUR,COMPLETED,508.11
CARD_PAYMENT,Current,2022-06-30 10:39:43,2022-07-01 11:05:57,PRIO,-58.29,0,EUR,COMPLETED,449.82
CARD_PAYMENT,Current,2022-06-30 10:43:13,2022-07-01 11:05:57,PRIO,-1.55,0,EUR,COMPLETED,448.27
TRANSFER,Current,2022-07-01 11:34:50,2022-07-01 11:34:50,To EUR Bills,-100,0,EUR,COMPLETED,348.27
TRANSFER,Current,2022-07-01 14:34:00,2022-07-01 14:34:00,To EUR Savings,-0.6,0,EUR,COMPLETED,347.67
TRANSFER,Current,2022-07-01 17:04:12,2022-07-01 17:04:12,To EUR Savings,-0.55,0,EUR,COMPLETED,347.12
TRANSFER,Current,2022-07-01 20:23:10,2022-07-01 20:23:10,To EUR Savings,-0.2,0,EUR,COMPLETED,346.92
TRANSFER,Current,2022-07-02 03:13:49,2022-07-02 03:13:49,To EUR Savings,-0.01,0,EUR,COMPLETED,346.91
CARD_PAYMENT,Current,2022-07-01 14:34:00,2022-07-02 12:42:56,Cafe Rest Beira Rio,-40.4,0,EUR,COMPLETED,306.51
CARD_PAYMENT,Current,2022-07-01 17:04:12,2022-07-02 12:54:10,Minipreço,-18.45,0,EUR,COMPLETED,288.06
TRANSFER,Current,2022-07-02 14:41:04,2022-07-02 14:41:04,To EUR Savings,-0.9,0,EUR,COMPLETED,287.16
TRANSFER,Current,2022-07-02 18:04:36,2022-07-02 18:04:36,To EUR Savings,-0.14,0,EUR,COMPLETED,287.02
CARD_PAYMENT,Current,2022-07-01 20:23:09,2022-07-03 10:38:40,Cafe Rest Beira Rio,-11.8,0,EUR,COMPLETED,275.22
CARD_PAYMENT,Current,2022-07-02 18:04:36,2022-07-03 10:40:51,Minipreço,-15.86,0,EUR,COMPLETED,259.36
CARD_PAYMENT,Current,2022-07-02 14:41:03,2022-07-03 10:40:51,Alvaros,-50.1,0,EUR,COMPLETED,209.26
TRANSFER,Current,2022-07-03 10:42:08,2022-07-03 10:42:08,To EUR Savings,-0.2,0,EUR,COMPLETED,209.06
TRANSFER,Current,2022-07-03 14:36:54,2022-07-03 14:36:54,To EUR Savings,-0.5,0,EUR,COMPLETED,208.56
CARD_PAYMENT,Current,2022-07-02 03:13:49,2022-07-03 21:29:10,Apple,-4.99,0,EUR,COMPLETED,203.57
TRANSFER,Current,2022-07-04 09:29:50,2022-07-04 09:29:50,To EUR Savings,-20,0,EUR,COMPLETED,183.57
CARD_PAYMENT,Current,2022-07-03 10:42:08,2022-07-04 09:39:51,Oleigois,-14.8,0,EUR,COMPLETED,168.77
CARD_PAYMENT,Current,2022-07-03 14:36:54,2022-07-04 09:40:30,Cafe Rest Beira Rio,-41.5,0,EUR,COMPLETED,127.27
TRANSFER,Current,2022-07-04 13:30:04,2022-07-04 13:30:04,Revolut Bank UAB,7,0,EUR,COMPLETED,134.27
TRANSFER,Current,2022-07-05 12:55:26,2022-07-05 12:55:26,To EUR Savings,-0.01,0,EUR,COMPLETED,134.26
TOPUP,Current,2022-07-05 12:56:16,2022-07-05 12:56:19,Apple Pay Top-Up by *6660,200,0,EUR,COMPLETED,334.26
TRANSFER,Current,2022-07-05 18:54:20,2022-07-05 18:54:20,To EUR Savings,-0.82,0,EUR,COMPLETED,333.44
TRANSFER,Current,2022-07-05 20:54:11,2022-07-05 20:54:11,To EUR Savings,-0.31,0,EUR,COMPLETED,333.13
CARD_PAYMENT,Current,2022-07-05 12:55:25,2022-07-06 10:43:21,Uber Eats,-32.99,0,EUR,COMPLETED,300.14
TRANSFER,Current,2022-07-06 12:37:59,2022-07-06 12:37:59,To EUR Savings,-0.98,0,EUR,COMPLETED,299.16
CARD_PAYMENT,Current,2022-07-05 18:54:19,2022-07-06 16:21:17,Auchan,-13.18,0,EUR,COMPLETED,285.98
TRANSFER,Current,2022-07-06 19:36:18,2022-07-06 19:36:18,To EUR Savings,-0.01,0,EUR,COMPLETED,285.97
TRANSFER,Current,2022-07-07 09:48:38,2022-07-07 09:48:38,To EUR Savings,-0.85,0,EUR,COMPLETED,285.12
CARD_PAYMENT,Current,2022-07-05 20:54:11,2022-07-07 09:50:25,Uber Eats,-21.69,0,EUR,COMPLETED,263.43
CARD_PAYMENT,Current,2022-07-06 12:37:59,2022-07-07 10:26:00,PayPal,-15.02,0,EUR,COMPLETED,248.41
TRANSFER,Current,2022-07-08 07:30:17,2022-07-08 07:30:17,To EUR Savings,-0.85,0,EUR,COMPLETED,247.56
CARD_PAYMENT,Current,2022-07-06 19:36:18,2022-07-08 08:45:07,Apple,-0.99,0,EUR,COMPLETED,246.57
TRANSFER,Current,2022-07-08 08:51:04,2022-07-08 08:51:04,To EUR Savings,-0.01,0,EUR,COMPLETED,246.56
CARD_PAYMENT,Current,2022-07-07 09:48:37,2022-07-08 12:32:23,Pad Port Miraflores,-3.15,0,EUR,COMPLETED,243.41
TRANSFER,Current,2022-07-09 09:28:13,2022-07-09 09:28:13,To EUR Savings,-0.85,0,EUR,COMPLETED,242.56
TRANSFER,Current,2022-07-09 09:59:32,2022-07-09 09:59:32,To EUR Savings,-0.42,0,EUR,COMPLETED,242.14
TRANSFER,Current,2022-07-09 13:47:02,2022-07-09 13:47:02,To EUR Savings,-0.51,0,EUR,COMPLETED,241.63
TRANSFER,Current,2022-07-10 08:39:59,2022-07-10 08:39:59,To EUR Savings,-0.85,0,EUR,COMPLETED,240.78
CARD_PAYMENT,Current,2022-07-08 08:51:03,2022-07-10 10:19:08,Apple,-0.99,0,EUR,COMPLETED,239.79
CARD_PAYMENT,Current,2022-07-08 07:30:17,2022-07-10 10:32:32,Pad Port Miraflores,-3.15,0,EUR,COMPLETED,236.64
CARD_PAYMENT,Current,2022-07-09 13:47:02,2022-07-10 12:01:14,Uber Eats,-54.49,0,EUR,COMPLETED,182.15
TRANSFER,Current,2022-07-10 12:45:51,2022-07-10 12:45:51,To EUR Savings,-0.68,0,EUR,COMPLETED,181.47
CARD_PAYMENT,Current,2022-07-09 09:59:32,2022-07-10 13:44:57,Auchan,-17.58,0,EUR,COMPLETED,163.89
CARD_PAYMENT,Current,2022-07-09 09:28:13,2022-07-10 13:44:57,Pad Port Miraflores,-3.15,0,EUR,COMPLETED,160.74
TRANSFER,Current,2022-07-10 19:50:01,2022-07-10 19:50:01,To EUR Savings,-1,0,EUR,COMPLETED,159.74
TRANSFER,Current,2022-07-11 09:31:47,2022-07-11 09:31:47,To EUR Savings,-20,0,EUR,COMPLETED,139.74
CARD_PAYMENT,Current,2022-07-10 12:45:51,2022-07-11 09:38:14,Amazon,-20.32,0,EUR,COMPLETED,119.42
CARD_PAYMENT,Current,2022-07-10 19:49:59,2022-07-11 09:40:05,Minipreço,-9,0,EUR,COMPLETED,110.42
CARD_PAYMENT,Current,2022-07-10 08:39:59,2022-07-11 11:54:45,Pad Port Miraflores,-3.15,0,EUR,COMPLETED,107.27
TRANSFER,Current,2022-07-12 07:47:11,2022-07-12 07:47:11,To EUR Savings,-0.21,0,EUR,COMPLETED,107.06
TOPUP,Current,2022-07-12 08:36:46,2022-07-12 08:36:48,Apple Pay Top-Up by *6660,200,0,EUR,COMPLETED,307.06
TRANSFER,Current,2022-07-12 09:59:05,2022-07-12 09:59:05,To EUR Savings,-0.05,0,EUR,COMPLETED,307.01
CARD_PAYMENT,Current,2022-07-12 09:59:04,2022-07-13 16:11:22,PayPal,-19.95,0,EUR,COMPLETED,287.06
CARD_PAYMENT,Current,2022-07-12 07:47:11,2022-07-14 03:42:43,Repsol,-75.79,0,EUR,COMPLETED,211.27
TRANSFER,Current,2022-07-15 17:52:53,2022-07-15 17:52:53,To EUR Savings,-0.81,0,EUR,COMPLETED,210.46
TRANSFER,Current,2022-07-16 08:31:03,2022-07-16 08:31:03,To EUR Savings,-0.85,0,EUR,COMPLETED,209.61
CARD_PAYMENT,Current,2022-07-15 17:52:52,2022-07-16 10:28:31,Minipreço,-11.19,0,EUR,COMPLETED,198.42
TRANSFER,Current,2022-07-16 13:00:07,2022-07-16 13:00:07,To EUR Savings,-0.8,0,EUR,COMPLETED,197.62
TRANSFER,Current,2022-07-16 13:05:31,2022-07-16 13:05:31,To EUR Savings,-0.7,0,EUR,COMPLETED,196.92
TRANSFER,Current,2022-07-17 13:06:05,2022-07-17 13:06:05,To EUR Savings,-0.2,0,EUR,COMPLETED,196.72
CARD_PAYMENT,Current,2022-07-16 08:31:03,2022-07-17 13:58:00,Pad Port Miraflores,-3.15,0,EUR,COMPLETED,193.57
CARD_PAYMENT,Current,2022-07-16 13:00:07,2022-07-17 13:59:09,Saisish,-17.2,0,EUR,COMPLETED,176.37
CARD_PAYMENT,Current,2022-07-16 13:05:31,2022-07-17 13:59:09,Mercado de Algés,-3.3,0,EUR,COMPLETED,173.07
TRANSFER,Current,2022-07-17 21:40:57,2022-07-17 21:40:57,To EUR Savings,-0.51,0,EUR,COMPLETED,172.56
TRANSFER,Current,2022-07-18 09:32:27,2022-07-18 09:32:27,To EUR Savings,-20,0,EUR,COMPLETED,152.56
CARD_PAYMENT,Current,2022-07-17 13:06:05,2022-07-18 11:40:55,Receita Pomposa,-25.8,0,EUR,COMPLETED,126.76
TRANSFER,Current,2022-07-19 08:44:48,2022-07-19 08:44:48,To EUR Savings,-0.03,0,EUR,COMPLETED,126.73
CARD_PAYMENT,Current,2022-07-17 21:40:57,2022-07-19 09:13:24,YouTube,-8.49,0,EUR,COMPLETED,118.24
TRANSFER,Current,2022-07-19 12:49:42,2022-07-19 12:49:42,To EUR Savings,-0.61,0,EUR,COMPLETED,117.63
TOPUP,Current,2022-07-19 20:40:12,2022-07-19 20:40:18,Apple Pay Top-Up by *6660,200,0,EUR,COMPLETED,317.63
TRANSFER,Current,2022-07-20 07:37:09,2022-07-20 07:37:09,To EUR Savings,-0.85,0,EUR,COMPLETED,316.78
CARD_PAYMENT,Current,2022-07-19 12:49:41,2022-07-20 15:20:24,Uber Eats,-33.39,0,EUR,COMPLETED,283.39
CARD_PAYMENT,Current,2022-07-19 08:44:47,2022-07-20 15:30:14,Minipreço,-8.97,0,EUR,COMPLETED,274.42
CARD_PAYMENT,Current,2022-07-20 07:37:09,2022-07-21 17:35:59,Pad Port Miraflores,-3.15,0,EUR,COMPLETED,271.27
TRANSFER,Current,2022-07-22 16:25:47,2022-07-22 16:25:47,To EUR Savings,-0.01,0,EUR,COMPLETED,271.26
CARD_PAYMENT,Current,2022-07-22 16:25:47,2022-07-23 11:03:52,Apple,-3.99,0,EUR,COMPLETED,267.27
TRANSFER,Current,2022-07-23 13:03:15,2022-07-23 13:03:15,To EUR Savings,-0.1,0,EUR,COMPLETED,267.17
CARD_PAYMENT,Current,2022-07-23 13:03:15,2022-07-24 12:50:49,Uber Eats,-16.9,0,EUR,COMPLETED,250.27
TRANSFER,Current,2022-07-24 14:42:52,2022-07-24 14:42:52,To EUR Savings,-0.01,0,EUR,COMPLETED,250.26
TRANSFER,Current,2022-07-24 14:43:19,2022-07-24 14:43:19,To EUR Savings,-0.01,0,EUR,COMPLETED,250.25
TRANSFER,Current,2022-07-25 00:07:30,2022-07-25 00:07:30,To EUR Savings,-0.17,0,EUR,COMPLETED,250.08
TRANSFER,Current,2022-07-25 09:36:44,2022-07-25 09:36:44,To EUR Savings,-20,0,EUR,COMPLETED,230.08
CARD_PAYMENT,Current,2022-07-24 14:42:51,2022-07-25 11:18:14,PlayStation,-24.99,0,EUR,COMPLETED,205.09
CARD_PAYMENT,Current,2022-07-24 14:43:18,2022-07-25 11:18:14,PlayStation,-62.99,0,EUR,COMPLETED,142.1
TRANSFER,Current,2022-07-26 08:47:45,2022-07-26 08:47:45,To EUR Savings,-0.6,0,EUR,COMPLETED,141.5
CARD_PAYMENT,Current,2022-07-25 00:07:30,2022-07-26 11:16:32,Antoniobarb,-35.83,0,EUR,COMPLETED,105.67
TRANSFER,Current,2022-07-26 23:14:14,2022-07-26 23:14:14,To EUR Savings,-0.29,0,EUR,COMPLETED,105.38
TRANSFER,Current,2022-07-27 00:33:37,2022-07-27 00:33:37,To EUR Savings,-0.01,0,EUR,COMPLETED,105.37
TRANSFER,Current,2022-07-27 00:36:50,2022-07-27 00:36:50,To EUR Savings,-0.51,0,EUR,COMPLETED,104.86
CARD_PAYMENT,Current,2022-07-26 08:47:45,2022-07-27 10:03:59,Minipreço,-14.4,0,EUR,COMPLETED,90.46
TRANSFER,Current,2022-07-27 12:44:06,2022-07-27 12:44:06,To EUR Savings,-0.83,0,EUR,COMPLETED,89.63
TOPUP,Current,2022-07-27 16:16:45,2022-07-27 16:16:48,Apple Pay Top-Up by *6660,400,0,EUR,COMPLETED,489.63
CARD_PAYMENT,Current,2022-07-27 00:36:50,2022-07-28 10:11:11,Apple,-5.49,0,EUR,COMPLETED,484.14
CARD_PAYMENT,Current,2022-07-26 23:14:13,2022-07-28 10:12:10,PayPal,-38.71,0,EUR,COMPLETED,445.43
CARD_PAYMENT,Current,2022-07-27 12:44:06,2022-07-28 10:32:28,Uber Eats,-33.17,0,EUR,COMPLETED,412.26
CARD_PAYMENT,Current,2022-07-27 00:33:36,2022-07-28 11:01:11,Apple,-1.99,0,EUR,COMPLETED,410.27
TRANSFER,Current,2022-07-28 12:34:40,2022-07-28 12:34:40,To EUR Savings,-0.01,0,EUR,COMPLETED,410.26
TRANSFER,Current,2022-07-28 13:13:54,2022-07-28 13:13:54,To EUR Savings,-0.2,0,EUR,COMPLETED,410.06
TRANSFER,Current,2022-07-28 14:03:46,2022-07-28 14:03:46,To EUR Savings,-0.01,0,EUR,COMPLETED,410.05
CARD_PAYMENT,Current,2022-07-28 12:34:39,2022-07-29 09:54:55,PayPal,-39.99,0,EUR,COMPLETED,370.06
CARD_PAYMENT,Current,2022-07-28 14:03:42,2022-07-29 10:18:13,Google,-2.99,0,EUR,COMPLETED,367.07
CARD_PAYMENT,Current,2022-07-28 13:13:54,2022-07-29 14:36:36,Mercado de Algés,-1.8,0,EUR,COMPLETED,365.27
TOPUP,Current,2022-07-29 21:42:40,2022-07-29 21:42:42,Apple Pay Top-Up by *6660,500,0,EUR,COMPLETED,865.27
TRANSFER,Current,2022-07-29 22:15:04,2022-07-29 22:15:04,To EUR Savings,-0.8,0,EUR,COMPLETED,864.47
TRANSFER,Current,2022-07-30 07:50:27,2022-07-30 07:50:27,To EUR Savings,-0.85,0,EUR,COMPLETED,863.62
TRANSFER,Current,2022-07-30 08:58:00,2022-07-30 08:58:00,To EUR Savings,-0.67,0,EUR,COMPLETED,862.95
TRANSFER,Current,2022-07-30 10:28:30,2022-07-30 10:28:30,To EUR Savings,-0.75,0,EUR,COMPLETED,862.2
TRANSFER,Current,2022-07-30 10:46:59,2022-07-30 10:46:59,To EUR Savings,-0.92,0,EUR,COMPLETED,861.28
TRANSFER,Current,2022-07-30 11:10:47,2022-07-30 11:10:47,To EUR Savings,-0.51,0,EUR,COMPLETED,860.77
CARD_PAYMENT,Current,2022-07-30 20:27:01,,Too Good To Go,-2.99,0,EUR,REVERTED,
TRANSFER,Current,2022-07-30 20:27:01,2022-07-30 20:27:01,To EUR Savings,-0.01,0,EUR,COMPLETED,860.76
TRANSFER,Current,2022-07-31 07:17:14,2022-07-31 07:17:14,To EUR Savings,-0.85,0,EUR,COMPLETED,859.91
TRANSFER,Current,2022-07-31 09:08:10,2022-07-31 09:08:10,To EUR Savings,-0.82,0,EUR,COMPLETED,859.09
TRANSFER,Current,2022-07-31 10:23:16,2022-07-31 10:23:16,To EUR Savings,-0.37,0,EUR,COMPLETED,858.72
CARD_PAYMENT,Current,2022-07-29 22:15:04,2022-07-31 10:28:19,TAP Air Portugal,-176.2,0,EUR,COMPLETED,682.52
CARD_PAYMENT,Current,2022-07-30 07:50:26,2022-07-31 17:10:12,Pad Port Miraflores,-3.15,0,EUR,COMPLETED,679.37
CARD_PAYMENT,Current,2022-07-30 08:57:59,2022-07-31 17:10:22,Pingo Doce,-23.33,0,EUR,COMPLETED,656.04
CARD_PAYMENT,Current,2022-07-30 10:28:30,2022-07-31 17:10:32,Gleba,-2.25,0,EUR,COMPLETED,653.79
CARD_PAYMENT,Current,2022-07-30 10:46:41,2022-07-31 17:10:42,Cortefiel,-30.08,0,EUR,COMPLETED,623.71
CARD_PAYMENT,Current,2022-07-30 11:09:45,2022-07-31 17:10:52,Auchan,-5.49,0,EUR,COMPLETED,618.22
TRANSFER,Current,2022-08-01 09:21:32,2022-08-01 09:21:32,To EUR Savings,-0.28,0,EUR,COMPLETED,617.94
TRANSFER,Current,2022-08-01 10:10:01,2022-08-01 10:10:01,To EUR Savings,-20,0,EUR,COMPLETED,597.94
CARD_PAYMENT,Current,2022-07-31 10:23:16,2022-08-01 11:29:08,Minipreço,-13.63,0,EUR,COMPLETED,584.31
TRANSFER,Current,2022-08-01 11:33:49,2022-08-01 11:33:49,To EUR Bills,-100,0,EUR,COMPLETED,484.31
TRANSFER,Current,2022-08-01 12:49:17,2022-08-01 12:49:17,To EUR Savings,-0.94,0,EUR,COMPLETED,483.37
CARD_PAYMENT,Current,2022-07-31 09:08:09,2022-08-01 15:11:47,Leroy Merlin,-10.18,0,EUR,COMPLETED,473.19
CARD_PAYMENT,Current,2022-07-31 07:17:13,2022-08-01 15:11:47,Pad Port Miraflores,-3.15,0,EUR,COMPLETED,470.04
TRANSFER,Current,2022-08-02 03:13:34,2022-08-02 03:13:34,To EUR Savings,-0.01,0,EUR,COMPLETED,470.03
CARD_PAYMENT,Current,2022-08-01 12:49:17,2022-08-02 10:28:45,Uber Eats,-25.06,0,EUR,COMPLETED,444.97
CARD_PAYMENT,Current,2022-08-01 09:21:32,2022-08-02 12:38:54,Minipreço,-2.72,0,EUR,COMPLETED,442.25
TRANSFER,Current,2022-08-03 08:47:31,2022-08-03 08:47:31,To EUR Savings,-0.04,0,EUR,COMPLETED,442.21
TRANSFER,Current,2022-08-03 09:14:19,2022-08-03 09:14:19,To EUR Savings,-0.05,0,EUR,COMPLETED,442.16
CARD_PAYMENT,Current,2022-08-02 03:13:34,2022-08-03 09:58:43,Apple,-4.99,0,EUR,COMPLETED,437.17
CARD_PAYMENT,Current,2022-08-03 09:14:18,2022-08-04 09:19:56,Fruugo,-15.95,0,EUR,COMPLETED,421.22
CARD_PAYMENT,Current,2022-08-03 08:47:31,2022-08-04 11:16:27,Minipreço,-13.96,0,EUR,COMPLETED,407.26
TRANSFER,Current,2022-08-05 12:54:41,2022-08-05 12:54:41,To EUR Savings,-0.66,0,EUR,COMPLETED,406.6
TRANSFER,Current,2022-08-05 14:15:57,2022-08-05 14:15:57,To EUR Savings,-0.21,0,EUR,COMPLETED,406.39
TRANSFER,Current,2022-08-06 07:32:39,2022-08-06 07:32:39,To EUR Savings,-0.85,0,EUR,COMPLETED,405.54
CARD_PAYMENT,Current,2022-08-05 12:54:36,2022-08-06 11:07:36,Uber Eats,-12.34,0,EUR,COMPLETED,393.2
CARD_PAYMENT,Current,2022-08-05 14:15:51,2022-08-06 11:18:08,Uber Eats,-2.79,0,EUR,COMPLETED,390.41
TRANSFER,Current,2022-08-07 07:22:26,2022-08-07 07:22:26,To EUR Savings,-0.85,0,EUR,COMPLETED,389.56
TRANSFER,Current,2022-08-07 08:24:17,2022-08-07 08:24:17,To EUR Savings,-0.22,0,EUR,COMPLETED,389.34
TRANSFER,Current,2022-08-07 13:51:33,2022-08-07 13:51:33,To EUR Savings,-0.2,0,EUR,COMPLETED,389.14
TRANSFER,Current,2022-08-07 14:02:36,2022-08-07 14:02:36,To EUR Savings,-1,0,EUR,COMPLETED,388.14
TRANSFER,Current,2022-08-08 08:53:45,2022-08-08 08:53:45,To EUR Savings,-0.01,0,EUR,COMPLETED,388.13
TRANSFER,Current,2022-08-08 08:59:48,2022-08-08 08:59:48,To EUR Savings,-0.15,0,EUR,COMPLETED,387.98
CARD_PAYMENT,Current,2022-08-06 07:32:39,2022-08-08 09:33:35,Pad Port Miraflores,-3.15,0,EUR,COMPLETED,384.83
TRANSFER,Current,2022-08-08 09:41:55,2022-08-08 09:41:55,To EUR Savings,-20,0,EUR,COMPLETED,364.83
CARD_PAYMENT,Current,2022-08-07 08:24:16,2022-08-08 15:35:38,Leroy Merlin,-13.78,0,EUR,COMPLETED,351.05
CARD_PAYMENT,Current,2022-08-07 07:22:26,2022-08-08 15:35:38,Pad Port Miraflores,-3.15,0,EUR,COMPLETED,347.9
CARD_PAYMENT,Current,2022-08-07 14:02:35,2022-08-08 15:36:40,Municipio De Oeiras,-5,0,EUR,COMPLETED,342.9
CARD_PAYMENT,Current,2022-08-07 13:51:32,2022-08-08 15:36:40,Soya Bar,-29.8,0,EUR,COMPLETED,313.1
TRANSFER,Current,2022-08-09 09:02:11,2022-08-09 09:02:11,To EUR Savings,-0.55,0,EUR,COMPLETED,312.55
CARD_PAYMENT,Current,2022-08-08 08:53:45,2022-08-09 10:21:46,Apple,-0.99,0,EUR,COMPLETED,311.56
TRANSFER,Current,2022-08-09 11:55:50,2022-08-09 11:55:50,To EUR Savings,-0.01,0,EUR,COMPLETED,311.55
CARD_PAYMENT,Current,2022-08-08 08:59:48,2022-08-09 12:01:59,Minipreço,-14.85,0,EUR,COMPLETED,296.7
TRANSFER,Current,2022-08-09 12:43:17,2022-08-09 12:43:17,To EUR Savings,-0.83,0,EUR,COMPLETED,295.87
TRANSFER,Current,2022-08-10 07:49:06,2022-08-10 07:49:06,To EUR Savings,-0.25,0,EUR,COMPLETED,295.62
TRANSFER,Current,2022-08-10 09:56:21,2022-08-10 09:56:21,To EUR Savings,-0.85,0,EUR,COMPLETED,294.77
CARD_PAYMENT,Current,2022-08-09 11:55:49,2022-08-10 10:26:38,Apple,-1.99,0,EUR,COMPLETED,292.78
CARD_PAYMENT,Current,2022-08-09 12:43:16,2022-08-10 10:36:50,Uber Eats,-33.17,0,EUR,COMPLETED,259.61
CARD_PAYMENT,Current,2022-08-09 09:02:11,2022-08-10 11:55:23,Cantinho Docepastela,-1.45,0,EUR,COMPLETED,258.16
TRANSFER,Current,2022-08-11 09:06:48,2022-08-11 09:06:48,To EUR Savings,-0.11,0,EUR,COMPLETED,258.05
TRANSFER,Current,2022-08-11 11:04:31,2022-08-11 11:04:31,To EUR Savings,-0.01,0,EUR,COMPLETED,258.04
CARD_PAYMENT,Current,2022-08-10 07:49:06,2022-08-12 00:32:28,Pad Port Miraflores,-3.75,0,EUR,COMPLETED,254.29
CARD_PAYMENT,Current,2022-08-10 09:56:18,2022-08-12 00:32:38,Pad Port Miraflores,-1.15,0,EUR,COMPLETED,253.14
CARD_PAYMENT,Current,2022-08-11 11:04:30,2022-08-12 10:39:20,Apple,-14.99,0,EUR,COMPLETED,238.15
CARD_PAYMENT,Current,2022-08-11 09:06:47,2022-08-12 11:20:16,Minipreço,-6.89,0,EUR,COMPLETED,231.26
TRANSFER,Current,2022-08-12 20:32:22,2022-08-12 20:32:22,To EUR Savings,-0.5,0,EUR,COMPLETED,230.76
TRANSFER,Current,2022-08-13 13:20:03,2022-08-13 13:20:03,To EUR Savings,-0.3,0,EUR,COMPLETED,230.46
TRANSFER,Current,2022-08-13 13:37:10,2022-08-13 13:37:10,To EUR Savings,-0.97,0,EUR,COMPLETED,229.49
TRANSFER,Current,2022-08-13 21:29:33,2022-08-13 21:29:33,To EUR Savings,-0.7,0,EUR,COMPLETED,228.79
CARD_PAYMENT,Current,2022-08-12 20:32:22,2022-08-14 12:00:19,Isabel Bandeira,-9.5,0,EUR,COMPLETED,219.29
CARD_PAYMENT,Current,2022-08-13 13:37:10,2022-08-14 12:00:39,Minipreço,-16.03,0,EUR,COMPLETED,203.26
CARD_PAYMENT,Current,2022-08-13 13:20:03,2022-08-14 12:00:39,Alvaros,-24.7,0,EUR,COMPLETED,178.56
TOPUP,Current,2022-08-14 12:23:16,2022-08-14 12:23:18,Apple Pay Top-Up by *6660,200,0,EUR,COMPLETED,378.56
TRANSFER,Current,2022-08-14 13:13:24,2022-08-14 13:13:24,To EUR Savings,-0.7,0,EUR,COMPLETED,377.86
TRANSFER,Current,2022-08-15 09:48:17,2022-08-15 09:48:17,To EUR Savings,-20,0,EUR,COMPLETED,357.86
CARD_PAYMENT,Current,2022-08-14 13:13:24,2022-08-15 11:29:31,Isabel Bandeira,-22.3,0,EUR,COMPLETED,335.56
CARD_PAYMENT,Current,2022-08-13 21:29:33,2022-08-15 11:29:56,Cafe O Silverio,-17.3,0,EUR,COMPLETED,318.26
TRANSFER,Current,2022-08-15 13:03:43,2022-08-15 13:03:43,To EUR Savings,-0.4,0,EUR,COMPLETED,317.86
CARD_PAYMENT,Current,2022-08-15 13:03:42,2022-08-16 11:40:32,Cafe Rest Beira Rio,-20.6,0,EUR,COMPLETED,297.26
TRANSFER,Current,2022-08-16 18:01:56,2022-08-16 18:01:56,To EUR Savings,-0.7,0,EUR,COMPLETED,296.56
CARD_PAYMENT,Current,2022-08-16 18:01:42,2022-08-17 11:40:27,Confeitaria Lailai,-4.3,0,EUR,COMPLETED,292.26
TRANSFER,Current,2022-08-17 17:44:43,2022-08-17 17:44:43,To EUR Savings,-0.35,0,EUR,COMPLETED,291.91
TRANSFER,Current,2022-08-17 21:40:58,2022-08-17 21:40:58,To EUR Savings,-0.51,0,EUR,COMPLETED,291.4
TRANSFER,Current,2022-08-18 13:02:13,2022-08-18 13:02:13,To EUR Savings,-0.44,0,EUR,COMPLETED,290.96
CARD_PAYMENT,Current,2022-08-17 17:44:43,2022-08-18 17:18:55,Repsol,-80.65,0,EUR,COMPLETED,210.31
CARD_PAYMENT,Current,2022-08-17 21:40:57,2022-08-19 10:47:24,YouTube,-8.49,0,EUR,COMPLETED,201.82
CARD_PAYMENT,Current,2022-08-18 13:02:13,2022-08-19 11:55:47,Minipreço,-3.56,0,EUR,COMPLETED,198.26
TRANSFER,Current,2022-08-20 08:27:34,2022-08-20 08:27:34,To EUR Savings,-0.85,0,EUR,COMPLETED,197.41
TOPUP,Current,2022-08-20 09:15:12,2022-08-20 09:15:14,Apple Pay Top-Up by *6660,200,0,EUR,COMPLETED,397.41
TRANSFER,Current,2022-08-21 08:26:53,2022-08-21 08:26:53,To EUR Savings,-0.85,0,EUR,COMPLETED,396.56
TRANSFER,Current,2022-08-21 09:13:45,2022-08-21 09:13:45,To EUR Savings,-0.05,0,EUR,COMPLETED,396.51
TRANSFER,Current,2022-08-21 09:34:05,2022-08-21 09:34:05,To EUR Savings,-0.46,0,EUR,COMPLETED,396.05
TRANSFER,Current,2022-08-21 09:50:13,2022-08-21 09:50:13,To EUR Savings,-0.94,0,EUR,COMPLETED,395.11
TRANSFER,Current,2022-08-21 10:14:18,2022-08-21 10:14:18,To EUR Savings,-0.5,0,EUR,COMPLETED,394.61
TRANSFER,Current,2022-08-21 12:14:00,2022-08-21 12:14:00,To EUR Savings,-0.04,0,EUR,COMPLETED,394.57
CARD_PAYMENT,Current,2022-08-20 08:27:34,2022-08-21 15:02:55,Pad Port Miraflores,-3.15,0,EUR,COMPLETED,391.42
CARD_PAYMENT,Current,2022-08-21 12:14:00,2022-08-22 08:56:52,Minipreço,-4.96,0,EUR,COMPLETED,386.46
TRANSFER,Current,2022-08-22 09:45:49,2022-08-22 09:45:49,To EUR Savings,-20,0,EUR,COMPLETED,366.46
CARD_PAYMENT,Current,2022-08-21 09:13:45,2022-08-22 13:18:58,Norauto Alfragide,-5.95,0,EUR,COMPLETED,360.51
CARD_PAYMENT,Current,2022-08-21 10:14:17,2022-08-22 13:18:58,Gleba,-5.5,0,EUR,COMPLETED,355.01
CARD_PAYMENT,Current,2022-08-21 09:50:12,2022-08-22 13:18:58,Pingo Doce,-12.06,0,EUR,COMPLETED,342.95
CARD_PAYMENT,Current,2022-08-21 09:34:05,2022-08-22 13:18:58,Auchan,-38.54,0,EUR,COMPLETED,304.41
CARD_PAYMENT,Current,2022-08-21 08:26:53,2022-08-22 13:24:31,Pad Port Miraflores,-3.15,0,EUR,COMPLETED,301.26
TRANSFER,Current,2022-08-22 20:30:13,2022-08-22 20:30:13,To EUR Savings,-0.66,0,EUR,COMPLETED,300.6
TRANSFER,Current,2022-08-23 08:53:11,2022-08-23 08:53:11,To EUR Savings,-0.49,0,EUR,COMPLETED,300.11
TRANSFER,Current,2022-08-24 07:41:03,2022-08-24 07:41:03,To EUR Savings,-0.85,0,EUR,COMPLETED,299.26
TRANSFER,Current,2022-08-24 08:21:54,2022-08-24 08:21:54,To EUR Savings,-1,0,EUR,COMPLETED,298.26
CARD_PAYMENT,Current,2022-08-22 20:30:12,2022-08-24 12:43:17,Minipreço,-1.34,0,EUR,COMPLETED,296.92
CARD_PAYMENT,Current,2022-08-23 08:53:11,2022-08-24 12:43:17,Minipreço,-10.51,0,EUR,COMPLETED,286.41
TRANSFER,Current,2022-08-24 12:48:48,2022-08-24 12:48:48,To EUR Savings,-0.33,0,EUR,COMPLETED,286.08
TRANSFER,Current,2022-08-24 18:01:34,2022-08-24 18:01:34,To EUR Savings,-0.76,0,EUR,COMPLETED,285.32
TRANSFER,Current,2022-08-25 09:07:36,2022-08-25 09:07:36,To EUR Savings,-0.93,0,EUR,COMPLETED,284.39
CARD_PAYMENT,Current,2022-08-24 12:48:48,2022-08-25 11:11:38,Uber Eats,-33.67,0,EUR,COMPLETED,250.72
TRANSFER,Current,2022-08-25 12:48:36,2022-08-25 12:48:36,To EUR Savings,-0.51,0,EUR,COMPLETED,250.21
TRANSFER,Current,2022-08-25 18:05:50,2022-08-25 18:05:50,To EUR Savings,-0.01,0,EUR,COMPLETED,250.2
CARD_PAYMENT,Current,2022-08-24 08:20:50,2022-08-25 23:54:04,Norauto Alfragide,-3,0,EUR,COMPLETED,247.2
CARD_PAYMENT,Current,2022-08-24 07:41:03,2022-08-25 23:54:04,Pad Port Miraflores,-3.15,0,EUR,COMPLETED,244.05
CARD_PAYMENT,Current,2022-08-24 18:01:32,2022-08-26 11:09:29,Google,-2.24,0,EUR,COMPLETED,241.81
CARD_PAYMENT,Current,2022-08-25 12:48:36,2022-08-26 11:24:28,Uber Eats,-39.49,0,EUR,COMPLETED,202.32
CARD_PAYMENT,Current,2022-08-25 09:07:36,2022-08-26 11:36:39,Minipreço,-4.07,0,EUR,COMPLETED,198.25
TRANSFER,Current,2022-08-27 00:33:05,2022-08-27 00:33:05,To EUR Savings,-0.01,0,EUR,COMPLETED,198.24
TRANSFER,Current,2022-08-27 00:34:14,2022-08-27 00:34:14,To EUR Savings,-0.51,0,EUR,COMPLETED,197.73
TRANSFER,Current,2022-08-27 08:07:39,2022-08-27 08:07:39,To EUR Savings,-0.85,0,EUR,COMPLETED,196.88
CARD_PAYMENT,Current,2022-08-25 18:05:49,2022-08-27 10:36:20,Apple,-3.99,0,EUR,COMPLETED,192.89
TRANSFER,Current,2022-08-27 13:30:41,2022-08-27 13:30:41,To EUR Savings,-0.8,0,EUR,COMPLETED,192.09
TRANSFER,Current,2022-08-28 07:42:25,2022-08-28 07:42:25,To EUR Savings,-0.85,0,EUR,COMPLETED,191.24
TRANSFER,Current,2022-08-28 09:09:10,2022-08-28 09:09:10,To EUR Savings,-0.36,0,EUR,COMPLETED,190.88
CARD_PAYMENT,Current,2022-08-27 00:33:05,2022-08-28 12:22:45,Apple,-1.99,0,EUR,COMPLETED,188.89
CARD_PAYMENT,Current,2022-08-27 00:34:14,2022-08-28 12:23:06,Apple,-5.49,0,EUR,COMPLETED,183.4
TRANSFER,Current,2022-08-28 12:41:25,2022-08-28 12:41:25,To EUR Savings,-0.25,0,EUR,COMPLETED,183.15
TRANSFER,Current,2022-08-28 14:03:44,2022-08-28 14:03:44,To EUR Savings,-0.01,0,EUR,COMPLETED,183.14
CARD_PAYMENT,Current,2022-08-27 13:30:36,2022-08-28 14:41:25,Soya Bar,-58.2,0,EUR,COMPLETED,124.94
CARD_PAYMENT,Current,2022-08-27 08:07:39,2022-08-28 14:48:35,Pad Port Miraflores,-3.15,0,EUR,COMPLETED,121.79
CARD_PAYMENT,Current,2022-08-28 12:41:25,2022-08-29 09:18:05,Uber Eats,-30.75,0,EUR,COMPLETED,91.04
CARD_PAYMENT,Current,2022-08-28 14:03:43,2022-08-29 09:33:13,Google,-2.99,0,EUR,COMPLETED,88.05
TRANSFER,Current,2022-08-29 09:49:30,2022-08-29 09:49:30,To EUR Savings,-20,0,EUR,COMPLETED,68.05
CARD_PAYMENT,Current,2022-08-28 07:42:25,2022-08-29 13:59:31,Pad Port Miraflores,-3.15,0,EUR,COMPLETED,64.9
CARD_PAYMENT,Current,2022-08-28 09:09:09,2022-08-29 13:59:31,Pingo Doce,-26.64,0,EUR,COMPLETED,38.26
TOPUP,Current,2022-08-29 20:21:22,2022-08-29 20:21:24,Apple Pay Top-Up by *6660,400,0,EUR,COMPLETED,438.26
TRANSFER,Current,2022-08-30 12:46:06,2022-08-30 12:46:06,To EUR Savings,-0.33,0,EUR,COMPLETED,437.93
CARD_PAYMENT,Current,2022-08-30 12:46:05,2022-08-31 10:00:44,Uber Eats,-33.67,0,EUR,COMPLETED,404.26
TRANSFER,Current,2022-08-31 13:06:41,2022-08-31 13:06:41,To EUR Savings,-0.45,0,EUR,COMPLETED,403.81
TRANSFER,Current,2022-09-01 07:53:09,2022-09-01 07:53:09,To EUR Savings,-0.85,0,EUR,COMPLETED,402.96
TRANSFER,Current,2022-09-01 11:17:29,2022-09-01 11:17:29,To EUR Savings,-0.8,0,EUR,COMPLETED,402.16
TRANSFER,Current,2022-09-01 11:27:23,2022-09-01 11:27:23,To EUR Savings,-0.4,0,EUR,COMPLETED,401.76
CARD_PAYMENT,Current,2022-08-31 13:06:41,2022-09-01 11:32:34,Minipreço,-4.55,0,EUR,COMPLETED,397.21
TRANSFER,Current,2022-09-01 11:34:56,2022-09-01 11:34:56,To EUR Bills,-100,0,EUR,COMPLETED,297.21
TOPUP,Current,2022-09-01 11:58:59,2022-09-01 11:59:03,Apple Pay Top-Up by *6660,200,0,EUR,COMPLETED,497.21
TRANSFER,Current,2022-09-02 10:19:49,2022-09-02 10:19:49,To EUR Savings,-0.3,0,EUR,COMPLETED,496.91
TRANSFER,Current,2022-09-02 12:33:43,2022-09-02 12:33:43,To EUR Savings,-0.3,0,EUR,COMPLETED,496.61
TRANSFER,Current,2022-09-02 12:55:01,2022-09-02 12:55:01,To EUR Savings,-0.3,0,EUR,COMPLETED,496.31
CARD_PAYMENT,Current,2022-09-01 07:53:08,2022-09-02 15:10:07,Pad Port Miraflores,-3.15,0,EUR,COMPLETED,493.16
CARD_PAYMENT,Current,2022-09-01 11:27:22,2022-09-02 15:10:38,areas,-9.6,0,EUR,COMPLETED,483.56
CARD_PAYMENT,Current,2022-09-01 11:17:25,2022-09-02 15:10:38,Grupo Versailles,-6.2,0,EUR,COMPLETED,477.36
TRANSFER,Current,2022-09-02 15:22:07,2022-09-02 15:22:07,To EUR Savings,-0.25,0,EUR,COMPLETED,477.11
TRANSFER,Current,2022-09-03 09:42:15,2022-09-03 09:42:15,To EUR Savings,-0.9,0,EUR,COMPLETED,476.21
CARD_PAYMENT,Current,2022-09-02 15:22:06,2022-09-03 13:15:32,Gvz2,-16.75,0,EUR,COMPLETED,459.46
CARD_PAYMENT,Current,2022-09-02 12:33:39,2022-09-03 13:15:32,Parkeerplaats Madurodam,-41.7,0,EUR,COMPLETED,417.76
CARD_PAYMENT,Current,2022-09-02 12:55:00,2022-09-03 13:15:41,Parkeerplaats Madurodam,-15.7,0,EUR,COMPLETED,402.06
CARD_PAYMENT,Current,2022-09-02 10:19:49,2022-09-03 13:15:42,Parkeerplaats Madurodam,-5.7,0,EUR,COMPLETED,396.36
TRANSFER,Current,2022-09-03 15:04:45,2022-09-03 15:04:45,To EUR Savings,-1,0,EUR,COMPLETED,395.36
TRANSFER,Current,2022-09-03 15:09:58,2022-09-03 15:09:58,To EUR Savings,-1,0,EUR,COMPLETED,394.36
TRANSFER,Current,2022-09-03 17:31:01,2022-09-03 17:31:01,To EUR Savings,-0.06,0,EUR,COMPLETED,394.3
TOPUP,Current,2022-09-03 22:00:05,2022-09-03 22:00:08,Apple Pay Top-Up by *6660,200,0,EUR,COMPLETED,594.3
TRANSFER,Current,2022-09-03 22:30:14,2022-09-03 22:30:14,To EUR Savings,-1,0,EUR,COMPLETED,593.3
CARD_PAYMENT,Current,2022-09-03 17:31:00,2022-09-04 12:54:32,Parkeren Utrecht,-2.94,0,EUR,COMPLETED,590.36
CARD_PAYMENT,Current,2022-09-03 09:42:15,2022-09-04 12:54:42,De Veldkeuken,-13.1,0,EUR,COMPLETED,577.26
TRANSFER,Current,2022-09-04 14:07:40,2022-09-04 14:07:40,To EUR Savings,-0.5,0,EUR,COMPLETED,576.76
CARD_PAYMENT,Current,2022-09-03 15:09:58,2022-09-04 15:01:54,Stichting Exploitatie Kas,-27,0,EUR,COMPLETED,549.76
CARD_PAYMENT,Current,2022-09-03 22:30:14,2022-09-04 15:08:20,Heron Petit Restaurant,-350,0,EUR,COMPLETED,199.76
TRANSFER,Current,2022-09-04 19:17:25,2022-09-04 19:17:25,To EUR Savings,-0.05,0,EUR,COMPLETED,199.71
CARD_PAYMENT,Current,2022-09-03 15:04:45,2022-09-04 20:31:03,Pin,-9,0,EUR,COMPLETED,190.71
TRANSFER,Current,2022-09-05 01:14:13,2022-09-05 01:14:13,To EUR Savings,-0.41,0,EUR,COMPLETED,190.3
TRANSFER,Current,2022-09-05 09:55:41,2022-09-05 09:55:41,To EUR Savings,-20,0,EUR,COMPLETED,170.3
CARD_PAYMENT,Current,2022-09-04 19:17:25,2022-09-05 10:41:57,HMSHost International,-24.95,0,EUR,COMPLETED,145.35
TOPUP,Current,2022-09-05 12:19:29,2022-09-05 12:19:37,Apple Pay Top-Up by *6660,300,0,EUR,COMPLETED,445.35
CARD_PAYMENT,Current,2022-09-04 14:07:39,2022-09-05 13:22:47,Taverna,-60.5,0,EUR,COMPLETED,384.85
CARD_PAYMENT,Current,2022-09-05 01:14:13,2022-09-06 11:52:36,FREE NOW,-16.59,0,EUR,COMPLETED,368.26
TRANSFER,Current,2022-09-06 12:46:14,2022-09-06 12:46:14,To EUR Savings,-0.33,0,EUR,COMPLETED,367.93
CARD_PAYMENT,Current,2022-09-06 12:46:09,2022-09-07 09:01:18,Uber Eats,-33.67,0,EUR,COMPLETED,334.26
TRANSFER,Current,2022-09-08 08:32:37,2022-09-08 08:32:37,To EUR Savings,-0.33,0,EUR,COMPLETED,333.93
TRANSFER,Current,2022-09-08 08:53:15,2022-09-08 08:53:15,To EUR Savings,-0.01,0,EUR,COMPLETED,333.92
TRANSFER,Current,2022-09-08 17:10:39,2022-09-08 17:10:39,To EUR Savings,-0.4,0,EUR,COMPLETED,333.52
CARD_PAYMENT,Current,2022-09-08 08:53:14,2022-09-09 09:04:20,Apple,-0.99,0,EUR,COMPLETED,332.53
CARD_PAYMENT,Current,2022-09-08 08:32:36,2022-09-09 10:17:21,Minipreço,-2.67,0,EUR,COMPLETED,329.86
TRANSFER,Current,2022-09-09 12:49:44,2022-09-09 12:49:44,To EUR Savings,-0.51,0,EUR,COMPLETED,329.35
CARD_PAYMENT,Current,2022-09-08 17:10:39,2022-09-10 10:20:05,Uber,-11.6,0,EUR,COMPLETED,317.75
TRANSFER,Current,2022-09-10 19:12:46,2022-09-10 19:12:46,To EUR Savings,-0.55,0,EUR,COMPLETED,317.2
TRANSFER,Current,2022-09-11 12:13:19,2022-09-11 12:13:19,To EUR Savings,-0.1,0,EUR,COMPLETED,317.1
CARD_PAYMENT,Current,2022-09-10 19:12:45,2022-09-11 14:55:41,Continente,-10.45,0,EUR,COMPLETED,306.65
TRANSFER,Current,2022-09-11 16:13:34,2022-09-11 16:13:34,To EUR Savings,-0.92,0,EUR,COMPLETED,305.73
TRANSFER,Current,2022-09-11 20:04:06,2022-09-11 20:04:06,To EUR Savings,-0.75,0,EUR,COMPLETED,304.98
CARD_PAYMENT,Current,2022-09-09 12:49:38,2022-09-12 08:48:08,Uber Eats,-39.49,0,EUR,COMPLETED,265.49
TRANSFER,Current,2022-09-12 09:54:09,2022-09-12 09:54:09,To EUR Savings,-20,0,EUR,COMPLETED,245.49
CARD_PAYMENT,Current,2022-09-11 12:13:14,2022-09-12 10:06:29,Confeitaria Lailai,-5.9,0,EUR,COMPLETED,239.59
CARD_PAYMENT,Current,2022-09-11 16:13:34,2022-09-12 13:59:12,Repsol,-83.08,0,EUR,COMPLETED,156.51
TRANSFER,Current,2022-09-12 16:22:24,2022-09-12 16:22:24,To EUR Savings,-1,0,EUR,COMPLETED,155.51
TRANSFER,Current,2022-09-12 16:36:47,2022-09-12 16:36:47,To EUR Savings,-0.12,0,EUR,COMPLETED,155.39
CARD_PAYMENT,Current,2022-09-11 20:04:06,2022-09-13 09:46:23,Minipreço,-15.25,0,EUR,COMPLETED,140.14
CARD_PAYMENT,Current,2022-09-12 16:22:24,2022-09-13 14:40:21,Parques Tejo,-6,0,EUR,COMPLETED,134.14
CARD_PAYMENT,Current,2022-09-12 16:36:47,2022-09-13 14:40:21,Pingo Doce,-24.88,0,EUR,COMPLETED,109.26
TOPUP,Current,2022-09-13 17:05:12,2022-09-13 17:05:21,Apple Pay Top-Up by *6660,200,0,EUR,COMPLETED,309.26
TRANSFER,Current,2022-09-14 20:11:12,2022-09-14 20:11:12,To EUR Savings,-0.33,0,EUR,COMPLETED,308.93
TRANSFER,Current,2022-09-15 11:19:03,2022-09-15 11:19:03,To EUR Savings,-0.1,0,EUR,COMPLETED,308.83
TRANSFER,Current,2022-09-15 16:37:04,2022-09-15 16:37:04,To EUR Savings,-0.05,0,EUR,COMPLETED,308.78
CARD_PAYMENT,Current,2022-09-15 16:37:04,2022-09-16 10:47:10,Farmacia Santa Rita,-4.95,0,EUR,COMPLETED,303.83
CARD_PAYMENT,Current,2022-09-15 11:19:02,2022-09-16 11:41:26,Vinspy,-8.9,0,EUR,COMPLETED,294.93
CARD_PAYMENT,Current,2022-09-14 20:11:12,2022-09-16 12:00:13,Uber Eats,-33.67,0,EUR,COMPLETED,261.26
TRANSFER,Current,2022-09-16 17:24:28,2022-09-16 17:24:28,To EUR Savings,-0.26,0,EUR,COMPLETED,261
TRANSFER,Current,2022-09-16 17:28:30,2022-09-16 17:28:30,To EUR,84,0,EUR,COMPLETED,345
TRANSFER,Current,2022-09-16 18:30:14,2022-09-16 18:30:14,To EUR Savings,-0.76,0,EUR,COMPLETED,344.24
TRANSFER,Current,2022-09-16 19:58:57,2022-09-16 19:58:57,To EUR Savings,-0.4,0,EUR,COMPLETED,343.84
CARD_PAYMENT,Current,2022-09-16 18:30:09,2022-09-17 12:57:05,Auchan,-141.24,0,EUR,COMPLETED,202.6
CARD_PAYMENT,Current,2022-09-16 19:58:57,2022-09-17 12:57:55,Padaria Lisboa,-3.6,0,EUR,COMPLETED,199
CARD_PAYMENT,Current,2022-09-16 17:23:58,2022-09-17 16:33:25,Gleba,-9.74,0,EUR,COMPLETED,189.26
TRANSFER,Current,2022-09-17 21:40:58,2022-09-17 21:40:58,To EUR Savings,-0.51,0,EUR,COMPLETED,188.75
TRANSFER,Current,2022-09-18 09:06:28,2022-09-18 09:06:28,To EUR Savings,-0.65,0,EUR,COMPLETED,188.1
TRANSFER,Current,2022-09-18 12:39:49,2022-09-18 12:39:49,To EUR Savings,-0.01,0,EUR,COMPLETED,188.09
TRANSFER,Current,2022-09-18 12:54:27,2022-09-18 12:54:27,To EUR Savings,-0.51,0,EUR,COMPLETED,187.58
TOPUP,Current,2022-09-19 08:24:21,2022-09-19 08:24:27,Apple Pay Top-Up by *6660,200,0,EUR,COMPLETED,387.58
CARD_PAYMENT,Current,2022-09-17 21:40:58,2022-09-19 09:40:42,YouTube,-8.49,0,EUR,COMPLETED,379.09
TRANSFER,Current,2022-09-19 09:55:00,2022-09-19 09:55:00,To EUR Savings,-20,0,EUR,COMPLETED,359.09
CARD_PAYMENT,Current,2022-09-18 12:54:26,2022-09-19 10:19:03,Minipreço,-7.49,0,EUR,COMPLETED,351.6
CARD_PAYMENT,Current,2022-09-18 12:39:49,2022-09-19 10:30:52,Apple,-0.99,0,EUR,COMPLETED,350.61
CARD_PAYMENT,Current,2022-09-18 09:06:28,2022-09-19 13:56:39,Pad Port Miraflores,-3.35,0,EUR,COMPLETED,347.26
TRANSFER,Current,2022-09-22 12:42:54,2022-09-22 12:42:54,To EUR Savings,-0.22,0,EUR,COMPLETED,347.04
TRANSFER,Current,2022-09-22 23:02:33,2022-09-22 23:02:33,To EUR Savings,-0.54,0,EUR,COMPLETED,346.5
TRANSFER,Current,2022-09-23 08:24:43,2022-09-23 08:24:43,To EUR Savings,-0.35,0,EUR,COMPLETED,346.15
CARD_PAYMENT,Current,2022-09-22 12:42:52,2022-09-23 10:00:49,Uber Eats,-22.78,0,EUR,COMPLETED,323.37
TRANSFER,Current,2022-09-24 07:51:39,2022-09-24 07:51:39,To EUR Savings,-0.65,0,EUR,COMPLETED,322.72
TRANSFER,Current,2022-09-24 10:42:51,2022-09-24 10:42:51,To EUR Savings,-0.02,0,EUR,COMPLETED,322.7
CARD_PAYMENT,Current,2022-09-22 23:02:32,2022-09-24 10:44:07,Apple,-2.46,0,EUR,COMPLETED,320.24
CARD_PAYMENT,Current,2022-09-23 08:24:42,2022-09-24 11:06:00,Cantinho Docepastela,-0.65,0,EUR,COMPLETED,319.59
TRANSFER,Current,2022-09-24 12:27:52,2022-09-24 12:27:52,To EUR Savings,-0.17,0,EUR,COMPLETED,319.42
TRANSFER,Current,2022-09-24 13:06:01,2022-09-24 13:06:01,To EUR Savings,-0.1,0,EUR,COMPLETED,319.32
TRANSFER,Current,2022-09-24 13:06:50,2022-09-24 13:06:50,To EUR Savings,-0.8,0,EUR,COMPLETED,318.52
TRANSFER,Current,2022-09-24 14:00:32,2022-09-24 14:00:32,To EUR Savings,-1,0,EUR,COMPLETED,317.52
TRANSFER,Current,2022-09-24 14:11:34,2022-09-24 14:11:34,To EUR Savings,-1,0,EUR,COMPLETED,316.52
TRANSFER,Current,2022-09-25 08:22:02,2022-09-25 08:22:02,To EUR Savings,-0.65,0,EUR,COMPLETED,315.87
TRANSFER,Current,2022-09-25 09:17:45,2022-09-25 09:17:45,To EUR Savings,-0.34,0,EUR,COMPLETED,315.53
CARD_PAYMENT,Current,2022-09-24 12:27:52,2022-09-25 09:28:35,Antoniobarb,-40.83,0,EUR,COMPLETED,274.7
CARD_PAYMENT,Current,2022-09-24 07:51:39,2022-09-25 14:10:33,Pad Port Miraflores,-3.35,0,EUR,COMPLETED,271.35
CARD_PAYMENT,Current,2022-09-24 10:42:50,2022-09-25 14:10:54,Leroy Merlin,-15.98,0,EUR,COMPLETED,255.37
CARD_PAYMENT,Current,2022-09-24 13:06:50,2022-09-25 14:11:48,Receita Pomposa,-2.2,0,EUR,COMPLETED,253.17
CARD_PAYMENT,Current,2022-09-24 13:06:01,2022-09-25 14:11:48,Receita Pomposa,-28.9,0,EUR,COMPLETED,224.27
CARD_PAYMENT,Current,2022-09-24 14:00:31,2022-09-25 14:12:08,Mercado de Algés,-4,0,EUR,COMPLETED,220.27
CARD_PAYMENT,Current,2022-09-24 14:11:34,2022-09-25 14:12:18,Mercado de Algés,-33,0,EUR,COMPLETED,187.27
TRANSFER,Current,2022-09-25 16:01:49,2022-09-25 16:01:49,To EUR Savings,-1,0,EUR,COMPLETED,186.27
TRANSFER,Current,2022-09-26 10:00:25,2022-09-26 10:00:25,To EUR Savings,-20,0,EUR,COMPLETED,166.27
CARD_PAYMENT,Current,2022-09-25 08:22:02,2022-09-26 13:34:25,Pad Port Miraflores,-3.35,0,EUR,COMPLETED,162.92
CARD_PAYMENT,Current,2022-09-25 09:17:45,2022-09-26 13:34:34,Leroy Merlin,-27.66,0,EUR,COMPLETED,135.26
TOPUP,Current,2022-09-26 21:16:33,2022-09-26 21:16:36,Apple Pay Top-Up by *6660,300,0,EUR,COMPLETED,435.26
CARD_PAYMENT,Current,2022-09-25 16:01:48,2022-09-26 22:46:50,A Casa Do Bacalhau,-105,0,EUR,COMPLETED,330.26
TRANSFER,Current,2022-09-27 00:32:20,2022-09-27 00:32:20,To EUR Savings,-0.01,0,EUR,COMPLETED,330.25
TRANSFER,Current,2022-09-27 00:33:41,2022-09-27 00:33:41,To EUR Savings,-0.51,0,EUR,COMPLETED,329.74
TRANSFER,Current,2022-09-27 18:23:04,2022-09-27 18:23:04,To EUR Savings,-0.01,0,EUR,COMPLETED,329.73
CARD_PAYMENT,Current,2022-09-27 00:32:20,2022-09-28 10:37:30,Apple,-1.99,0,EUR,COMPLETED,327.74
CARD_PAYMENT,Current,2022-09-27 00:33:41,2022-09-28 10:38:22,Apple,-5.49,0,EUR,COMPLETED,322.25
TRANSFER,Current,2022-09-28 14:03:46,2022-09-28 14:03:46,To EUR Savings,-0.01,0,EUR,COMPLETED,322.24
CARD_PAYMENT,Current,2022-09-27 18:23:04,2022-09-29 10:02:36,Google,-1.99,0,EUR,COMPLETED,320.25
CARD_PAYMENT,Current,2022-09-28 14:03:46,2022-09-29 10:51:01,Google,-2.99,0,EUR,COMPLETED,317.26
TRANSFER,Current,2022-09-29 12:51:08,2022-09-29 12:51:08,To EUR Savings,-0.33,0,EUR,COMPLETED,316.93
TRANSFER,Current,2022-09-29 19:09:05,2022-09-29 19:09:05,To EUR Savings,-0.12,0,EUR,COMPLETED,316.81
CARD_PAYMENT,Current,2022-09-29 12:51:08,2022-09-30 10:38:08,Uber Eats,-33.67,0,EUR,COMPLETED,283.14
CARD_PAYMENT,Current,2022-09-29 19:09:05,2022-09-30 11:22:08,Minipreço,-7.88,0,EUR,COMPLETED,275.26
TRANSFER,Current,2022-09-30 21:09:56,2022-09-30 21:09:56,To EUR Savings,-0.75,0,EUR,COMPLETED,274.51
TRANSFER,Current,2022-09-30 22:04:05,2022-09-30 22:04:05,To EUR Savings,-1,0,EUR,COMPLETED,273.51
TRANSFER,Current,2022-10-01 07:56:56,2022-10-01 07:56:56,To EUR Savings,-0.65,0,EUR,COMPLETED,272.86
TRANSFER,Current,2022-10-01 11:34:19,2022-10-01 11:34:19,To EUR Bills,-100,0,EUR,COMPLETED,172.86
TRANSFER,Current,2022-10-01 12:53:20,2022-10-01 12:53:20,To EUR Savings,-1,0,EUR,COMPLETED,171.86
TRANSFER,Current,2022-10-01 13:05:42,2022-10-01 13:05:42,To EUR Savings,-1,0,EUR,COMPLETED,170.86
TRANSFER,Current,2022-10-01 13:10:48,2022-10-01 13:10:48,To EUR Savings,-1,0,EUR,COMPLETED,169.86
TRANSFER,Current,2022-10-01 20:01:01,2022-10-01 20:01:01,To EUR Savings,-0.11,0,EUR,COMPLETED,169.75
CARD_PAYMENT,Current,2022-09-30 22:04:05,2022-10-01 20:45:25,Degrazie,-34,0,EUR,COMPLETED,135.75
TOPUP,Current,2022-10-01 21:19:41,2022-10-01 21:19:45,Apple Pay Top-Up by *6660,300,0,EUR,COMPLETED,435.75
TRANSFER,Current,2022-10-02 03:16:48,2022-10-02 03:16:48,To EUR Savings,-0.01,0,EUR,COMPLETED,435.74
TRANSFER,Current,2022-10-02 08:34:21,2022-10-02 08:34:21,To EUR Savings,-0.65,0,EUR,COMPLETED,435.09
TRANSFER,Current,2022-10-02 09:22:16,2022-10-02 09:22:16,To EUR Savings,-0.05,0,EUR,COMPLETED,435.04
CARD_PAYMENT,Current,2022-09-30 01:00:00,2022-10-02 09:51:12,Uber,-1,0,EUR,COMPLETED,434.04
TRANSFER,Current,2022-10-02 09:51:12,2022-10-02 09:51:12,To EUR Savings,-1,0,EUR,COMPLETED,433.04
CARD_PAYMENT,Current,2022-09-30 21:09:55,2022-10-02 09:58:01,Uber,-3.25,0,EUR,COMPLETED,429.79
TRANSFER,Current,2022-10-02 11:38:53,2022-10-02 11:38:53,To EUR Savings,-0.01,0,EUR,COMPLETED,429.78
CARD_PAYMENT,Current,2022-10-01 13:10:48,2022-10-02 12:19:56,Saisish,-4,0,EUR,COMPLETED,425.78
CARD_PAYMENT,Current,2022-10-01 07:56:56,2022-10-02 16:55:26,Pad Port Miraflores,-3.35,0,EUR,COMPLETED,422.43
CARD_PAYMENT,Current,2022-10-01 12:53:19,2022-10-02 16:56:36,Saisish,-23,0,EUR,COMPLETED,399.43
CARD_PAYMENT,Current,2022-10-01 13:05:42,2022-10-02 16:57:18,Mercado de Algés,-4,0,EUR,COMPLETED,395.43
TRANSFER,Current,2022-10-02 17:43:39,2022-10-02 17:43:39,To EUR Savings,-0.64,0,EUR,COMPLETED,394.79
CARD_PAYMENT,Current,2022-10-01 20:01:01,2022-10-03 09:26:13,Uber Eats,-28.89,0,EUR,COMPLETED,365.9
CARD_PAYMENT,Current,2022-10-02 03:16:47,2022-10-03 09:26:32,Apple,-4.99,0,EUR,COMPLETED,360.91
CARD_PAYMENT,Current,2022-10-02 11:38:53,2022-10-03 09:43:24,Privadonetw,-7.99,0,EUR,COMPLETED,352.92
TRANSFER,Current,2022-10-03 10:03:55,2022-10-03 10:03:55,To EUR Savings,-20,0,EUR,COMPLETED,332.92
CARD_PAYMENT,Current,2022-10-02 17:43:39,2022-10-03 10:25:07,Minipreço,-3.36,0,EUR,COMPLETED,329.56
TRANSFER,Current,2022-10-03 10:37:36,2022-10-03 10:37:36,To EUR Savings,-0.55,0,EUR,COMPLETED,329.01
CARD_PAYMENT,Current,2022-10-02 09:22:16,2022-10-03 12:36:59,Pingo Doce,-21.95,0,EUR,COMPLETED,307.06
CARD_PAYMENT,Current,2022-10-02 08:34:21,2022-10-03 12:36:59,Pad Port Miraflores,-3.35,0,EUR,COMPLETED,303.71
TRANSFER,Current,2022-10-04 07:49:43,2022-10-04 07:49:43,To EUR Savings,-0.3,0,EUR,COMPLETED,303.41
TRANSFER,Current,2022-10-04 10:19:06,2022-10-04 10:19:06,To EUR Savings,-0.6,0,EUR,COMPLETED,302.81
CARD_PAYMENT,Current,2022-10-03 10:37:36,2022-10-04 12:17:47,Cantinho Docepastela,-1.45,0,EUR,COMPLETED,301.36
TRANSFER,Current,2022-10-04 13:09:20,2022-10-04 13:09:20,To EUR Savings,-0.1,0,EUR,COMPLETED,301.26
TRANSFER,Current,2022-10-04 16:42:45,2022-10-04 16:42:45,To EUR Savings,-0.5,0,EUR,COMPLETED,300.76
TRANSFER,Current,2022-10-04 17:36:41,2022-10-04 17:36:41,To EUR Savings,-0.39,0,EUR,COMPLETED,300.37
TRANSFER,Current,2022-10-05 08:23:00,2022-10-05 08:23:00,To EUR Savings,-0.65,0,EUR,COMPLETED,299.72
CARD_PAYMENT,Current,2022-10-04 07:49:42,2022-10-05 14:12:16,Pad Port Marques Pom,-2.7,0,EUR,COMPLETED,297.02
CARD_PAYMENT,Current,2022-10-04 10:19:06,2022-10-05 14:12:35,Fruly,-2.4,0,EUR,COMPLETED,294.62
CARD_PAYMENT,Current,2022-10-04 13:09:19,2022-10-05 14:13:21,Fruly,-4.9,0,EUR,COMPLETED,289.72
CARD_PAYMENT,Current,2022-10-04 16:42:45,2022-10-05 14:14:17,Fruly,-1.5,0,EUR,COMPLETED,288.22
TRANSFER,Current,2022-10-05 14:59:12,2022-10-05 14:59:12,To EUR Savings,-0.01,0,EUR,COMPLETED,288.21
TRANSFER,Current,2022-10-05 20:01:26,2022-10-05 20:01:26,To EUR Savings,-0.02,0,EUR,COMPLETED,288.19
TRANSFER,Current,2022-10-06 07:05:46,2022-10-06 07:05:46,To EUR Savings,-0.53,0,EUR,COMPLETED,287.66
TRANSFER,Current,2022-10-06 07:24:12,2022-10-06 07:24:12,To EUR Savings,-0.65,0,EUR,COMPLETED,287.01
TRANSFER,Current,2022-10-06 08:34:43,2022-10-06 08:34:43,To EUR Savings,-0.35,0,EUR,COMPLETED,286.66
CARD_PAYMENT,Current,2022-10-04 17:36:41,2022-10-06 10:49:26,Uber,-16.61,0,EUR,COMPLETED,270.05
TRANSFER,Current,2022-10-06 13:11:02,2022-10-06 13:11:02,To EUR Savings,-0.4,0,EUR,COMPLETED,269.65
TRANSFER,Current,2022-10-06 13:15:15,2022-10-06 13:15:15,To EUR Savings,-0.6,0,EUR,COMPLETED,269.05
CARD_PAYMENT,Current,2022-10-05 08:23:00,2022-10-06 15:16:46,Pad Port Miraflores,-3.35,0,EUR,COMPLETED,265.7
CARD_PAYMENT,Current,2022-10-05 14:59:12,2022-10-06 15:18:10,Leroy Merlin,-2.99,0,EUR,COMPLETED,262.71
TRANSFER,Current,2022-10-06 22:23:59,2022-10-06 22:23:59,To EUR Savings,-0.71,0,EUR,COMPLETED,262
CARD_PAYMENT,Current,2022-10-05 20:01:26,2022-10-07 11:07:30,Minipreço,-13.98,0,EUR,COMPLETED,248.02
CARD_PAYMENT,Current,2022-10-06 07:05:46,2022-10-07 11:58:28,FREE NOW,-4.48,0,EUR,COMPLETED,243.54
CARD_PAYMENT,Current,2022-10-06 22:23:59,2022-10-07 12:06:55,FREE NOW,-5.29,0,EUR,COMPLETED,238.25
CARD_PAYMENT,Current,2022-10-06 07:24:12,2022-10-07 13:31:29,Pad Port Marques Pom,-3.35,0,EUR,COMPLETED,234.9
CARD_PAYMENT,Current,2022-10-06 08:34:42,2022-10-07 13:31:29,Fruly,-2.65,0,EUR,COMPLETED,232.25
CARD_PAYMENT,Current,2022-10-06 13:15:08,2022-10-07 13:32:25,Fruly,-4.4,0,EUR,COMPLETED,227.85
CARD_PAYMENT,Current,2022-10-06 13:11:01,2022-10-07 13:32:25,O Cacho Dourado,-31.6,0,EUR,COMPLETED,196.25
TRANSFER,Current,2022-10-08 08:19:59,2022-10-08 08:19:59,To EUR Savings,-0.65,0,EUR,COMPLETED,195.6
TRANSFER,Current,2022-10-08 15:11:46,2022-10-08 15:11:46,To EUR,85.78,0,EUR,COMPLETED,281.38
TRANSFER,Current,2022-10-09 08:00:45,2022-10-09 08:00:45,To EUR Savings,-0.65,0,EUR,COMPLETED,280.73
TRANSFER,Current,2022-10-09 11:41:12,2022-10-09 11:41:12,To EUR Savings,-0.75,0,EUR,COMPLETED,279.98
TRANSFER,Current,2022-10-09 12:20:34,2022-10-09 12:20:34,To EUR Savings,-0.6,0,EUR,COMPLETED,279.38
TRANSFER,Current,2022-10-09 12:40:36,2022-10-09 12:40:36,To EUR Savings,-0.2,0,EUR,COMPLETED,279.18
TRANSFER,Current,2022-10-09 12:53:40,2022-10-09 12:53:40,To EUR Savings,-1,0,EUR,COMPLETED,278.18
TRANSFER,Current,2022-10-10 08:32:07,2022-10-10 08:32:07,To EUR Savings,-0.24,0,EUR,COMPLETED,277.94
TRANSFER,Current,2022-10-10 20:45:47,2022-10-10 20:45:47,To EUR Savings,-20,0,EUR,COMPLETED,257.94
CARD_PAYMENT,Current,2022-10-08 08:19:59,2022-10-11 03:35:49,Pad Port Miraflores,-3.35,0,EUR,COMPLETED,254.59
CARD_PAYMENT,Current,2022-10-09 11:41:11,2022-10-11 06:13:30,Frn* Hold.free-Now.com,-1.95,0,EUR,COMPLETED,252.64
CARD_PAYMENT,Current,2022-10-09 08:00:44,2022-10-11 10:54:53,Pad Port Miraflores,-3.35,0,EUR,COMPLETED,249.29
CARD_PAYMENT,Current,2022-10-09 12:20:33,2022-10-11 10:56:10,Puro Italiano,-22.4,0,EUR,COMPLETED,226.89
CARD_PAYMENT,Current,2022-10-09 12:40:36,2022-10-11 10:56:19,Mercado de Algés,-4.8,0,EUR,COMPLETED,222.09
CARD_PAYMENT,Current,2022-10-09 12:53:40,2022-10-11 10:56:28,Mercado de Algés,-2,0,EUR,COMPLETED,220.09
CARD_PAYMENT,Current,2022-10-10 08:32:07,2022-10-12 14:35:32,Minipreço,-1.76,0,EUR,COMPLETED,218.33
TRANSFER,Current,2022-10-13 18:19:47,2022-10-13 18:19:47,To EUR Savings,-1,0,EUR,COMPLETED,217.33
CARD_PAYMENT,Current,2022-10-13 18:19:47,2022-10-14 11:58:33,Microsoft Store,-1,0,EUR,COMPLETED,216.33
TRANSFER,Current,2022-10-15 08:18:59,2022-10-15 08:18:59,To EUR Savings,-0.65,0,EUR,COMPLETED,215.68
TRANSFER,Current,2022-10-15 09:17:30,2022-10-15 09:17:30,To EUR Savings,-0.97,0,EUR,COMPLETED,214.71
TRANSFER,Current,2022-10-15 13:21:47,2022-10-15 13:21:47,To EUR Savings,-0.1,0,EUR,COMPLETED,214.61
TRANSFER,Current,2022-10-15 13:30:16,2022-10-15 13:30:16,To EUR Savings,-0.7,0,EUR,COMPLETED,213.91
TRANSFER,Current,2022-10-16 08:39:18,2022-10-16 08:39:18,To EUR Savings,-0.65,0,EUR,COMPLETED,213.26
TRANSFER,Current,2022-10-16 09:53:30,2022-10-16 09:53:30,To EUR Savings,-0.79,0,EUR,COMPLETED,212.47
TOPUP,Current,2022-10-16 14:58:39,2022-10-16 14:58:42,Apple Pay Top-Up by *6660,100,0,EUR,COMPLETED,312.47
CARD_PAYMENT,Current,2022-10-15 08:18:59,2022-10-16 15:21:17,Pad Port Miraflores,-3.35,0,EUR,COMPLETED,309.12
CARD_PAYMENT,Current,2022-10-15 09:17:29,2022-10-16 15:21:27,Pingo Doce,-30.03,0,EUR,COMPLETED,279.09
CARD_PAYMENT,Current,2022-10-15 13:30:16,2022-10-16 15:22:59,Mercado de Algés,-3.3,0,EUR,COMPLETED,275.79
CARD_PAYMENT,Current,2022-10-15 13:21:47,2022-10-16 15:22:59,Receita Pomposa,-10.9,0,EUR,COMPLETED,264.89
TRANSFER,Current,2022-10-17 10:06:27,2022-10-17 10:06:27,To EUR Savings,-20,0,EUR,COMPLETED,244.89
CARD_PAYMENT,Current,2022-10-16 08:39:18,2022-10-17 13:00:01,Pad Port Miraflores,-3.35,0,EUR,COMPLETED,241.54
CARD_PAYMENT,Current,2022-10-16 09:53:28,2022-10-17 13:00:18,Carnaxide Wtc,-30.21,0,EUR,COMPLETED,211.33
TRANSFER,Current,2022-10-17 21:40:58,2022-10-17 21:40:58,To EUR Savings,-0.51,0,EUR,COMPLETED,210.82
CARD_PAYMENT,Current,2022-10-17 21:40:58,2022-10-19 09:45:34,YouTube,-8.49,0,EUR,COMPLETED,202.33
TRANSFER,Current,2022-10-21 16:46:55,2022-10-21 16:46:55,To EUR Savings,-1,0,EUR,COMPLETED,201.33
TOPUP,Current,2022-10-21 21:02:04,2022-10-21 21:02:07,Apple Pay Top-Up by *6660,200,0,EUR,COMPLETED,401.33
TRANSFER,Current,2022-10-22 08:03:47,2022-10-22 08:03:47,To EUR Savings,-0.1,0,EUR,COMPLETED,401.23
TRANSFER,Current,2022-10-22 09:08:44,2022-10-22 09:08:44,To EUR Savings,-0.68,0,EUR,COMPLETED,400.55
CARD_PAYMENT,Current,2022-10-21 16:46:54,2022-10-22 14:07:22,Parques Tejo,-6,0,EUR,COMPLETED,394.55
TRANSFER,Current,2022-10-22 15:04:43,2022-10-22 15:04:43,To EUR Savings,-0.01,0,EUR,COMPLETED,394.54
TRANSFER,Current,2022-10-23 08:25:40,2022-10-23 08:25:40,To EUR Savings,-0.1,0,EUR,COMPLETED,394.44
TRANSFER,Current,2022-10-23 09:51:09,2022-10-23 09:51:09,To EUR Savings,-0.04,0,EUR,COMPLETED,394.4
TRANSFER,Current,2022-10-23 11:44:13,2022-10-23 11:44:13,To EUR Savings,-0.5,0,EUR,COMPLETED,393.9
TRANSFER,Current,2022-10-23 11:52:51,2022-10-23 11:52:51,To EUR Savings,-0.75,0,EUR,COMPLETED,393.15
CARD_PAYMENT,Current,2022-10-22 15:04:43,2022-10-23 12:05:26,Apple,-2.99,0,EUR,COMPLETED,390.16
CARD_PAYMENT,Current,2022-10-23 09:51:08,2022-10-23 23:00:22,Viagogo,-55.96,0,EUR,COMPLETED,334.2
CARD_PAYMENT,Current,2022-10-22 08:03:46,2022-10-23 23:19:19,Carnaxide Wtc,-1.9,0,EUR,COMPLETED,332.3
CARD_PAYMENT,Current,2022-10-22 09:08:44,2022-10-23 23:19:29,Carnaxide Wtc,-24.32,0,EUR,COMPLETED,307.98
TRANSFER,Current,2022-10-24 08:13:47,2022-10-24 08:13:47,To EUR Savings,-0.35,0,EUR,COMPLETED,307.63
TRANSFER,Current,2022-10-24 10:08:25,2022-10-24 10:08:25,To EUR Savings,-20,0,EUR,COMPLETED,287.63
TRANSFER,Current,2022-10-24 13:23:14,2022-10-24 13:23:14,To EUR Savings,-0.01,0,EUR,COMPLETED,287.62
TRANSFER,Current,2022-10-25 08:43:59,2022-10-25 08:43:59,To EUR Savings,-0.35,0,EUR,COMPLETED,287.27
CARD_PAYMENT,Current,2022-10-24 08:13:47,2022-10-25 12:44:18,Cantinho Docepastela,-0.65,0,EUR,COMPLETED,286.62
CARD_PAYMENT,Current,2022-10-24 13:23:12,2022-10-25 12:49:53,Google,-2.99,0,EUR,COMPLETED,283.63
CARD_PAYMENT,Current,2022-10-23 08:25:40,2022-10-25 16:05:07,Carnaxide Wtc,-1.9,0,EUR,COMPLETED,281.73
CARD_PAYMENT,Current,2022-10-23 11:52:51,2022-10-25 16:05:17,Gleba,-3.25,0,EUR,COMPLETED,278.48
CARD_PAYMENT,Current,2022-10-23 11:44:12,2022-10-25 16:05:17,Jean Louis David,-18.5,0,EUR,COMPLETED,259.98
TRANSFER,Current,2022-10-26 08:38:46,2022-10-26 08:38:46,To EUR Savings,-0.35,0,EUR,COMPLETED,259.63
CARD_PAYMENT,Current,2022-10-25 08:43:58,2022-10-26 11:47:44,Cantinho Docepastela,-0.65,0,EUR,COMPLETED,258.98
TRANSFER,Current,2022-10-26 17:53:37,2022-10-26 17:53:37,To EUR Savings,-0.8,0,EUR,COMPLETED,258.18
TRANSFER,Current,2022-10-26 20:38:43,2022-10-26 20:38:43,To EUR Savings,-0.99,0,EUR,COMPLETED,257.19
TRANSFER,Current,2022-10-26 23:01:05,2022-10-26 23:01:05,To EUR Savings,-0.9,0,EUR,COMPLETED,256.29
TRANSFER,Current,2022-10-27 00:33:39,2022-10-27 00:33:39,To EUR Savings,-0.51,0,EUR,COMPLETED,255.78
TRANSFER,Current,2022-10-27 00:42:24,2022-10-27 00:42:24,To EUR Savings,-0.01,0,EUR,COMPLETED,255.77
TRANSFER,Current,2022-10-27 08:31:52,2022-10-27 08:31:52,To EUR Savings,-0.35,0,EUR,COMPLETED,255.42
CARD_PAYMENT,Current,2022-10-26 23:01:05,2022-10-27 11:52:39,FREE NOW,-10.6,0,EUR,COMPLETED,244.82
CARD_PAYMENT,Current,2022-10-26 08:38:45,2022-10-27 12:01:06,Cantinho Docepastela,-0.65,0,EUR,COMPLETED,244.17
CARD_PAYMENT,Current,2022-10-26 20:38:43,2022-10-27 13:11:13,Frn* Hold.free-Now.com,-6.51,0,EUR,COMPLETED,237.66
CARD_PAYMENT,Current,2022-10-26 17:53:36,2022-10-27 13:32:22,Padaria Lisboa,-7.2,0,EUR,COMPLETED,230.46
TRANSFER,Current,2022-10-27 17:45:21,2022-10-27 17:45:21,To EUR Savings,-0.48,0,EUR,COMPLETED,229.98
TRANSFER,Current,2022-10-28 08:27:40,2022-10-28 08:27:40,To EUR Savings,-0.55,0,EUR,COMPLETED,229.43
CARD_PAYMENT,Current,2022-10-27 00:33:39,2022-10-28 09:36:25,Apple,-5.49,0,EUR,COMPLETED,223.94
CARD_PAYMENT,Current,2022-10-27 00:42:24,2022-10-28 10:21:07,Apple,-1.99,0,EUR,COMPLETED,221.95
CARD_PAYMENT,Current,2022-10-27 08:31:52,2022-10-28 11:43:20,Cantinho Docepastela,-0.65,0,EUR,COMPLETED,221.3
CARD_PAYMENT,Current,2022-10-27 17:37:12,2022-10-28 11:43:20,Minipreço,-15.52,0,EUR,COMPLETED,205.78
TRANSFER,Current,2022-10-28 14:04:03,2022-10-28 14:04:03,To EUR Savings,-0.01,0,EUR,COMPLETED,205.77
TRANSFER,Current,2022-10-29 08:34:20,2022-10-29 08:34:20,To EUR Savings,-0.1,0,EUR,COMPLETED,205.67
TRANSFER,Current,2022-10-29 09:26:13,2022-10-29 09:26:13,To EUR Savings,-0.27,0,EUR,COMPLETED,205.4
CARD_PAYMENT,Current,2022-10-28 08:27:40,2022-10-29 10:34:40,Cantinho Docepastela,-1.45,0,EUR,COMPLETED,203.95
CARD_PAYMENT,Current,2022-10-28 14:03:41,2022-10-29 11:53:18,Google,-2.99,0,EUR,COMPLETED,200.96
TRANSFER,Current,2022-10-29 12:51:42,2022-10-29 12:51:42,To EUR Savings,-0.83,0,EUR,COMPLETED,200.13
TRANSFER,Current,2022-10-29 13:02:16,2022-10-29 13:02:16,To EUR Savings,-0.45,0,EUR,COMPLETED,199.68
TRANSFER,Current,2022-10-29 14:45:41,2022-10-29 14:45:41,To EUR Savings,-1,0,EUR,COMPLETED,198.68
TOPUP,Current,2022-10-29 14:59:14,2022-10-29 14:59:23,Apple Pay Top-Up by *6660,200,0,EUR,COMPLETED,398.68
TRANSFER,Current,2022-10-30 08:28:20,2022-10-30 08:28:20,To EUR Savings,-0.1,0,EUR,COMPLETED,398.58
TRANSFER,Current,2022-10-30 09:37:24,2022-10-30 09:37:24,To EUR Savings,-0.73,0,EUR,COMPLETED,397.85
TRANSFER,Current,2022-10-30 09:49:14,2022-10-30 09:49:14,To EUR Savings,-0.84,0,EUR,COMPLETED,397.01
TRANSFER,Current,2022-10-30 10:10:03,2022-10-30 10:10:03,To EUR Savings,-0.66,0,EUR,COMPLETED,396.35
CARD_PAYMENT,Current,2022-10-29 13:01:55,2022-10-30 11:54:14,Minipreço,-3.55,0,EUR,COMPLETED,392.8
CARD_PAYMENT,Current,2022-10-29 12:51:41,2022-10-30 11:54:14,Minipreço,-10.17,0,EUR,COMPLETED,382.63
TRANSFER,Current,2022-10-30 12:42:55,2022-10-30 12:42:55,To EUR Savings,-0.5,0,EUR,COMPLETED,382.13
TRANSFER,Current,2022-10-30 12:51:53,2022-10-30 12:51:53,To EUR Savings,-0.5,0,EUR,COMPLETED,381.63
CARD_PAYMENT,Current,2022-10-29 08:34:20,2022-10-30 13:18:34,Carnaxide Wtc,-1.9,0,EUR,COMPLETED,379.73
CARD_PAYMENT,Current,2022-10-29 09:26:13,2022-10-30 13:18:46,Carnaxide Wtc,-13.73,0,EUR,COMPLETED,366
CARD_PAYMENT,Current,2022-10-29 14:45:40,2022-10-30 13:20:03,Nata Do Bairro,-6,0,EUR,COMPLETED,360
TRANSFER,Current,2022-10-30 13:21:31,2022-10-30 13:21:31,To EUR Savings,-0.5,0,EUR,COMPLETED,359.5
TRANSFER,Current,2022-10-31 08:35:39,2022-10-31 08:35:39,To EUR Savings,-0.43,0,EUR,COMPLETED,359.07
TRANSFER,Current,2022-10-31 14:07:25,2022-10-31 14:07:25,To EUR Savings,-20,0,EUR,COMPLETED,339.07
CARD_PAYMENT,Current,2022-10-30 08:28:20,2022-10-31 15:38:34,Carnaxide Wtc,-1.9,0,EUR,COMPLETED,337.17
CARD_PAYMENT,Current,2022-10-30 09:37:24,2022-10-31 15:38:43,Carnaxide Wtc,-4.27,0,EUR,COMPLETED,332.9
CARD_PAYMENT,Current,2022-10-30 09:49:14,2022-10-31 15:38:52,Auchan,-35.16,0,EUR,COMPLETED,297.74
CARD_PAYMENT,Current,2022-10-30 10:10:03,2022-10-31 15:38:52,Pingo Doce,-20.34,0,EUR,COMPLETED,277.4
CARD_PAYMENT,Current,2022-10-30 12:42:54,2022-10-31 15:40:50,Saisish,-12.5,0,EUR,COMPLETED,264.9
CARD_PAYMENT,Current,2022-10-30 12:51:53,2022-10-31 15:40:59,Receita Pomposa,-8.5,0,EUR,COMPLETED,256.4
CARD_PAYMENT,Current,2022-10-30 13:21:31,2022-10-31 15:41:09,Mercado de Algés,-4.5,0,EUR,COMPLETED,251.9
TRANSFER,Current,2022-11-01 08:25:15,2022-11-01 08:25:15,To EUR Savings,-0.35,0,EUR,COMPLETED,251.55
TRANSFER,Current,2022-11-01 10:35:01,2022-11-01 10:35:01,To EUR Bills,-100,0,EUR,COMPLETED,151.55
TRANSFER,Current,2022-11-01 10:51:09,2022-11-01 10:51:09,To EUR Savings,-0.01,0,EUR,COMPLETED,151.54
CARD_PAYMENT,Current,2022-10-31 08:35:39,2022-11-01 11:10:24,Minipreço,-12.57,0,EUR,COMPLETED,138.97
TRANSFER,Current,2022-11-02 07:19:45,2022-11-02 07:19:45,To EUR Savings,-0.5,0,EUR,COMPLETED,138.47
TRANSFER,Current,2022-11-02 07:54:31,2022-11-02 07:54:31,To EUR Savings,-0.4,0,EUR,COMPLETED,138.07
TRANSFER,Current,2022-11-02 09:21:51,2022-11-02 09:21:51,To EUR Savings,-0.55,0,EUR,COMPLETED,137.52
CARD_PAYMENT,Current,2022-11-01 10:51:09,2022-11-02 09:30:31,Privadonetw,-7.99,0,EUR,COMPLETED,129.53
TOPUP,Current,2022-11-02 10:12:52,2022-11-02 10:12:55,Apple Pay Top-Up by *6660,400,0,EUR,COMPLETED,529.53
CARD_PAYMENT,Current,2022-11-01 08:25:15,2022-11-02 10:47:47,Cantinho Docepastela,-0.65,0,EUR,COMPLETED,528.88
TRANSFER,Current,2022-11-03 08:59:39,2022-11-03 08:59:39,To EUR Savings,-0.35,0,EUR,COMPLETED,528.53
CARD_PAYMENT,Current,2022-11-02 09:21:51,2022-11-03 10:54:53,Cantinho Docepastela,-1.45,0,EUR,COMPLETED,527.08
CARD_PAYMENT,Current,2022-11-02 07:19:45,2022-11-03 13:54:13,Jeronymo Arco Cego,-9.5,0,EUR,COMPLETED,517.58
CARD_PAYMENT,Current,2022-11-02 07:54:30,2022-11-03 13:54:13,Jeronymo Arco Cego,-1.6,0,EUR,COMPLETED,515.98
TRANSFER,Current,2022-11-04 08:12:18,2022-11-04 08:12:18,To EUR Savings,-0.35,0,EUR,COMPLETED,515.63
CARD_PAYMENT,Current,2022-11-03 08:59:39,2022-11-04 11:05:02,Cantinho Docepastela,-0.65,0,EUR,COMPLETED,514.98
TRANSFER,Current,2022-11-05 07:43:19,2022-11-05 07:43:19,To EUR Savings,-0.65,0,EUR,COMPLETED,514.33
CARD_PAYMENT,Current,2022-11-04 08:12:18,2022-11-05 11:32:12,Cantinho Docepastela,-0.65,0,EUR,COMPLETED,513.68
TRANSFER,Current,2022-11-05 14:03:54,2022-11-05 14:03:54,To EUR Savings,-0.6,0,EUR,COMPLETED,513.08
TRANSFER,Current,2022-11-05 14:15:09,2022-11-05 14:15:09,To EUR Savings,-0.71,0,EUR,COMPLETED,512.37
TRANSFER,Current,2022-11-06 07:25:12,2022-11-06 07:25:12,To EUR Savings,-0.25,0,EUR,COMPLETED,512.12
TRANSFER,Current,2022-11-06 08:21:11,2022-11-06 08:21:11,To EUR Savings,-0.18,0,EUR,COMPLETED,511.94
TRANSFER,Current,2022-11-06 08:33:01,2022-11-06 08:33:01,To EUR Savings,-0.51,0,EUR,COMPLETED,511.43
CARD_PAYMENT,Current,2022-11-05 14:03:54,2022-11-06 14:37:49,O Telheiro,-29.4,0,EUR,COMPLETED,482.03
CARD_PAYMENT,Current,2022-11-05 07:43:19,2022-11-06 14:49:13,Pad Port Miraflores,-3.35,0,EUR,COMPLETED,478.68
CARD_PAYMENT,Current,2022-11-05 14:15:08,2022-11-06 14:50:58,Mini Mix Alges,-3.29,0,EUR,COMPLETED,475.39
TRANSFER,Current,2022-11-06 17:44:13,2022-11-06 17:44:13,To EUR Savings,-0.05,0,EUR,COMPLETED,475.34
TRANSFER,Current,2022-11-07 08:33:21,2022-11-07 08:33:21,To EUR Savings,-0.35,0,EUR,COMPLETED,474.99
TRANSFER,Current,2022-11-07 09:15:41,2022-11-07 09:15:41,To EUR Savings,-20,0,EUR,COMPLETED,454.99
CARD_PAYMENT,Current,2022-11-06 07:25:12,2022-11-07 13:23:46,Castilho Cafetarias,-2.75,0,EUR,COMPLETED,452.24
CARD_PAYMENT,Current,2022-11-06 08:21:11,2022-11-07 13:23:54,Carnaxide Wtc,-44.82,0,EUR,COMPLETED,407.42
CARD_PAYMENT,Current,2022-11-06 08:33:01,2022-11-07 13:23:54,Leroy Merlin,-5.49,0,EUR,COMPLETED,401.93
CARD_PAYMENT,Current,2022-11-06 17:44:13,2022-11-07 13:26:12,Pingo Doce,-23.95,0,EUR,COMPLETED,377.98
CARD_PAYMENT,Current,2022-11-07 08:33:21,2022-11-08 10:24:15,Cantinho Docepastela,-0.65,0,EUR,COMPLETED,377.33
TRANSFER,Current,2022-11-10 08:42:37,2022-11-10 08:42:37,To EUR Savings,-0.35,0,EUR,COMPLETED,376.98
TRANSFER,Current,2022-11-11 08:29:10,2022-11-11 08:29:10,To EUR Savings,-0.35,0,EUR,COMPLETED,376.63
CARD_PAYMENT,Current,2022-11-10 08:42:37,2022-11-11 10:43:23,Cantinho Docepastela,-0.65,0,EUR,COMPLETED,375.98
TRANSFER,Current,2022-11-11 18:08:41,2022-11-11 18:08:41,To EUR Savings,-0.6,0,EUR,COMPLETED,375.38
TRANSFER,Current,2022-11-11 20:50:56,2022-11-11 20:50:56,To EUR Savings,-0.4,0,EUR,COMPLETED,374.98
CARD_PAYMENT,Current,2022-11-11 08:29:10,2022-11-12 10:48:40,Cantinho Docepastela,-0.65,0,EUR,COMPLETED,374.33
CARD_PAYMENT,Current,2022-11-11 18:08:41,2022-11-12 10:48:40,PRIO,-1.4,0,EUR,COMPLETED,372.93
TRANSFER,Current,2022-11-12 14:42:58,2022-11-12 14:42:58,To EUR Savings,-0.7,0,EUR,COMPLETED,372.23
CARD_PAYMENT,Current,2022-11-11 20:50:56,2022-11-13 10:35:10,Cafe Rest Beira Rio,-46.6,0,EUR,COMPLETED,325.63
CARD_PAYMENT,Current,2022-11-12 14:42:58,2022-11-13 10:36:11,Alvaros Cafe Unipess,-40.3,0,EUR,COMPLETED,285.33
TRANSFER,Current,2022-11-13 20:31:58,2022-11-13 20:31:58,To EUR,500,0,EUR,COMPLETED,785.33
TRANSFER,Current,2022-11-13 20:32:12,2022-11-13 20:32:12,To EUR Rainy day,-500,0,EUR,COMPLETED,285.33
TRANSFER,Current,2022-11-14 08:21:28,2022-11-14 08:21:28,To EUR Savings,-0.35,0,EUR,COMPLETED,284.98
TRANSFER,Current,2022-11-14 09:16:19,2022-11-14 09:16:19,To EUR Savings,-20,0,EUR,COMPLETED,264.98
TRANSFER,Current,2022-11-15 08:46:28,2022-11-15 08:46:28,To EUR Savings,-0.55,0,EUR,COMPLETED,264.43
CARD_PAYMENT,Current,2022-11-14 08:21:28,2022-11-15 10:31:42,Cantinho Docepastela,-0.65,0,EUR,COMPLETED,263.78
TRANSFER,Current,2022-11-16 08:34:51,2022-11-16 08:34:51,To EUR Savings,-0.35,0,EUR,COMPLETED,263.43
CARD_PAYMENT,Current,2022-11-15 08:46:28,2022-11-16 10:17:54,Cantinho Docepastela,-1.45,0,EUR,COMPLETED,261.98
TRANSFER,Current,2022-11-16 18:34:32,2022-11-16 18:34:32,To EUR,500,0,EUR,COMPLETED,761.98
TRANSFER,Current,2022-11-16 20:31:30,2022-11-16 20:31:30,To EUR Rainy day,-500,0,EUR,COMPLETED,261.98
TRANSFER,Current,2022-11-17 08:25:05,2022-11-17 08:25:05,To EUR Savings,-0.5,0,EUR,COMPLETED,261.48
CARD_PAYMENT,Current,2022-11-16 08:34:51,2022-11-17 10:58:48,Cantinho Docepastela,-0.65,0,EUR,COMPLETED,260.83
TRANSFER,Current,2022-11-17 21:40:58,2022-11-17 21:40:58,To EUR Savings,-0.51,0,EUR,COMPLETED,260.32
CARD_PAYMENT,Current,2022-11-17 08:25:05,2022-11-18 13:31:27,Nata Do Bairro,-1.5,0,EUR,COMPLETED,258.82
TRANSFER,Current,2022-11-19 08:38:00,2022-11-19 08:38:00,To EUR Savings,-0.65,0,EUR,COMPLETED,258.17
CARD_PAYMENT,Current,2022-11-17 21:40:58,2022-11-19 09:35:22,YouTube,-8.49,0,EUR,COMPLETED,249.68
TRANSFER,Current,2022-11-19 09:51:24,2022-11-19 09:51:24,To EUR Savings,-0.09,0,EUR,COMPLETED,249.59
TRANSFER,Current,2022-11-19 10:00:47,2022-11-19 10:00:47,To EUR Savings,-0.02,0,EUR,COMPLETED,249.57
TRANSFER,Current,2022-11-19 14:27:25,2022-11-19 14:27:25,To EUR Savings,-0.5,0,EUR,COMPLETED,249.07
TOPUP,Current,2022-11-19 20:04:27,2022-11-19 20:04:32,Apple Pay Top-Up by *6660,200,0,EUR,COMPLETED,449.07
TRANSFER,Current,2022-11-20 08:07:42,2022-11-20 08:07:42,To EUR Savings,-0.1,0,EUR,COMPLETED,448.97
TRANSFER,Current,2022-11-20 09:09:38,2022-11-20 09:09:38,To EUR Savings,-0.71,0,EUR,COMPLETED,448.26
TRANSFER,Current,2022-11-20 10:14:22,2022-11-20 10:14:22,To EUR Savings,-0.75,0,EUR,COMPLETED,447.51
CARD_REFUND,Current,2022-11-20 00:00:00,2022-11-20 10:22:14,Google,17.99,0,EUR,COMPLETED,465.5
CARD_PAYMENT,Current,2022-11-19 08:38:00,2022-11-20 11:33:35,Pad Port Miraflores,-3.35,0,EUR,COMPLETED,462.15
CARD_PAYMENT,Current,2022-11-19 09:51:24,2022-11-20 11:33:39,Carnaxide Wtc,-50.91,0,EUR,COMPLETED,411.24
CARD_PAYMENT,Current,2022-11-19 10:00:47,2022-11-20 11:33:39,Carnaxide Wtc,-1.98,0,EUR,COMPLETED,409.26
CARD_PAYMENT,Current,2022-11-19 14:27:25,2022-11-20 11:34:58,Tricana Da Barra,-67.5,0,EUR,COMPLETED,341.76
TRANSFER,Current,2022-11-21 08:40:03,2022-11-21 08:40:03,To EUR Savings,-1,0,EUR,COMPLETED,340.76
CARD_REFUND,Current,2022-11-21 00:00:00,2022-11-21 09:06:34,Google,20.99,0,EUR,COMPLETED,361.75
CARD_REFUND,Current,2022-11-21 00:00:00,2022-11-21 09:14:36,Google,1.99,0,EUR,COMPLETED,363.74
CARD_REFUND,Current,2022-11-21 00:00:00,2022-11-21 09:15:57,Google,19.99,0,EUR,COMPLETED,383.73
CARD_REFUND,Current,2022-11-21 00:00:00,2022-11-21 09:16:38,Google,2.24,0,EUR,COMPLETED,385.97
TRANSFER,Current,2022-11-21 09:18:11,2022-11-21 09:18:11,To EUR Savings,-20,0,EUR,COMPLETED,365.97
CARD_PAYMENT,Current,2022-11-20 08:07:42,2022-11-21 11:08:30,Carnaxide Wtc,-1.9,0,EUR,COMPLETED,364.07
CARD_PAYMENT,Current,2022-11-20 09:09:38,2022-11-21 11:08:30,Pingo Doce,-16.29,0,EUR,COMPLETED,347.78
CARD_PAYMENT,Current,2022-11-20 10:14:22,2022-11-22 09:05:28,Amazon,-16.25,0,EUR,COMPLETED,331.53
TRANSFER,Current,2022-11-23 13:34:53,2022-11-23 13:34:53,To EUR Savings,-0.24,0,EUR,COMPLETED,331.29
TRANSFER,Current,2022-11-23 17:13:18,2022-11-23 17:13:18,To EUR Savings,-0.55,0,EUR,COMPLETED,330.74
TRANSFER,Current,2022-11-24 00:17:26,2022-11-24 00:17:26,To EUR Savings,-0.75,0,EUR,COMPLETED,329.99
TRANSFER,Current,2022-11-24 09:07:53,2022-11-24 09:07:53,To EUR Savings,-0.35,0,EUR,COMPLETED,329.64
CARD_PAYMENT,Current,2022-11-21 08:40:03,2022-11-24 09:29:03,PayPal,-59,0,EUR,COMPLETED,270.64
CARD_PAYMENT,Current,2022-11-23 13:34:50,2022-11-24 09:58:07,Uber,-7.76,0,EUR,COMPLETED,262.88
CARD_PAYMENT,Current,2022-11-23 17:13:18,2022-11-24 11:31:45,Fruly,-4.45,0,EUR,COMPLETED,258.43
TRANSFER,Current,2022-11-24 18:41:32,2022-11-24 18:41:32,To EUR Savings,-0.3,0,EUR,COMPLETED,258.13
TRANSFER,Current,2022-11-24 18:45:48,2022-11-24 18:45:48,To EUR Savings,-0.63,0,EUR,COMPLETED,257.5
TRANSFER,Current,2022-11-24 19:32:31,2022-11-24 19:32:31,To EUR Savings,-0.65,0,EUR,COMPLETED,256.85
TRANSFER,Current,2022-11-25 08:48:20,2022-11-25 08:48:20,To EUR Savings,-0.35,0,EUR,COMPLETED,256.5
CARD_PAYMENT,Current,2022-11-24 00:00:00,2022-11-25 09:34:38,Uber,-1,0,EUR,COMPLETED,255.5
TRANSFER,Current,2022-11-25 09:34:41,2022-11-25 09:34:41,To EUR Savings,-1,0,EUR,COMPLETED,254.5
CARD_PAYMENT,Current,2022-11-24 00:17:26,2022-11-25 09:42:14,Uber,-9.25,0,EUR,COMPLETED,245.25
CARD_PAYMENT,Current,2022-11-24 09:02:15,2022-11-25 09:58:14,Cantinho Docepastela,-0.65,0,EUR,COMPLETED,244.6
CARD_PAYMENT,Current,2022-11-24 18:45:44,2022-11-25 09:58:14,Minipreço,-12.37,0,EUR,COMPLETED,232.23
CARD_PAYMENT,Current,2022-11-24 13:16:57,2022-11-25 11:31:34,Vitaminas Oeiras,-10.7,0,EUR,COMPLETED,221.53
CARD_PAYMENT,Current,2022-11-24 13:45:54,2022-11-25 11:31:42,Portugália Oeiras Parque,-4.35,0,EUR,COMPLETED,217.18
TRANSFER,Current,2022-11-25 20:10:41,2022-11-25 20:10:41,To EUR Savings,-0.11,0,EUR,COMPLETED,217.07
TRANSFER,Current,2022-11-26 08:33:06,2022-11-26 08:33:06,To EUR Savings,-0.1,0,EUR,COMPLETED,216.97
CARD_PAYMENT,Current,2022-11-25 08:47:55,2022-11-26 10:19:19,Cantinho Docepastela,-0.65,0,EUR,COMPLETED,216.32
TRANSFER,Current,2022-11-26 11:49:59,2022-11-26 11:49:59,To EUR Savings,-0.4,0,EUR,COMPLETED,215.92
TRANSFER,Current,2022-11-26 16:42:06,2022-11-26 16:42:06,To EUR Savings,-0.01,0,EUR,COMPLETED,215.91
TRANSFER,Current,2022-11-26 20:49:36,2022-11-26 20:49:36,To EUR Savings,-0.5,0,EUR,COMPLETED,215.41
TRANSFER,Current,2022-11-27 00:33:13,2022-11-27 00:33:13,To EUR Savings,-0.01,0,EUR,COMPLETED,215.4
TRANSFER,Current,2022-11-27 00:34:08,2022-11-27 00:34:08,To EUR Savings,-0.51,0,EUR,COMPLETED,214.89
CARD_PAYMENT,Current,2022-11-26 11:49:54,2022-11-27 10:16:37,PRIO,-1.6,0,EUR,COMPLETED,213.29
CARD_PAYMENT,Current,2022-11-25 20:10:38,2022-11-27 10:16:37,Minipreço,-4.89,0,EUR,COMPLETED,208.4
CARD_PAYMENT,Current,2022-11-26 08:33:06,2022-11-27 11:20:56,Carnaxide Wtc,-1.9,0,EUR,COMPLETED,206.5
TRANSFER,Current,2022-11-27 13:57:58,2022-11-27 13:57:58,To EUR Savings,-0.3,0,EUR,COMPLETED,206.2
CARD_PAYMENT,Current,2022-11-27 00:33:13,2022-11-28 08:51:21,Apple,-1.99,0,EUR,COMPLETED,204.21
TRANSFER,Current,2022-11-28 08:51:49,2022-11-28 08:51:49,To EUR Savings,-0.35,0,EUR,COMPLETED,203.86
CARD_PAYMENT,Current,2022-11-26 16:42:01,2022-11-28 08:52:04,Apple,-14.99,0,EUR,COMPLETED,188.87
CARD_PAYMENT,Current,2022-11-27 00:34:08,2022-11-28 08:57:40,Apple,-5.49,0,EUR,COMPLETED,183.38
CARD_PAYMENT,Current,2022-11-27 13:57:54,2022-11-28 09:12:41,Cafe Rest Beira Rio,-31.7,0,EUR,COMPLETED,151.68
CARD_PAYMENT,Current,2022-11-26 20:49:35,2022-11-28 09:12:48,Alvaros Cafe Unipess,-19.5,0,EUR,COMPLETED,132.18
TRANSFER,Current,2022-11-28 09:22:43,2022-11-28 09:22:43,To EUR Savings,-20,0,EUR,COMPLETED,112.18
TRANSFER,Current,2022-11-28 13:03:48,2022-11-28 13:03:48,To EUR Savings,-0.01,0,EUR,COMPLETED,112.17
TOPUP,Current,2022-11-28 13:55:32,2022-11-28 13:55:38,Apple Pay Top-Up by *6660,400,0,EUR,COMPLETED,512.17
TRANSFER,Current,2022-11-28 13:57:19,2022-11-28 13:57:19,To EUR Savings,-0.01,0,EUR,COMPLETED,512.16
TRANSFER,Current,2022-11-29 08:34:38,2022-11-29 08:34:38,To EUR Savings,-0.35,0,EUR,COMPLETED,511.81
CARD_PAYMENT,Current,2022-11-28 13:57:14,2022-11-29 09:33:50,Microsoft Store,-12.99,0,EUR,COMPLETED,498.82
CARD_PAYMENT,Current,2022-11-28 08:51:28,2022-11-29 09:57:33,Cantinho Docepastela,-0.65,0,EUR,COMPLETED,498.17
CARD_PAYMENT,Current,2022-11-28 13:03:42,2022-11-29 11:03:13,Google,-2.99,0,EUR,COMPLETED,495.18
TRANSFER,Current,2022-11-29 12:13:16,2022-11-29 12:13:16,To EUR Savings,-0.5,0,EUR,COMPLETED,494.68
TRANSFER,Current,2022-11-29 12:29:18,2022-11-29 12:29:18,To EUR Savings,-1,0,EUR,COMPLETED,493.68
TRANSFER,Current,2022-11-30 08:33:08,2022-11-30 08:33:08,To EUR Savings,-0.35,0,EUR,COMPLETED,493.33
CARD_PAYMENT,Current,2022-11-29 08:34:38,2022-11-30 09:34:26,Cantinho Docepastela,-0.65,0,EUR,COMPLETED,492.68
CARD_PAYMENT,Current,2022-11-29 12:13:10,2022-11-30 10:23:47,Saisish,-12.5,0,EUR,COMPLETED,480.18
CARD_PAYMENT,Current,2022-11-29 12:29:13,2022-11-30 10:23:50,Mercado de Algés,-11,0,EUR,COMPLETED,469.18
TRANSFER,Current,2022-12-01 08:17:09,2022-12-01 08:17:09,To EUR Savings,-0.1,0,EUR,COMPLETED,469.08
TRANSFER,Current,2022-12-01 08:41:59,2022-12-01 08:41:59,To EUR Savings,-0.78,0,EUR,COMPLETED,468.3
TRANSFER,Current,2022-12-01 08:46:12,2022-12-01 08:46:12,To EUR Savings,-0.15,0,EUR,COMPLETED,468.15
CARD_PAYMENT,Current,2022-11-30 08:33:08,2022-12-01 09:33:55,Cantinho Docepastela,-0.65,0,EUR,COMPLETED,467.5
TRANSFER,Current,2022-12-01 13:00:23,2022-12-01 13:00:23,To EUR Savings,-0.33,0,EUR,COMPLETED,467.17
TRANSFER,Current,2022-12-01 16:21:24,2022-12-01 16:21:24,To EUR Bills,-100,0,EUR,COMPLETED,367.17
CARD_PAYMENT,Current,2022-12-01 13:00:19,2022-12-02 10:01:08,Uber Eats,-33.67,0,EUR,COMPLETED,333.5
TRANSFER,Current,2022-12-02 11:17:36,2022-12-02 11:17:36,To EUR Savings,-0.76,0,EUR,COMPLETED,332.74
TRANSFER,Current,2022-12-02 11:35:40,2022-12-02 11:35:40,To EUR Savings,-0.47,0,EUR,COMPLETED,332.27
TRANSFER,Current,2022-12-02 12:31:21,2022-12-02 12:31:21,To EUR Savings,-0.46,0,EUR,COMPLETED,331.81
TRANSFER,Current,2022-12-02 15:27:27,2022-12-02 15:27:27,Revolut Bank UAB,-15,0,EUR,COMPLETED,316.81
CARD_PAYMENT,Current,2022-12-01 08:41:59,2022-12-02 17:00:00,Carnaxide Wtc,-14.22,0,EUR,COMPLETED,302.59
CARD_PAYMENT,Current,2022-12-01 08:17:09,2022-12-02 17:00:00,Carnaxide Wtc,-1.9,0,EUR,COMPLETED,300.69
CARD_PAYMENT,Current,2022-12-01 08:46:12,2022-12-02 17:00:00,Mv Sousa Posto Galp,-3.85,0,EUR,COMPLETED,296.84
TRANSFER,Current,2022-12-02 19:30:21,2022-12-02 19:30:21,To EUR Savings,-0.81,0,EUR,COMPLETED,296.03
TRANSFER,Current,2022-12-03 08:07:24,2022-12-03 08:07:24,To EUR Savings,-0.1,0,EUR,COMPLETED,295.93
TRANSFER,Current,2022-12-03 08:56:14,2022-12-03 08:56:14,To EUR Savings,-0.23,0,EUR,COMPLETED,295.7
TRANSFER,Current,2022-12-03 09:08:53,2022-12-03 09:08:53,To EUR Savings,-0.9,0,EUR,COMPLETED,294.8
CARD_PAYMENT,Current,2022-12-02 12:31:21,2022-12-03 10:51:53,Uber Eats,-33.54,0,EUR,COMPLETED,261.26
CARD_PAYMENT,Current,2022-12-02 11:17:36,2022-12-03 11:59:29,Carnaxide Wtc,-18.24,0,EUR,COMPLETED,243.02
CARD_PAYMENT,Current,2022-12-02 11:35:37,2022-12-03 11:59:33,Auchan,-26.53,0,EUR,COMPLETED,216.49
TRANSFER,Current,2022-12-03 13:44:18,2022-12-03 13:44:18,To EUR Savings,-0.13,0,EUR,COMPLETED,216.36
TOPUP,Current,2022-12-03 14:23:54,2022-12-03 14:23:57,Apple Pay Top-Up by *6660,400,0,EUR,COMPLETED,616.36
TRANSFER,Current,2022-12-04 08:27:05,2022-12-04 08:27:05,To EUR Savings,-0.1,0,EUR,COMPLETED,616.26
CARD_PAYMENT,Current,2022-12-02 19:30:18,2022-12-04 08:40:46,Uber Eats,-36.19,0,EUR,COMPLETED,580.07
CARD_PAYMENT,Current,2022-12-03 13:44:13,2022-12-04 10:03:30,Minipreço,-8.87,0,EUR,COMPLETED,571.2
CARD_PAYMENT,Current,2022-12-03 08:07:24,2022-12-04 11:11:49,Carnaxide Wtc,-1.9,0,EUR,COMPLETED,569.3
CARD_PAYMENT,Current,2022-12-03 09:08:52,2022-12-04 11:11:54,Pingo Doce,-19.1,0,EUR,COMPLETED,550.2
CARD_PAYMENT,Current,2022-12-03 08:56:14,2022-12-04 11:11:54,Carnaxide Wtc,-4.77,0,EUR,COMPLETED,545.43
TRANSFER,Current,2022-12-04 12:02:36,2022-12-04 12:02:36,To EUR Savings,-0.54,0,EUR,COMPLETED,544.89
TRANSFER,Current,2022-12-05 08:55:49,2022-12-05 08:55:49,To EUR Savings,-0.35,0,EUR,COMPLETED,544.54
CARD_PAYMENT,Current,2022-12-04 12:02:36,2022-12-05 09:06:21,Minipreço,-11.46,0,EUR,COMPLETED,533.08
TRANSFER,Current,2022-12-05 09:23:54,2022-12-05 09:23:54,To EUR Savings,-20,0,EUR,COMPLETED,513.08
CARD_PAYMENT,Current,2022-12-04 08:27:05,2022-12-05 10:49:02,Carnaxide Wtc,-1.9,0,EUR,COMPLETED,511.18
CARD_PAYMENT,Current,2022-12-05 08:55:49,2022-12-06 09:19:38,Cantinho Docepastela,-0.65,0,EUR,COMPLETED,510.53
TRANSFER,Current,2022-12-06 19:30:29,2022-12-06 19:30:29,To EUR Savings,-0.91,0,EUR,COMPLETED,509.62
TRANSFER,Current,2022-12-08 08:10:29,2022-12-08 08:10:29,To EUR Savings,-0.1,0,EUR,COMPLETED,509.52
CARD_PAYMENT,Current,2022-12-06 19:30:29,2022-12-08 09:39:26,Uber Eats,-29.09,0,EUR,COMPLETED,480.43
TRANSFER,Current,2022-12-08 22:40:06,2022-12-08 22:40:07,Revolut Bank UAB,-20,0,EUR,COMPLETED,460.43
TRANSFER,Current,2022-12-09 08:40:57,2022-12-09 08:40:57,To EUR Savings,-0.35,0,EUR,COMPLETED,460.08
CARD_PAYMENT,Current,2022-12-08 08:10:27,2022-12-09 10:21:50,Carnaxide Wtc,-1.9,0,EUR,COMPLETED,458.18
TRANSFER,Current,2022-12-09 12:50:48,2022-12-09 12:50:48,To EUR Savings,-0.33,0,EUR,COMPLETED,457.85
TRANSFER,Current,2022-12-10 09:02:45,2022-12-10 09:02:45,To EUR Savings,-0.1,0,EUR,COMPLETED,457.75
CARD_PAYMENT,Current,2022-12-09 08:40:57,2022-12-10 09:40:28,Cantinho Docepastela,-0.65,0,EUR,COMPLETED,457.1
CARD_PAYMENT,Current,2022-12-09 12:50:48,2022-12-10 10:22:07,Uber Eats,-33.67,0,EUR,COMPLETED,423.43
TRANSFER,Current,2022-12-11 08:35:42,2022-12-11 08:35:42,To EUR Savings,-0.1,0,EUR,COMPLETED,423.33
TRANSFER,Current,2022-12-11 09:19:40,2022-12-11 09:19:40,To EUR Savings,-0.55,0,EUR,COMPLETED,422.78
CARD_PAYMENT,Current,2022-12-10 09:02:45,2022-12-11 10:47:39,Carnaxide Wtc,-1.9,0,EUR,COMPLETED,420.88
TRANSFER,Current,2022-12-12 07:37:46,2022-12-12 07:37:46,To EUR Savings,-0.82,0,EUR,COMPLETED,420.06
TRANSFER,Current,2022-12-12 08:34:53,2022-12-12 08:34:53,To EUR Savings,-0.9,0,EUR,COMPLETED,419.16
TRANSFER,Current,2022-12-12 09:18:29,2022-12-12 09:18:29,To EUR Savings,-20,0,EUR,COMPLETED,399.16
CARD_PAYMENT,Current,2022-12-11 09:19:39,2022-12-12 10:14:41,Pingo Doce,-20.45,0,EUR,COMPLETED,378.71
CARD_PAYMENT,Current,2022-12-11 08:35:42,2022-12-12 10:14:41,Carnaxide Wtc,-1.9,0,EUR,COMPLETED,376.81
TRANSFER,Current,2022-12-12 14:24:30,2022-12-12 14:24:30,To EUR Savings,-0.2,0,EUR,COMPLETED,376.61
TRANSFER,Current,2022-12-12 15:31:19,2022-12-12 15:31:19,To EUR Savings,-1,0,EUR,COMPLETED,375.61
TRANSFER,Current,2022-12-12 16:23:02,2022-12-12 16:23:02,To EUR Savings,-1,0,EUR,COMPLETED,374.61
TRANSFER,Current,2022-12-12 16:54:46,2022-12-12 16:54:46,To EUR Savings,-0.05,0,EUR,COMPLETED,374.56
TRANSFER,Current,2022-12-12 17:01:23,2022-12-12 17:01:23,To EUR Savings,-1,0,EUR,COMPLETED,373.56
TRANSFER,Current,2022-12-13 08:49:01,2022-12-13 08:49:01,To EUR Savings,-0.77,0,EUR,COMPLETED,372.79
CARD_PAYMENT,Current,2022-12-12 14:23:49,2022-12-13 09:50:44,BVG - Berliner Verkehrsbetrieben,-3.8,0,EUR,COMPLETED,368.99
CARD_PAYMENT,Current,2022-12-12 17:00:10,2022-12-13 09:50:44,BVG - Berliner Verkehrsbetrieben,-3,0,EUR,COMPLETED,365.99
CARD_PAYMENT,Current,2022-12-12 16:54:28,2022-12-13 10:02:48,Galeria Karstadt Kaufhof,-39.95,0,EUR,COMPLETED,326.04
CARD_PAYMENT,Current,2022-12-12 07:36:27,2022-12-13 10:06:48,Uber,-14.18,0,EUR,COMPLETED,311.86
CARD_PAYMENT,Current,2022-12-12 08:34:15,2022-12-13 10:07:52,Cafe Terminal 2,-16.1,0,EUR,COMPLETED,295.76
CARD_PAYMENT,Current,2022-12-12 15:31:18,2022-12-13 10:29:57,H4 Hotel Berlin Alexanderplatz,-30,0,EUR,COMPLETED,265.76
CARD_PAYMENT,Current,2022-12-12 16:23:01,2022-12-13 10:29:58,H4 Hotel Berlin Alexanderplatz,-28,0,EUR,COMPLETED,237.76
TRANSFER,Current,2022-12-13 15:32:09,2022-12-13 15:32:09,To EUR Savings,-0.33,0,EUR,COMPLETED,237.43
TRANSFER,Current,2022-12-14 09:06:38,2022-12-14 09:06:38,To EUR Savings,-0.2,0,EUR,COMPLETED,237.23
CARD_PAYMENT,Current,2022-12-13 08:49:01,2022-12-14 10:22:47,Uber,-16.23,0,EUR,COMPLETED,221
TRANSFER,Current,2022-12-14 15:23:20,2022-12-14 15:23:20,To EUR Savings,-0.25,0,EUR,COMPLETED,220.75
TRANSFER,Current,2022-12-14 15:39:29,2022-12-14 15:39:29,To EUR Savings,-0.86,0,EUR,COMPLETED,219.89
TRANSFER,Current,2022-12-15 12:44:13,2022-12-15 12:44:13,To EUR Savings,-0.22,0,EUR,COMPLETED,219.67
CARD_PAYMENT,Current,2022-12-14 09:06:38,2022-12-15 14:12:16,BVG - Berliner Verkehrsbetrieben,-3.8,0,EUR,COMPLETED,215.87
CARD_PAYMENT,Current,2022-12-13 15:32:09,2022-12-15 14:14:47,Uber,-15.67,0,EUR,COMPLETED,200.2
CARD_PAYMENT,Current,2022-12-14 15:39:29,2022-12-15 14:17:20,FREE NOW,-8.14,0,EUR,COMPLETED,192.06
CARD_PAYMENT,Current,2022-12-14 15:23:20,2022-12-15 17:02:28,Ryanair,-8.75,0,EUR,COMPLETED,183.31
CARD_PAYMENT,Current,2022-12-15 12:44:02,2022-12-16 09:05:12,Uber Eats,-22.78,0,EUR,COMPLETED,160.53
TRANSFER,Current,2022-12-16 15:45:47,2022-12-16 15:45:47,To EUR Savings,-0.01,0,EUR,COMPLETED,160.52
TOPUP,Current,2022-12-17 08:33:51,2022-12-17 08:33:53,Apple Pay Top-Up by *6660,400,0,EUR,COMPLETED,560.52
CARD_PAYMENT,Current,2022-12-16 15:45:47,2022-12-17 09:19:13,Apple,-30.99,0,EUR,COMPLETED,529.53
TRANSFER,Current,2022-12-17 13:14:18,2022-12-17 13:14:18,To EUR Savings,-0.92,0,EUR,COMPLETED,528.61
TRANSFER,Current,2022-12-17 21:40:58,2022-12-17 21:40:58,To EUR Savings,-0.51,0,EUR,COMPLETED,528.1
TRANSFER,Current,2022-12-18 08:31:21,2022-12-18 08:31:21,To EUR Savings,-0.1,0,EUR,COMPLETED,528
TRANSFER,Current,2022-12-18 09:00:09,2022-12-18 09:00:09,To EUR Savings,-0.19,0,EUR,COMPLETED,527.81
CARD_PAYMENT,Current,2022-12-17 21:40:57,2022-12-19 08:48:56,YouTube,-8.49,0,EUR,COMPLETED,519.32
TRANSFER,Current,2022-12-19 08:57:24,2022-12-19 08:57:24,To EUR Savings,-0.35,0,EUR,COMPLETED,518.97
TRANSFER,Current,2022-12-19 09:14:55,2022-12-19 09:14:55,To EUR Savings,-20,0,EUR,COMPLETED,498.97
CARD_PAYMENT,Current,2022-12-17 13:14:18,2022-12-19 09:34:34,Uber Eats,-33.08,0,EUR,COMPLETED,465.89
CARD_PAYMENT,Current,2022-12-18 08:31:21,2022-12-19 10:06:41,Carnaxide Wtc,-1.9,0,EUR,COMPLETED,463.99
CARD_PAYMENT,Current,2022-12-18 09:00:09,2022-12-19 10:06:43,Carnaxide Wtc,-2.81,0,EUR,COMPLETED,461.18
CARD_PAYMENT,Current,2022-12-19 08:57:23,2022-12-20 09:14:19,Cantinho Docepastela,-0.65,0,EUR,COMPLETED,460.53
TRANSFER,Current,2022-12-21 02:15:43,2022-12-21 02:15:43,To EUR Savings,-0.01,0,EUR,COMPLETED,460.52
TRANSFER,Current,2022-12-21 14:09:06,2022-12-21 14:09:06,To EUR Savings,-0.5,0,EUR,COMPLETED,460.02
CARD_PAYMENT,Current,2022-12-21 02:15:42,2022-12-21 15:53:52,Microsoft,-12.99,0,EUR,COMPLETED,447.03
TRANSFER,Current,2022-12-21 23:54:05,2022-12-21 23:54:05,To EUR Savings,-0.5,0,EUR,COMPLETED,446.53
TRANSFER,Current,2022-12-22 08:55:36,2022-12-22 08:55:36,To EUR Savings,-0.1,0,EUR,COMPLETED,446.43
TOPUP,Current,2022-12-22 09:21:15,2022-12-22 09:21:17,Apple Pay Top-Up by *6660,200,0,EUR,COMPLETED,646.43
TRANSFER,Current,2022-12-22 15:03:37,2022-12-22 15:03:37,To EUR Savings,-0.01,0,EUR,COMPLETED,646.42
CARD_PAYMENT,Current,2022-12-21 14:09:06,2022-12-22 22:09:45,Nata Do Bairro,-5.5,0,EUR,COMPLETED,640.92
CARD_PAYMENT,Current,2022-12-22 15:03:37,2022-12-23 08:53:49,Apple,-2.99,0,EUR,COMPLETED,637.93
TRANSFER,Current,2022-12-23 09:18:18,2022-12-23 09:18:18,To EUR Savings,-0.35,0,EUR,COMPLETED,637.58
CARD_PAYMENT,Current,2022-12-21 23:54:05,2022-12-23 10:58:56,Hosp. Vivemos Gato,-210.5,0,EUR,COMPLETED,427.08
CARD_PAYMENT,Current,2022-12-22 08:55:36,2022-12-23 10:58:59,Carnaxide Wtc,-1.9,0,EUR,COMPLETED,425.18
TRANSFER,Current,2022-12-23 11:53:55,2022-12-23 11:53:55,To EUR Savings,-0.7,0,EUR,COMPLETED,424.48
TRANSFER,Current,2022-12-23 14:11:29,2022-12-23 14:11:29,To EUR Savings,-0.9,0,EUR,COMPLETED,423.58
CARD_PAYMENT,Current,2022-12-23 14:11:29,2022-12-24 10:14:12,Cafe Disco,-19.1,0,EUR,COMPLETED,404.48
CARD_PAYMENT,Current,2022-12-23 09:18:18,2022-12-24 10:14:12,Cantinho Docepastela,-0.65,0,EUR,COMPLETED,403.83
CARD_PAYMENT,Current,2022-12-23 11:53:55,2022-12-24 15:23:51,Brisa,-6.3,0,EUR,COMPLETED,397.53
TRANSFER,Current,2022-12-24 18:36:10,2022-12-24 18:36:10,To EUR Savings,-0.29,0,EUR,COMPLETED,397.24
CARD_PAYMENT,Current,2022-12-24 18:36:09,2022-12-25 11:22:37,Intermarché,-63.71,0,EUR,COMPLETED,333.53
TRANSFER,Current,2022-12-26 09:17:32,2022-12-26 09:17:32,To EUR Savings,-20,0,EUR,COMPLETED,313.53
TRANSFER,Current,2022-12-26 14:18:12,2022-12-26 14:18:12,To EUR Savings,-0.95,0,EUR,COMPLETED,312.58
TRANSFER,Current,2022-12-26 17:23:51,2022-12-26 17:23:51,To EUR Savings,-0.44,0,EUR,COMPLETED,312.14
TRANSFER,Current,2022-12-27 00:32:38,2022-12-27 00:32:38,To EUR Savings,-0.01,0,EUR,COMPLETED,312.13
TRANSFER,Current,2022-12-27 00:36:17,2022-12-27 00:36:17,To EUR Savings,-0.51,0,EUR,COMPLETED,311.62
TRANSFER,Current,2022-12-27 08:19:51,2022-12-27 08:19:51,To EUR Savings,-0.1,0,EUR,COMPLETED,311.52
CARD_PAYMENT,Current,2022-12-26 17:23:49,2022-12-27 09:11:27,Pingo Doce,-29.56,0,EUR,COMPLETED,281.96
CARD_PAYMENT,Current,2022-12-26 14:18:11,2022-12-27 09:54:09,Leitao Do Aires,-87.05,0,EUR,COMPLETED,194.91
TRANSFER,Current,2022-12-28 08:19:36,2022-12-28 08:19:36,To EUR Savings,-0.1,0,EUR,COMPLETED,194.81
TRANSFER,Current,2022-12-28 08:53:15,2022-12-28 08:53:15,To EUR Savings,-0.13,0,EUR,COMPLETED,194.68
CARD_PAYMENT,Current,2022-12-27 00:32:38,2022-12-28 09:55:48,Apple,-1.99,0,EUR,COMPLETED,192.69
CARD_PAYMENT,Current,2022-12-27 00:36:17,2022-12-28 09:56:16,Apple,-5.49,0,EUR,COMPLETED,187.2
TRANSFER,Current,2022-12-28 10:06:58,2022-12-28 10:06:58,To EUR Savings,-0.02,0,EUR,COMPLETED,187.18
CARD_PAYMENT,Current,2022-12-27 08:19:50,2022-12-28 11:05:34,Carnaxide Wtc,-1.9,0,EUR,COMPLETED,185.28
TRANSFER,Current,2022-12-28 11:13:50,2022-12-28 11:13:50,To EUR Savings,-0.97,0,EUR,COMPLETED,184.31
TRANSFER,Current,2022-12-28 13:03:41,2022-12-28 13:03:41,To EUR Savings,-0.01,0,EUR,COMPLETED,184.3
TRANSFER,Current,2022-12-28 15:09:14,2022-12-28 15:09:14,To EUR Savings,-1,0,EUR,COMPLETED,183.3
TRANSFER,Current,2022-12-29 08:11:01,2022-12-29 08:11:01,To EUR Savings,-0.1,0,EUR,COMPLETED,183.2
CARD_PAYMENT,Current,2022-12-28 10:06:58,2022-12-29 09:48:20,Electrostor,-27.98,0,EUR,COMPLETED,155.22
CARD_PAYMENT,Current,2022-12-28 11:13:50,2022-12-29 09:56:19,Minipreço,-4.03,0,EUR,COMPLETED,151.19
CARD_PAYMENT,Current,2022-12-28 13:03:41,2022-12-29 10:07:50,Google,-2.99,0,EUR,COMPLETED,148.2
CARD_PAYMENT,Current,2022-12-28 15:09:14,2022-12-29 10:08:54,Nos Cinemas,-30,0,EUR,COMPLETED,118.2
CARD_PAYMENT,Current,2022-12-28 08:19:36,2022-12-29 10:55:24,Carnaxide Wtc,-1.9,0,EUR,COMPLETED,116.3
CARD_PAYMENT,Current,2022-12-28 08:53:14,2022-12-29 10:55:24,Carnaxide Wtc,-36.87,0,EUR,COMPLETED,79.43
TRANSFER,Current,2022-12-29 12:11:03,2022-12-29 12:11:03,To EUR Savings,-1,0,EUR,COMPLETED,78.43
TRANSFER,Current,2022-12-29 12:23:17,2022-12-29 12:23:17,To EUR Savings,-0.33,0,EUR,COMPLETED,78.1
TRANSFER,Current,2022-12-29 15:25:11,2022-12-29 15:25:11,To EUR Savings,-0.1,0,EUR,COMPLETED,78
TOPUP,Current,2022-12-30 08:43:29,2022-12-30 08:43:42,Apple Pay Top-Up by *6660,400,0,EUR,COMPLETED,478
TRANSFER,Current,2022-12-30 08:43:52,2022-12-30 08:43:52,To EUR Savings,-0.1,0,EUR,COMPLETED,477.9
CARD_PAYMENT,Current,2022-12-29 12:11:03,2022-12-30 09:30:24,Nos Cinemas,-30,0,EUR,COMPLETED,447.9
CARD_PAYMENT,Current,2022-12-29 12:23:17,2022-12-30 09:31:33,Uber Eats,-33.67,0,EUR,COMPLETED,414.23
TOPUP,Current,2022-12-30 09:49:05,2022-12-30 09:50:07,Card Top-Up,100,0,EUR,COMPLETED,514.23
CARD_PAYMENT,Current,2022-12-29 08:11:01,2022-12-30 11:00:05,Carnaxide Wtc,-1.9,0,EUR,COMPLETED,512.33
CARD_PAYMENT,Current,2022-12-29 15:25:11,2022-12-30 11:00:40,Cinemas NOS,-11.9,0,EUR,COMPLETED,500.43
TRANSFER,Current,2022-12-30 17:01:22,2022-12-30 17:01:22,To EUR Savings,-0.07,0,EUR,COMPLETED,500.36
TRANSFER,Current,2022-12-30 17:16:14,2022-12-30 17:16:14,To EUR Savings,-0.5,0,EUR,COMPLETED,499.86
TRANSFER,Current,2022-12-31 08:12:41,2022-12-31 08:12:41,To EUR Savings,-0.65,0,EUR,COMPLETED,499.21
CARD_PAYMENT,Current,2022-12-30 08:43:52,2022-12-31 13:05:37,Carnaxide Wtc,-1.9,0,EUR,COMPLETED,497.31
CARD_PAYMENT,Current,2022-12-30 17:16:14,2022-12-31 13:06:08,Gleba,-2.5,0,EUR,COMPLETED,494.81
CARD_PAYMENT,Current,2022-12-30 17:01:22,2022-12-31 13:06:08,Auchan,-82.93,0,EUR,COMPLETED,411.88
TRANSFER,Current,2023-01-01 10:36:28,2023-01-01 10:36:28,To EUR Bills,-100,0,EUR,COMPLETED,311.88
CARD_PAYMENT,Current,2023-01-02 07:54:38,,Frn* Hold.free-Now.com,-9.35,0,EUR,REVERTED,
TRANSFER,Current,2023-01-02 07:54:38,2023-01-02 07:54:38,To EUR Savings,-0.65,0,EUR,COMPLETED,311.23
TRANSFER,Current,2023-01-02 07:56:15,2023-01-02 07:56:15,To EUR Savings,-0.95,0,EUR,COMPLETED,310.28
TRANSFER,Current,2023-01-02 08:32:32,2023-01-02 08:32:32,To EUR Savings,-0.5,0,EUR,COMPLETED,309.78
TRANSFER,Current,2023-01-02 09:19:38,2023-01-02 09:19:38,To EUR Savings,-20,0,EUR,COMPLETED,289.78
TRANSFER,Current,2023-01-02 09:29:57,2023-01-02 09:29:57,To EUR Savings,-1,0,EUR,COMPLETED,288.78
TRANSFER,Current,2023-01-02 10:11:52,2023-01-02 10:11:52,To EUR Savings,-0.29,0,EUR,COMPLETED,288.49
CARD_PAYMENT,Current,2022-12-31 08:12:41,2023-01-02 10:13:32,Pad Port Miraflores,-3.35,0,EUR,COMPLETED,285.14
TOPUP,Current,2023-01-02 10:23:27,2023-01-02 10:23:29,Apple Pay Top-Up by *6660,200,0,EUR,COMPLETED,485.14
TRANSFER,Current,2023-01-02 12:22:03,2023-01-02 12:22:03,To EUR Savings,-0.11,0,EUR,COMPLETED,485.03
CARD_PAYMENT,Current,2023-01-02 12:22:02,2023-01-02 15:14:02,Worten,-41.89,0,EUR,COMPLETED,443.14
TRANSFER,Current,2023-01-02 15:18:02,2023-01-02 15:18:02,To EUR Savings,-0.01,0,EUR,COMPLETED,443.13
CARD_PAYMENT,Current,2023-01-02 10:11:51,2023-01-03 09:44:47,Frn* Hold.free-Now.com,-3.71,0,EUR,COMPLETED,439.42
CARD_PAYMENT,Current,2023-01-02 07:56:15,2023-01-03 09:58:10,Uber,-16.05,0,EUR,COMPLETED,423.37
CARD_PAYMENT,Current,2023-01-02 09:29:57,2023-01-03 10:09:57,Clinica Medica E,-70,0,EUR,COMPLETED,353.37
CARD_PAYMENT,Current,2023-01-02 08:32:31,2023-01-03 11:04:02,A Padaria Portuguesa,-3.5,0,EUR,COMPLETED,349.87
CARD_PAYMENT,Current,2023-01-02 15:17:45,2023-01-05 09:41:13,Apple,-4.99,0,EUR,COMPLETED,344.88
TRANSFER,Current,2023-01-05 12:34:42,2023-01-05 12:34:42,To EUR Savings,-0.33,0,EUR,COMPLETED,344.55
TRANSFER,Current,2023-01-05 19:10:38,2023-01-05 19:10:38,To EUR,140,0,EUR,COMPLETED,484.55
TRANSFER,Current,2023-01-05 19:32:11,2023-01-05 19:32:11,To EUR Savings,-0.63,0,EUR,COMPLETED,483.92
CARD_PAYMENT,Current,2023-01-05 12:34:42,2023-01-06 08:21:55,Uber Eats,-33.67,0,EUR,COMPLETED,450.25
TRANSFER,Current,2023-01-07 08:26:14,2023-01-07 08:26:14,To EUR Savings,-0.1,0,EUR,COMPLETED,450.15
CARD_PAYMENT,Current,2023-01-05 19:32:11,2023-01-07 09:06:50,Uber Eats,-27.37,0,EUR,COMPLETED,422.78
TRANSFER,Current,2023-01-08 08:46:00,2023-01-08 08:46:00,To EUR Savings,-0.1,0,EUR,COMPLETED,422.68
TRANSFER,Current,2023-01-08 09:17:08,2023-01-08 09:17:08,To EUR Savings,-0.64,0,EUR,COMPLETED,422.04
TRANSFER,Current,2023-01-08 09:35:37,2023-01-08 09:35:37,To EUR Savings,-0.2,0,EUR,COMPLETED,421.84
CARD_PAYMENT,Current,2023-01-07 08:26:14,2023-01-08 10:37:11,Carnaxide Wtc,-1.9,0,EUR,COMPLETED,419.94
TRANSFER,Current,2023-01-08 12:31:25,2023-01-08 12:31:25,To EUR Savings,-0.13,0,EUR,COMPLETED,419.81
CARD_PAYMENT,Current,2023-01-08 12:31:25,2023-01-09 09:08:36,Minipreço,-8.87,0,EUR,COMPLETED,410.94
TRANSFER,Current,2023-01-09 09:16:17,2023-01-09 09:16:17,To EUR Savings,-20,0,EUR,COMPLETED,390.94
CARD_PAYMENT,Current,2023-01-08 09:35:36,2023-01-09 10:02:53,Pingo Doce,-34.8,0,EUR,COMPLETED,356.14
CARD_PAYMENT,Current,2023-01-08 09:17:08,2023-01-09 10:02:53,Carnaxide Wtc,-11.36,0,EUR,COMPLETED,344.78
CARD_PAYMENT,Current,2023-01-08 08:46:00,2023-01-09 10:02:53,Carnaxide Wtc,-1.9,0,EUR,COMPLETED,342.88
TOPUP,Current,2023-01-09 13:57:28,2023-01-09 13:57:31,Apple Pay Top-Up by *6660,10,0,EUR,COMPLETED,352.88
TRANSFER,Current,2023-01-11 21:38:08,2023-01-11 21:38:08,To EUR Savings,-0.75,0,EUR,COMPLETED,352.13
TRANSFER,Current,2023-01-12 09:53:09,2023-01-12 09:53:09,To EUR Savings,-0.7,0,EUR,COMPLETED,351.43
TRANSFER,Current,2023-01-12 10:57:53,2023-01-12 10:57:53,To EUR Savings,-1,0,EUR,COMPLETED,350.43
TRANSFER,Current,2023-01-12 11:00:04,2023-01-12 11:00:04,To EUR Savings,-1,0,EUR,COMPLETED,349.43
TRANSFER,Current,2023-01-12 11:02:17,2023-01-12 11:02:17,To EUR Savings,-0.09,0,EUR,COMPLETED,349.34
TRANSFER,Current,2023-01-12 11:20:29,2023-01-12 11:20:29,To EUR Savings,-1,0,EUR,COMPLETED,348.34
TRANSFER,Current,2023-01-12 12:46:26,2023-01-12 12:46:26,To EUR Savings,-0.33,0,EUR,COMPLETED,348.01
TRANSFER,Current,2023-01-12 13:48:36,2023-01-12 13:48:36,To EUR,127.47,0,EUR,COMPLETED,475.48
CARD_PAYMENT,Current,2023-01-12 11:00:04,2023-01-13 09:40:10,Uber,-1,0,EUR,COMPLETED,474.48
CARD_PAYMENT,Current,2023-01-12 11:20:29,2023-01-13 09:40:10,Uber,-1,0,EUR,COMPLETED,473.48
CARD_PAYMENT,Current,2023-01-12 11:02:17,2023-01-13 09:41:04,Uber,-7.91,0,EUR,COMPLETED,465.57
CARD_PAYMENT,Current,2023-01-12 12:46:26,2023-01-13 09:45:01,Uber Eats,-33.67,0,EUR,COMPLETED,431.9
CARD_PAYMENT,Current,2023-01-12 09:53:08,2023-01-13 09:54:46,Uber,-8.3,0,EUR,COMPLETED,423.6
CARD_PAYMENT,Current,2023-01-12 10:57:53,2023-01-13 10:17:23,Clinica Medica E,-80,0,EUR,COMPLETED,343.6
CARD_PAYMENT,Current,2023-01-11 21:38:08,2023-01-13 10:53:44,Espaco Acores,-127.25,0,EUR,COMPLETED,216.35
TRANSFER,Current,2023-01-13 19:44:22,2023-01-13 19:44:22,To EUR Savings,-0.2,0,EUR,COMPLETED,216.15
TRANSFER,Current,2023-01-13 19:47:18,2023-01-13 19:47:18,To EUR Savings,-0.7,0,EUR,COMPLETED,215.45
TRANSFER,Current,2023-01-13 22:04:52,2023-01-13 22:04:52,To EUR,100,0,EUR,COMPLETED,315.45
TRANSFER,Current,2023-01-14 08:15:50,2023-01-14 08:15:50,To EUR Savings,-0.1,0,EUR,COMPLETED,315.35
CARD_PAYMENT,Current,2023-01-13 19:47:17,2023-01-14 09:46:54,Dois Corvos Taproom,-6.3,0,EUR,COMPLETED,309.05
CARD_PAYMENT,Current,2023-01-13 19:44:22,2023-01-14 09:46:55,Dois Corvos Taproom,-9.8,0,EUR,COMPLETED,299.25
TOPUP,Current,2023-01-14 10:22:45,2023-01-14 10:22:48,Apple Pay Top-Up by *6660,200,0,EUR,COMPLETED,499.25
TRANSFER,Current,2023-01-14 15:29:31,2023-01-14 15:29:31,To EUR Savings,-0.02,0,EUR,COMPLETED,499.23
TRANSFER,Current,2023-01-14 15:44:46,2023-01-14 15:44:46,To EUR Savings,-0.5,0,EUR,COMPLETED,498.73
TRANSFER,Current,2023-01-14 20:00:02,2023-01-14 20:00:02,To EUR Savings,-0.5,0,EUR,COMPLETED,498.23
TRANSFER,Current,2023-01-15 08:17:33,2023-01-15 08:17:33,To EUR Savings,-0.1,0,EUR,COMPLETED,498.13
TRANSFER,Current,2023-01-15 09:12:29,2023-01-15 09:12:29,To EUR Savings,-0.5,0,EUR,COMPLETED,497.63
TRANSFER,Current,2023-01-15 12:32:59,2023-01-15 12:32:59,To EUR Savings,-0.81,0,EUR,COMPLETED,496.82
CARD_PAYMENT,Current,2023-01-14 08:15:50,2023-01-15 12:38:34,Carnaxide Wtc,-1.9,0,EUR,COMPLETED,494.92
CARD_PAYMENT,Current,2023-01-14 15:44:46,2023-01-15 12:39:09,Music Factory,-17.5,0,EUR,COMPLETED,477.42
CARD_PAYMENT,Current,2023-01-14 15:29:31,2023-01-15 12:39:09,Fnac,-111.98,0,EUR,COMPLETED,365.44
CARD_PAYMENT,Current,2023-01-14 20:00:02,2023-01-15 12:39:38,Music Factory,-17.5,0,EUR,COMPLETED,347.94
TRANSFER,Current,2023-01-15 16:30:17,2023-01-15 16:30:17,To EUR,500,0,EUR,COMPLETED,847.94
TRANSFER,Current,2023-01-15 16:33:20,2023-01-15 16:33:20,To EUR Savings,-0.65,0,EUR,COMPLETED,847.29
TRANSFER,Current,2023-01-15 20:49:13,2023-01-15 20:49:13,To EUR Savings,-0.35,0,EUR,COMPLETED,846.94
CARD_PAYMENT,Current,2023-01-15 12:32:59,2023-01-16 09:11:49,Uber Eats,-33.19,0,EUR,COMPLETED,813.75
TRANSFER,Current,2023-01-16 09:18:21,2023-01-16 09:18:21,To EUR Savings,-20,0,EUR,COMPLETED,793.75
CARD_PAYMENT,Current,2023-01-15 09:12:29,2023-01-17 00:45:19,Carnaxide Wtc,-24.5,0,EUR,COMPLETED,769.25
CARD_PAYMENT,Current,2023-01-15 08:17:33,2023-01-17 00:45:19,Carnaxide Wtc,-1.9,0,EUR,COMPLETED,767.35
CARD_PAYMENT,Current,2023-01-15 16:33:20,2023-01-17 09:16:51,Amazon,-151.35,0,EUR,COMPLETED,616
CARD_PAYMENT,Current,2023-01-15 20:49:12,2023-01-17 12:10:56,Unicefport,-105.65,1.06,EUR,COMPLETED,509.29
TRANSFER,Current,2023-01-17 21:40:58,2023-01-17 21:40:58,To EUR Savings,-0.51,0,EUR,COMPLETED,508.78
TRANSFER,Current,2023-01-19 12:44:51,2023-01-19 12:44:51,To EUR Savings,-0.33,0,EUR,COMPLETED,508.45
TRANSFER,Current,2023-01-19 19:41:57,2023-01-19 19:41:57,To EUR Savings,-0.01,0,EUR,COMPLETED,508.44
CARD_PAYMENT,Current,2023-01-19 12:44:51,2023-01-20 09:06:51,Uber Eats,-33.67,0,EUR,COMPLETED,474.77
CARD_PAYMENT,Current,2023-01-17 21:40:58,2023-01-20 09:18:02,YouTube,-8.49,0,EUR,COMPLETED,466.28
TOPUP,Current,2023-01-20 13:47:38,2023-01-20 13:47:41,Apple Pay Top-Up by *6660,100,0,EUR,COMPLETED,566.28
TRANSFER,Current,2023-01-21 05:11:33,2023-01-21 05:11:33,To EUR Savings,-0.01,0,EUR,COMPLETED,566.27
TRANSFER,Current,2023-01-21 08:34:04,2023-01-21 08:34:04,To EUR Savings,-0.1,0,EUR,COMPLETED,566.17
CARD_PAYMENT,Current,2023-01-19 19:41:57,2023-01-21 08:47:35,Uber Eats,-48.99,0,EUR,COMPLETED,517.18
TRANSFER,Current,2023-01-21 11:30:57,2023-01-21 11:30:57,To EUR Savings,-0.8,0,EUR,COMPLETED,516.38
TRANSFER,Current,2023-01-21 13:10:58,2023-01-21 13:10:58,To EUR Savings,-1,0,EUR,COMPLETED,515.38
TRANSFER,Current,2023-01-21 20:20:01,2023-01-21 20:20:01,To EUR Savings,-0.9,0,EUR,COMPLETED,514.48
CARD_PAYMENT,Current,2023-01-21 05:11:33,2023-01-22 10:04:16,Microsoft,-12.99,0,EUR,COMPLETED,501.49
CARD_PAYMENT,Current,2023-01-21 13:10:58,2023-01-22 10:28:14,Alvaros,-18,0,EUR,COMPLETED,483.49
CARD_PAYMENT,Current,2023-01-21 11:30:56,2023-01-22 10:28:14,PRIO,-3.2,0,EUR,COMPLETED,480.29
TRANSFER,Current,2023-01-22 11:28:07,2023-01-22 11:28:07,To EUR Savings,-1,0,EUR,COMPLETED,479.29
CARD_PAYMENT,Current,2023-01-21 08:34:04,2023-01-22 11:30:05,Carnaxide Wtc,-1.9,0,EUR,COMPLETED,477.39
TRANSFER,Current,2023-01-22 13:48:04,2023-01-22 13:48:04,To EUR Savings,-0.1,0,EUR,COMPLETED,477.29
TRANSFER,Current,2023-01-22 15:03:08,2023-01-22 15:03:08,To EUR Savings,-0.01,0,EUR,COMPLETED,477.28
TRANSFER,Current,2023-01-23 09:17:35,2023-01-23 09:17:35,To EUR Savings,-20,0,EUR,COMPLETED,457.28
CARD_PAYMENT,Current,2023-01-21 20:20:01,2023-01-23 09:29:03,Alvaros Cafe Unipess,-6.1,0,EUR,COMPLETED,451.18
CARD_PAYMENT,Current,2023-01-22 13:48:03,2023-01-23 09:29:29,Cafe Rest Beira Rio,-26.9,0,EUR,COMPLETED,424.28
CARD_PAYMENT,Current,2023-01-22 11:28:07,2023-01-23 09:29:29,Irmaos Figueiredos,-40,0,EUR,COMPLETED,384.28
CARD_PAYMENT,Current,2023-01-22 15:03:08,2023-01-25 09:40:40,Apple,-2.99,0,EUR,COMPLETED,381.29
TRANSFER,Current,2023-01-26 12:55:26,2023-01-26 12:55:26,To EUR Savings,-0.33,0,EUR,COMPLETED,380.96
TRANSFER,Current,2023-01-27 00:32:48,2023-01-27 00:32:48,To EUR Savings,-0.01,0,EUR,COMPLETED,380.95
TRANSFER,Current,2023-01-27 00:33:54,2023-01-27 00:33:54,To EUR Savings,-0.51,0,EUR,COMPLETED,380.44
CARD_PAYMENT,Current,2023-01-26 12:55:26,2023-01-27 09:46:19,Uber Eats,-33.67,0,EUR,COMPLETED,346.77
TRANSFER,Current,2023-01-28 08:10:55,2023-01-28 08:10:55,To EUR Savings,-0.1,0,EUR,COMPLETED,346.67
TRANSFER,Current,2023-01-28 08:41:07,2023-01-28 08:41:07,To EUR Savings,-0.19,0,EUR,COMPLETED,346.48
TRANSFER,Current,2023-01-28 13:03:43,2023-01-28 13:03:43,To EUR Savings,-0.01,0,EUR,COMPLETED,346.47
TRANSFER,Current,2023-01-29 08:11:16,2023-01-29 08:11:16,To EUR Savings,-0.1,0,EUR,COMPLETED,346.37
TRANSFER,Current,2023-01-29 09:26:18,2023-01-29 09:26:18,To EUR Savings,-0.5,0,EUR,COMPLETED,345.87
CARD_PAYMENT,Current,2023-01-27 00:32:48,2023-01-29 09:59:50,Apple,-1.99,0,EUR,COMPLETED,343.88
CARD_PAYMENT,Current,2023-01-27 00:33:54,2023-01-29 10:02:31,Apple,-5.49,0,EUR,COMPLETED,338.39
CARD_PAYMENT,Current,2023-01-28 13:03:42,2023-01-29 10:06:01,Google,-2.99,0,EUR,COMPLETED,335.4
CARD_PAYMENT,Current,2023-01-28 08:41:07,2023-01-29 10:44:41,Carnaxide Wtc,-9.81,0,EUR,COMPLETED,325.59
CARD_PAYMENT,Current,2023-01-28 08:10:55,2023-01-29 10:44:41,Carnaxide Wtc,-1.9,0,EUR,COMPLETED,323.69
TRANSFER,Current,2023-01-29 11:21:45,2023-01-29 11:21:45,To EUR Savings,-0.54,0,EUR,COMPLETED,323.15
TRANSFER,Current,2023-01-29 14:55:37,2023-01-29 14:55:37,To EUR Savings,-0.8,0,EUR,COMPLETED,322.35
TRANSFER,Current,2023-01-30 09:21:05,2023-01-30 09:21:05,To EUR Savings,-20,0,EUR,COMPLETED,302.35
TRANSFER,Current,2023-01-31 11:12:48,2023-01-31 11:12:48,To EUR Savings,-0.1,0,EUR,COMPLETED,302.25
CARD_PAYMENT,Current,2023-01-29 08:11:16,2023-01-31 13:56:42,Carnaxide Wtc,-1.9,0,EUR,COMPLETED,300.35
CARD_PAYMENT,Current,2023-01-29 09:26:18,2023-01-31 13:56:42,Gleba,-3.5,0,EUR,COMPLETED,296.85
CARD_PAYMENT,Current,2023-01-29 11:21:44,2023-01-31 14:28:25,Amazon,-4.46,0,EUR,COMPLETED,292.39
CARD_PAYMENT,Current,2023-01-29 14:55:37,2023-01-31 17:40:08,Nata Do Bairro,-5.2,0,EUR,COMPLETED,287.19
CARD_REFUND,Current,2023-01-31 00:00:00,2023-01-31 21:15:37,Worten,41.89,0,EUR,COMPLETED,329.08
CARD_PAYMENT,Current,2023-01-31 11:12:48,2023-02-01 10:55:17,Luis Valente Silva L,-36.9,0,EUR,COMPLETED,292.18
TRANSFER,Current,2023-02-01 16:32:25,2023-02-01 16:32:25,To EUR Bills,-100,0,EUR,COMPLETED,192.18
TRANSFER,Current,2023-02-01 19:33:05,2023-02-01 19:33:05,To EUR Savings,-0.71,0,EUR,COMPLETED,191.47
TOPUP,Current,2023-02-01 20:35:56,2023-02-01 20:35:59,Apple Pay Top-Up by *6660,200,0,EUR,COMPLETED,391.47
CARD_PAYMENT,Current,2023-02-01 19:33:05,2023-02-03 09:10:14,Uber Eats,-35.29,0,EUR,COMPLETED,356.18
TRANSFER,Current,2023-02-04 08:26:11,2023-02-04 08:26:11,To EUR Savings,-0.5,0,EUR,COMPLETED,355.68
TRANSFER,Current,2023-02-05 08:14:49,2023-02-05 08:14:49,To EUR Savings,-0.1,0,EUR,COMPLETED,355.58
TRANSFER,Current,2023-02-05 08:56:44,2023-02-05 08:56:44,To EUR Savings,-0.76,0,EUR,COMPLETED,354.82
TRANSFER,Current,2023-02-05 09:14:14,2023-02-05 09:14:14,To EUR Savings,-1,0,EUR,COMPLETED,353.82
TRANSFER,Current,2023-02-05 09:17:05,2023-02-05 09:17:05,To EUR Savings,-0.5,0,EUR,COMPLETED,353.32
TRANSFER,Current,2023-02-05 09:32:08,2023-02-05 09:32:08,To EUR Savings,-0.14,0,EUR,COMPLETED,353.18
CARD_PAYMENT,Current,2023-02-04 08:26:04,2023-02-05 12:13:26,Pad Port Miraflores,-3.5,0,EUR,COMPLETED,349.68
TRANSFER,Current,2023-02-05 14:14:03,2023-02-05 14:14:03,To EUR Savings,-0.8,0,EUR,COMPLETED,348.88
TRANSFER,Current,2023-02-05 19:40:40,2023-02-05 19:40:40,To EUR Savings,-0.92,0,EUR,COMPLETED,347.96
CARD_PAYMENT,Current,2023-02-05 19:40:40,2023-02-06 08:51:52,Minipreço,-11.08,0,EUR,COMPLETED,336.88
CARD_PAYMENT,Current,2023-02-05 08:56:44,2023-02-06 10:44:50,Carnaxide Wtc,-5.24,0,EUR,COMPLETED,331.64
CARD_PAYMENT,Current,2023-02-05 09:14:14,2023-02-06 10:44:50,Auchan,-9,0,EUR,COMPLETED,322.64
CARD_PAYMENT,Current,2023-02-05 08:14:49,2023-02-06 10:44:50,Carnaxide Wtc,-1.9,0,EUR,COMPLETED,320.74
CARD_PAYMENT,Current,2023-02-05 09:17:05,2023-02-06 10:44:50,Gleba,-3.5,0,EUR,COMPLETED,317.24
CARD_PAYMENT,Current,2023-02-05 09:32:08,2023-02-06 10:44:53,Pingo Doce,-32.86,0,EUR,COMPLETED,284.38
CARD_PAYMENT,Current,2023-02-05 14:14:03,2023-02-06 10:45:16,Nata Do Bairro,-2.2,0,EUR,COMPLETED,282.18
TRANSFER,Current,2023-02-06 13:47:38,2023-02-06 13:47:38,To EUR Savings,-20,0,EUR,COMPLETED,262.18
TRANSFER,Current,2023-02-11 07:52:03,2023-02-11 07:52:03,To EUR Savings,-0.5,0,EUR,COMPLETED,261.68
TRANSFER,Current,2023-02-12 08:08:09,2023-02-12 08:08:09,To EUR Savings,-0.1,0,EUR,COMPLETED,261.58
TRANSFER,Current,2023-02-12 08:39:20,2023-02-12 08:39:20,To EUR Savings,-0.81,0,EUR,COMPLETED,260.77
TRANSFER,Current,2023-02-12 09:07:27,2023-02-12 09:07:27,To EUR Savings,-0.06,0,EUR,COMPLETED,260.71
CARD_PAYMENT,Current,2023-02-11 07:52:03,2023-02-12 11:04:24,Pad Port Miraflores,-3.5,0,EUR,COMPLETED,257.21
TRANSFER,Current,2023-02-12 16:35:59,2023-02-12 16:35:59,To EUR Savings,-0.01,0,EUR,COMPLETED,257.2
TRANSFER,Current,2023-02-12 19:20:12,2023-02-12 19:20:12,To EUR Savings,-0.6,0,EUR,COMPLETED,256.6
CARD_PAYMENT,Current,2023-02-12 16:35:59,2023-02-13 08:58:12,PlayStation,-9.99,0,EUR,COMPLETED,246.61
TRANSFER,Current,2023-02-13 09:18:19,2023-02-13 09:18:19,To EUR Savings,-20,0,EUR,COMPLETED,226.61
TRANSFER,Current,2023-02-13 10:21:37,2023-02-13 10:21:37,To EUR Savings,-0.46,0,EUR,COMPLETED,226.15
CARD_PAYMENT,Current,2023-02-12 08:08:09,2023-02-13 10:23:40,Carnaxide Wtc,-1.9,0,EUR,COMPLETED,224.25
CARD_PAYMENT,Current,2023-02-12 08:39:20,2023-02-13 10:23:40,Carnaxide Wtc,-4.19,0,EUR,COMPLETED,220.06
CARD_PAYMENT,Current,2023-02-12 09:07:27,2023-02-13 10:23:43,Pingo Doce,-15.94,0,EUR,COMPLETED,204.12
TRANSFER,Current,2023-02-13 11:17:14,2023-02-13 11:17:14,To EUR Savings,-1,0,EUR,COMPLETED,203.12
TRANSFER,Current,2023-02-13 11:54:20,2023-02-13 11:54:20,To EUR Savings,-0.4,0,EUR,COMPLETED,202.72
TRANSFER,Current,2023-02-13 12:06:55,2023-02-13 12:06:55,To EUR Savings,-0.5,0,EUR,COMPLETED,202.22
CARD_PAYMENT,Current,2023-02-13 10:21:37,2023-02-14 09:02:38,Uber,-7.63,0,EUR,COMPLETED,194.59
CARD_PAYMENT,Current,2023-02-13 11:54:18,2023-02-14 09:09:39,Uber,-3.6,0,EUR,COMPLETED,190.99
CARD_PAYMENT,Current,2023-02-13 12:05:37,2023-02-14 09:11:33,Uber,-0.5,0,EUR,COMPLETED,190.49
CARD_PAYMENT,Current,2023-02-12 19:20:12,2023-02-14 09:16:05,Uber Eats,-14.4,0,EUR,COMPLETED,176.09
CARD_PAYMENT,Current,2023-02-13 11:17:14,2023-02-14 09:36:38,Clinica Medica E,-70,0,EUR,COMPLETED,106.09
TOPUP,Current,2023-02-15 22:40:42,2023-02-15 22:40:45,Apple Pay Top-Up by *6660,200,0,EUR,COMPLETED,306.09
TRANSFER,Current,2023-02-17 18:31:16,2023-02-17 18:31:16,To EUR Savings,-0.84,0,EUR,COMPLETED,305.25
TRANSFER,Current,2023-02-17 19:29:22,2023-02-17 19:29:22,To EUR Savings,-0.95,0,EUR,COMPLETED,304.3
TRANSFER,Current,2023-02-17 21:40:58,2023-02-17 21:40:58,To EUR Savings,-0.51,0,EUR,COMPLETED,303.79
CARD_PAYMENT,Current,2023-02-17 19:29:21,2023-02-18 15:44:42,Repsol,-15.05,0,EUR,COMPLETED,288.74
TRANSFER,Current,2023-02-19 08:16:13,2023-02-19 08:16:13,To EUR Savings,-0.1,0,EUR,COMPLETED,288.64
TRANSFER,Current,2023-02-19 08:58:07,2023-02-19 08:58:07,To EUR Savings,-0.62,0,EUR,COMPLETED,288.02
TRANSFER,Current,2023-02-19 09:09:28,2023-02-19 09:09:28,To EUR Savings,-0.86,0,EUR,COMPLETED,287.16
CARD_PAYMENT,Current,2023-02-17 18:31:16,2023-02-19 09:51:40,Uber Eats,-14.16,0,EUR,COMPLETED,273
CARD_PAYMENT,Current,2023-02-17 21:40:58,2023-02-19 09:53:39,YouTube,-8.49,0,EUR,COMPLETED,264.51
TRANSFER,Current,2023-02-19 09:58:34,2023-02-19 09:58:34,To EUR Savings,-0.45,0,EUR,COMPLETED,264.06
TRANSFER,Current,2023-02-20 08:11:04,2023-02-20 08:11:04,To EUR Savings,-0.6,0,EUR,COMPLETED,263.46
CARD_PAYMENT,Current,2023-02-19 09:58:34,2023-02-20 09:00:13,Samsung,-15.55,0,EUR,COMPLETED,247.91
TRANSFER,Current,2023-02-20 09:19:38,2023-02-20 09:19:38,To EUR Savings,-1,0,EUR,COMPLETED,246.91
TRANSFER,Current,2023-02-20 09:20:21,2023-02-20 09:20:21,To EUR Savings,-20,0,EUR,COMPLETED,226.91
CARD_PAYMENT,Current,2023-02-19 08:16:13,2023-02-20 10:46:31,Carnaxide Wtc,-1.9,0,EUR,COMPLETED,225.01
CARD_PAYMENT,Current,2023-02-19 09:09:28,2023-02-20 10:46:33,Pingo Doce,-15.14,0,EUR,COMPLETED,209.87
CARD_PAYMENT,Current,2023-02-19 08:58:07,2023-02-20 10:46:33,Carnaxide Wtc,-8.38,0,EUR,COMPLETED,201.49
TRANSFER,Current,2023-02-20 18:49:14,2023-02-20 18:49:14,To EUR Savings,-0.2,0,EUR,COMPLETED,201.29
TRANSFER,Current,2023-02-21 08:16:23,2023-02-21 08:16:23,To EUR Savings,-0.1,0,EUR,COMPLETED,201.19
CARD_PAYMENT,Current,2023-02-20 18:49:13,2023-02-21 09:23:29,Cinemacity Alfragide,-4.8,0,EUR,COMPLETED,196.39
TRANSFER,Current,2023-02-21 09:51:01,2023-02-21 09:51:01,To EUR Savings,-0.3,0,EUR,COMPLETED,196.09
CARD_PAYMENT,Current,2023-02-20 08:11:04,2023-02-21 11:28:25,Carnaxide Wtc,-1.4,0,EUR,COMPLETED,194.69
CARD_PAYMENT,Current,2023-02-20 09:19:38,2023-02-21 11:28:28,Decathlon,-15,0,EUR,COMPLETED,179.69
TRANSFER,Current,2023-02-21 14:11:43,2023-02-21 14:11:43,To EUR Savings,-1,0,EUR,COMPLETED,178.69
CARD_PAYMENT,Current,2023-02-21 14:11:42,2023-02-22 09:47:58,Nos Cinemas,-15,0,EUR,COMPLETED,163.69
CARD_PAYMENT,Current,2023-02-21 08:16:23,2023-02-22 11:29:17,Carnaxide Wtc,-1.9,0,EUR,COMPLETED,161.79
CARD_PAYMENT,Current,2023-02-21 09:51:01,2023-02-22 11:29:17,Repsol,-20.7,0,EUR,COMPLETED,141.09
TRANSFER,Current,2023-02-22 15:02:37,2023-02-22 15:02:37,To EUR Savings,-0.01,0,EUR,COMPLETED,141.08
TOPUP,Current,2023-02-22 21:15:13,2023-02-22 21:15:20,Apple Pay Top-Up by *6660,200,0,EUR,COMPLETED,341.08
CARD_PAYMENT,Current,2023-02-22 15:02:37,2023-02-23 09:39:28,Apple,-2.99,0,EUR,COMPLETED,338.09
TRANSFER,Current,2023-02-25 08:09:19,2023-02-25 08:09:19,To EUR Savings,-0.1,0,EUR,COMPLETED,337.99
TRANSFER,Current,2023-02-26 09:40:08,2023-02-26 09:40:08,To EUR Savings,-0.1,0,EUR,COMPLETED,337.89
CARD_PAYMENT,Current,2023-02-25 08:09:18,2023-02-26 11:25:30,Carnaxide Wtc,-1.9,0,EUR,COMPLETED,335.99
TRANSFER,Current,2023-02-26 15:55:02,2023-02-26 15:55:02,To EUR Savings,-0.81,0,EUR,COMPLETED,335.18
TOPUP,Current,2023-02-26 17:36:10,2023-02-26 17:36:12,Apple Pay Top-Up by *6660,200,0,EUR,COMPLETED,535.18
TRANSFER,Current,2023-02-26 20:16:40,2023-02-26 20:16:40,To EUR Savings,-0.01,0,EUR,COMPLETED,535.17
TRANSFER,Current,2023-02-26 20:18:13,2023-02-26 20:18:13,To EUR Savings,-0.51,0,EUR,COMPLETED,534.66
TRANSFER,Current,2023-02-27 09:20:07,2023-02-27 09:20:07,To EUR Savings,-20,0,EUR,COMPLETED,514.66
CARD_PAYMENT,Current,2023-02-26 15:55:02,2023-02-27 09:46:44,Mania Do Peixe By Gu,-205.19,0,EUR,COMPLETED,309.47
CARD_PAYMENT,Current,2023-02-26 09:40:07,2023-02-27 14:55:56,Carnaxide Wtc,-1.9,0,EUR,COMPLETED,307.57
CARD_PAYMENT,Current,2023-02-26 20:16:40,2023-02-28 09:16:19,Apple,-1.99,0,EUR,COMPLETED,305.58
CARD_PAYMENT,Current,2023-02-26 20:18:13,2023-02-28 09:21:28,Apple,-5.49,0,EUR,COMPLETED,300.09
TRANSFER,Current,2023-02-28 13:03:43,2023-02-28 13:03:43,To EUR Savings,-0.01,0,EUR,COMPLETED,300.08
TRANSFER,Current,2023-02-28 22:16:50,2023-02-28 22:16:50,To EUR Savings,-0.2,0,EUR,COMPLETED,299.88
CARD_PAYMENT,Current,2023-02-28 13:03:43,2023-03-01 13:58:28,Google,-2.99,0,EUR,COMPLETED,296.89
TRANSFER,Current,2023-03-02 10:59:56,2023-03-02 10:59:56,To EUR Savings,-0.49,0,EUR,COMPLETED,296.4
CARD_PAYMENT,Current,2023-02-28 22:16:50,2023-03-02 11:46:19,La Siesta,-128.8,0,EUR,COMPLETED,167.6
TRANSFER,Current,2023-03-02 12:03:54,2023-03-02 12:03:54,To EUR Savings,-1,0,EUR,COMPLETED,166.6
TRANSFER,Current,2023-03-02 12:15:53,2023-03-02 12:15:53,To EUR Savings,-0.8,0,EUR,COMPLETED,165.8
TRANSFER,Current,2023-03-02 12:19:00,2023-03-02 12:19:00,To EUR Savings,-0.02,0,EUR,COMPLETED,165.78
TOPUP,Current,2023-03-02 12:50:16,2023-03-02 12:50:20,Apple Pay Top-Up by *6660,200,0,EUR,COMPLETED,365.78
CARD_PAYMENT,Current,2023-03-02 12:19:00,2023-03-03 09:52:38,Uber,-8.98,0,EUR,COMPLETED,356.8
CARD_PAYMENT,Current,2023-03-02 10:59:56,2023-03-03 10:12:05,Uber,-9.51,0,EUR,COMPLETED,347.29
CARD_PAYMENT,Current,2023-03-02 00:00:00,2023-03-03 10:20:06,Uber,-1,0,EUR,COMPLETED,346.29
TRANSFER,Current,2023-03-03 10:20:06,2023-03-03 10:20:06,To EUR Savings,-1,0,EUR,COMPLETED,345.29
CARD_PAYMENT,Current,2023-03-02 12:15:53,2023-03-03 10:21:24,Manteigaria,-7.2,0,EUR,COMPLETED,338.09
CARD_PAYMENT,Current,2023-03-02 12:03:53,2023-03-03 10:21:55,Clinica Medica E,-70,0,EUR,COMPLETED,268.09
TRANSFER,Current,2023-03-03 18:58:44,2023-03-03 18:58:44,To EUR Savings,-1,0,EUR,COMPLETED,267.09
TRANSFER,Current,2023-03-04 07:31:00,2023-03-04 07:31:00,To EUR Savings,-0.57,0,EUR,COMPLETED,266.52
TRANSFER,Current,2023-03-04 07:40:14,2023-03-04 07:40:14,To EUR Savings,-0.45,0,EUR,COMPLETED,266.07
CARD_PAYMENT,Current,2023-03-03 18:58:44,2023-03-04 09:18:43,Miió,-20,0,EUR,COMPLETED,246.07
TRANSFER,Current,2023-03-04 12:22:18,2023-03-04 12:22:18,To EUR Savings,-0.5,0,EUR,COMPLETED,245.57
TRANSFER,Current,2023-03-04 12:39:41,2023-03-04 12:39:41,To EUR Savings,-0.5,0,EUR,COMPLETED,245.07
TRANSFER,Current,2023-03-05 08:15:39,2023-03-05 08:15:39,To EUR Savings,-0.6,0,EUR,COMPLETED,244.47
TRANSFER,Current,2023-03-05 09:32:34,2023-03-05 09:32:34,To EUR Savings,-0.51,0,EUR,COMPLETED,243.96
CARD_PAYMENT,Current,2023-03-04 07:31:00,2023-03-05 13:49:47,Repsol,-14.43,0,EUR,COMPLETED,229.53
CARD_PAYMENT,Current,2023-03-04 07:40:13,2023-03-05 13:49:47,Pad Port Miraflores,-3.55,0,EUR,COMPLETED,225.98
CARD_PAYMENT,Current,2023-03-04 12:39:41,2023-03-05 13:49:59,Gleba,-3.5,0,EUR,COMPLETED,222.48
CARD_PAYMENT,Current,2023-03-04 12:22:17,2023-03-05 13:49:59,Jean Louis David,-18.5,0,EUR,COMPLETED,203.98
TRANSFER,Current,2023-03-06 09:19:40,2023-03-06 09:19:40,To EUR Savings,-20,0,EUR,COMPLETED,183.98
CARD_PAYMENT,Current,2023-03-05 08:15:39,2023-03-06 11:27:56,Carnaxide Wtc,-1.4,0,EUR,COMPLETED,182.58
CARD_PAYMENT,Current,2023-03-05 09:32:34,2023-03-06 11:28:00,Carnaxide Wtc,-7.49,0,EUR,COMPLETED,175.09
TRANSFER,Current,2023-03-06 16:30:09,2023-03-06 16:30:09,To EUR Savings,-0.56,0,EUR,COMPLETED,174.53
TRANSFER,Current,2023-03-06 23:49:17,2023-03-06 23:49:17,To EUR Savings,-1,0,EUR,COMPLETED,173.53
TRANSFER,Current,2023-03-06 23:50:14,2023-03-06 23:50:14,To EUR Savings,-1,0,EUR,COMPLETED,172.53
TOPUP,Current,2023-03-06 23:51:27,2023-03-06 23:51:34,Apple Pay Top-Up by *6660,200,0,EUR,COMPLETED,372.53
CARD_PAYMENT,Current,2023-03-06 16:30:09,2023-03-07 09:40:07,Uber,-11.44,0,EUR,COMPLETED,361.09
CARD_PAYMENT,Current,2023-03-06 23:50:13,2023-03-07 10:30:32,Miió,-20,0,EUR,COMPLETED,341.09
CARD_PAYMENT,Current,2023-03-06 23:49:17,2023-03-07 10:30:32,Miió,-10,0,EUR,COMPLETED,331.09
TRANSFER,Current,2023-03-07 15:49:42,2023-03-07 15:49:42,To EUR Savings,-1,0,EUR,COMPLETED,330.09
TRANSFER,Current,2023-03-07 17:59:38,2023-03-07 17:59:38,To EUR Savings,-0.05,0,EUR,COMPLETED,330.04
TRANSFER,Current,2023-03-08 01:30:00,2023-03-08 01:30:00,To EUR Savings,-1,0,EUR,COMPLETED,329.04
CARD_PAYMENT,Current,2023-03-08 01:30:00,2023-03-08 15:47:01,Miió,-50,0,EUR,COMPLETED,279.04
CARD_PAYMENT,Current,2023-03-07 17:59:38,2023-03-08 15:48:02,Pad Port Miraflores,-3.95,0,EUR,COMPLETED,275.09
CARD_PAYMENT,Current,2023-03-07 15:49:42,2023-03-09 09:57:40,Nos Cinemas,-5,0,EUR,COMPLETED,270.09
TRANSFER,Current,2023-03-09 13:12:25,2023-03-09 13:12:25,To EUR Savings,-0.95,0,EUR,COMPLETED,269.14
CARD_PAYMENT,Current,2023-03-09 13:12:25,2023-03-10 16:53:25,Uber Eats,-17.05,0,EUR,COMPLETED,252.09
TRANSFER,Current,2023-03-10 19:30:42,2023-03-10 19:30:42,To EUR Savings,-0.37,0,EUR,COMPLETED,251.72
TRANSFER,Current,2023-03-11 08:00:04,2023-03-11 08:00:04,To EUR Savings,-0.45,0,EUR,COMPLETED,251.27
TRANSFER,Current,2023-03-11 09:13:20,2023-03-11 09:13:20,To EUR Savings,-0.79,0,EUR,COMPLETED,250.48
TRANSFER,Current,2023-03-12 08:27:31,2023-03-12 08:27:31,To EUR Savings,-0.6,0,EUR,COMPLETED,249.88
TRANSFER,Current,2023-03-12 09:05:40,2023-03-12 09:05:40,To EUR Savings,-0.62,0,EUR,COMPLETED,249.26
CARD_PAYMENT,Current,2023-03-10 19:30:42,2023-03-12 09:33:28,Uber Eats,-16.63,0,EUR,COMPLETED,232.63
TOPUP,Current,2023-03-12 10:46:29,2023-03-12 10:46:35,Apple Pay Top-Up by *6660,200,0,EUR,COMPLETED,432.63
TRANSFER,Current,2023-03-12 14:09:39,2023-03-12 14:09:39,To EUR Savings,-0.2,0,EUR,COMPLETED,432.43
CARD_PAYMENT,Current,2023-03-11 08:00:04,2023-03-12 15:49:09,Pad Port Miraflores,-3.55,0,EUR,COMPLETED,428.88
CARD_PAYMENT,Current,2023-03-11 09:13:20,2023-03-12 15:49:12,Pingo Doce,-29.21,0,EUR,COMPLETED,399.67
CARD_PAYMENT,Current,2023-03-12 14:09:39,2023-03-13 09:11:20,Tia Rosa,-44.8,0,EUR,COMPLETED,354.87
TRANSFER,Current,2023-03-13 09:18:14,2023-03-13 09:18:14,To EUR Savings,-20,0,EUR,COMPLETED,334.87
CARD_PAYMENT,Current,2023-03-12 08:27:31,2023-03-13 10:53:11,Carnaxide Wtc,-1.4,0,EUR,COMPLETED,333.47
CARD_PAYMENT,Current,2023-03-12 09:05:40,2023-03-13 10:53:14,Carnaxide Wtc,-8.38,0,EUR,COMPLETED,325.09
TRANSFER,Current,2023-03-14 10:40:47,2023-03-14 10:40:47,To EUR Savings,-0.75,0,EUR,COMPLETED,324.34
TRANSFER,Current,2023-03-14 10:49:20,2023-03-14 10:49:20,To EUR Savings,-0.5,0,EUR,COMPLETED,323.84
CARD_PAYMENT,Current,2023-03-14 10:49:20,2023-03-15 09:41:07,Uber,-0.5,0,EUR,COMPLETED,323.34
CARD_PAYMENT,Current,2023-03-14 10:40:47,2023-03-15 09:42:12,Uber,-4.25,0,EUR,COMPLETED,319.09
TRANSFER,Current,2023-03-15 17:13:19,2023-03-15 17:13:19,To EUR Savings,-0.81,0,EUR,COMPLETED,318.28
TRANSFER,Current,2023-03-15 20:01:20,2023-03-15 20:01:20,To EUR Savings,-0.68,0,EUR,COMPLETED,317.6
TRANSFER,Current,2023-03-16 13:07:32,2023-03-16 13:07:32,To EUR Savings,-0.95,0,EUR,COMPLETED,316.65
CARD_PAYMENT,Current,2023-03-15 17:13:19,2023-03-16 16:37:14,Controlauto Miraflores,-34.19,0,EUR,COMPLETED,282.46
CARD_PAYMENT,Current,2023-03-16 13:07:32,2023-03-17 20:26:31,Uber Eats,-17.05,0,EUR,COMPLETED,265.41
CARD_PAYMENT,Current,2023-03-15 20:01:20,2023-03-17 20:29:56,Amazon,-20.32,0,EUR,COMPLETED,245.09
TRANSFER,Current,2023-03-17 21:40:58,2023-03-17 21:40:58,To EUR Savings,-0.51,0,EUR,COMPLETED,244.58
TRANSFER,Current,2023-03-18 08:14:20,2023-03-18 08:14:20,To EUR Savings,-0.45,0,EUR,COMPLETED,244.13
TRANSFER,Current,2023-03-18 15:24:43,2023-03-18 15:24:43,To EUR Savings,-1,0,EUR,COMPLETED,243.13
TRANSFER,Current,2023-03-18 17:37:47,2023-03-18 17:37:47,To EUR Savings,-0.2,0,EUR,COMPLETED,242.93
TRANSFER,Current,2023-03-18 20:07:01,2023-03-18 20:07:01,To EUR Savings,-0.8,0,EUR,COMPLETED,242.13
TRANSFER,Current,2023-03-19 08:04:04,2023-03-19 08:04:04,To EUR Savings,-0.1,0,EUR,COMPLETED,242.03
TRANSFER,Current,2023-03-19 08:46:07,2023-03-19 08:46:07,To EUR Savings,-0.81,0,EUR,COMPLETED,241.22
TRANSFER,Current,2023-03-19 09:15:55,2023-03-19 09:15:55,To EUR Savings,-0.12,0,EUR,COMPLETED,241.1
TRANSFER,Current,2023-03-19 10:47:44,2023-03-19 10:47:44,To EUR Savings,-1,0,EUR,COMPLETED,240.1
TRANSFER,Current,2023-03-19 11:15:19,2023-03-19 11:15:19,To EUR Savings,-0.83,0,EUR,COMPLETED,239.27
CARD_PAYMENT,Current,2023-03-20 08:32:14,,Amazon,-20.32,0,EUR,REVERTED,
TRANSFER,Current,2023-03-20 08:32:14,2023-03-20 08:32:14,To EUR Savings,-0.68,0,EUR,COMPLETED,238.59
TRANSFER,Current,2023-03-20 09:19:11,2023-03-20 09:19:11,To EUR Savings,-20,0,EUR,COMPLETED,218.59
CARD_PAYMENT,Current,2023-03-18 08:14:20,2023-03-20 21:14:11,Pad Port Miraflores,-3.55,0,EUR,COMPLETED,215.04
CARD_PAYMENT,Current,2023-03-18 17:37:46,2023-03-20 21:15:09,Gelados Santini,-7.8,0,EUR,COMPLETED,207.24
CARD_PAYMENT,Current,2023-03-17 21:40:58,2023-03-20 21:47:43,YouTube,-8.49,0,EUR,COMPLETED,198.75
CARD_PAYMENT,Current,2023-03-18 15:24:43,2023-03-20 22:19:43,Nos Cinemas,-15,0,EUR,COMPLETED,183.75
TOPUP,Current,2023-03-20 22:36:05,2023-03-20 22:36:10,Apple Pay Top-Up by *6660,200,0,EUR,COMPLETED,383.75
CARD_PAYMENT,Current,2023-03-18 20:07:01,2023-03-20 23:46:42,Cantinho Estrela,-8.2,0,EUR,COMPLETED,375.55
CARD_PAYMENT,Current,2023-03-19 08:04:04,2023-03-20 23:47:05,Carnaxide Wtc,-1.9,0,EUR,COMPLETED,373.65
CARD_PAYMENT,Current,2023-03-19 08:46:07,2023-03-20 23:47:08,Carnaxide Wtc,-4.19,0,EUR,COMPLETED,369.46
CARD_PAYMENT,Current,2023-03-19 09:15:54,2023-03-20 23:47:08,Pingo Doce,-29.88,0,EUR,COMPLETED,339.58
CARD_PAYMENT,Current,2023-03-19 11:15:18,2023-03-20 23:47:15,Leroy Merlin,-18.17,0,EUR,COMPLETED,321.41
CARD_PAYMENT,Current,2023-03-19 10:47:43,2023-03-21 00:23:31,Smallpdf.com,-10,0,EUR,COMPLETED,311.41
TRANSFER,Current,2023-03-21 21:00:17,2023-03-21 21:00:17,To EUR Savings,-1,0,EUR,COMPLETED,310.41
CARD_PAYMENT,Current,2023-03-21 21:00:17,2023-03-22 13:11:16,Miió,-20,0,EUR,COMPLETED,290.41
TRANSFER,Current,2023-03-22 14:02:33,2023-03-22 14:02:33,To EUR Savings,-0.01,0,EUR,COMPLETED,290.4
CARD_PAYMENT,Current,2023-03-22 14:02:32,2023-03-23 09:31:25,Apple,-2.99,0,EUR,COMPLETED,287.41
TRANSFER,Current,2023-03-23 17:04:27,2023-03-23 17:04:27,To EUR Savings,-0.05,0,EUR,COMPLETED,287.36
CARD_PAYMENT,Current,2023-03-23 17:01:37,2023-03-24 12:13:50,Pad Port Miraflores,-3.95,0,EUR,COMPLETED,283.41
TRANSFER,Current,2023-03-25 08:20:09,2023-03-25 08:20:09,To EUR Savings,-0.1,0,EUR,COMPLETED,283.31
TRANSFER,Current,2023-03-26 08:26:16,2023-03-26 08:26:16,To EUR Savings,-0.45,0,EUR,COMPLETED,282.86
TOPUP,Current,2023-03-26 08:26:56,2023-03-26 08:26:59,Apple Pay Top-Up by *6660,200,0,EUR,COMPLETED,482.86
TRANSFER,Current,2023-03-26 09:15:26,2023-03-26 09:15:26,To EUR Savings,-0.94,0,EUR,COMPLETED,481.92
CARD_PAYMENT,Current,2023-03-25 08:20:09,2023-03-26 13:49:18,Carnaxide Wtc,-1.9,0,EUR,COMPLETED,480.02
TRANSFER,Current,2023-03-26 15:23:19,2023-03-26 15:23:19,To EUR Savings,-0.4,0,EUR,COMPLETED,479.62
TRANSFER,Current,2023-03-27 00:32:25,2023-03-27 00:32:25,To EUR Savings,-0.01,0,EUR,COMPLETED,479.61
TRANSFER,Current,2023-03-27 00:33:32,2023-03-27 00:33:32,To EUR Savings,-0.51,0,EUR,COMPLETED,479.1
TRANSFER,Current,2023-03-27 10:17:52,2023-03-27 10:17:52,To EUR Savings,-20,0,EUR,COMPLETED,459.1
CARD_PAYMENT,Current,2023-03-26 09:15:26,2023-03-27 10:55:12,Pingo Doce,-26.06,0,EUR,COMPLETED,433.04
CARD_PAYMENT,Current,2023-03-26 08:26:16,2023-03-27 10:56:51,Pad Port Miraflores,-3.55,0,EUR,COMPLETED,429.49
CARD_PAYMENT,Current,2023-03-26 15:23:19,2023-03-27 10:57:11,Tricana,-68.6,0,EUR,COMPLETED,360.89
CARD_PAYMENT,Current,2023-03-27 00:32:24,2023-03-28 09:00:38,Apple,-1.99,0,EUR,COMPLETED,358.9
CARD_PAYMENT,Current,2023-03-27 00:33:32,2023-03-28 09:05:25,Apple,-5.49,0,EUR,COMPLETED,353.41
TRANSFER,Current,2023-03-28 11:29:46,2023-03-28 11:29:46,To EUR Savings,-1,0,EUR,COMPLETED,352.41
TRANSFER,Current,2023-03-28 14:03:44,2023-03-28 14:03:44,To EUR Savings,-0.01,0,EUR,COMPLETED,352.4
TRANSFER,Current,2023-03-28 21:58:49,2023-03-28 21:58:49,To EUR Savings,-0.01,0,EUR,COMPLETED,352.39
CARD_PAYMENT,Current,2023-03-28 11:29:45,2023-03-29 09:22:05,Clinica Medica E,-70,0,EUR,COMPLETED,282.39
CARD_PAYMENT,Current,2023-03-28 14:03:43,2023-03-29 09:36:11,Google,-2.99,0,EUR,COMPLETED,279.4
TRANSFER,Current,2023-03-29 11:04:31,2023-03-29 11:04:31,To EUR Savings,-0.01,0,EUR,COMPLETED,279.39
CARD_PAYMENT,Current,2023-03-28 21:58:48,2023-03-30 09:32:21,Apple,-6.99,0,EUR,COMPLETED,272.4
CARD_PAYMENT,Current,2023-03-29 11:04:30,2023-03-30 09:40:00,PayPal,-59.99,0,EUR,COMPLETED,212.41
TRANSFER,Current,2023-03-30 13:09:49,2023-03-30 13:09:49,To EUR Savings,-1,0,EUR,COMPLETED,211.41
CARD_PAYMENT,Current,2023-03-30 13:09:46,2023-03-31 10:25:57,Jc Clinicas Medicas,-17,0,EUR,COMPLETED,194.41
TRANSFER,Current,2023-03-31 19:42:44,2023-03-31 19:42:44,To EUR Savings,-0.5,0,EUR,COMPLETED,193.91
TRANSFER,Current,2023-04-01 08:10:30,2023-04-01 08:10:30,To EUR Savings,-0.45,0,EUR,COMPLETED,193.46
TRANSFER,Current,2023-04-01 12:46:07,2023-04-01 12:46:07,To EUR Savings,-0.95,0,EUR,COMPLETED,192.51
TRANSFER,Current,2023-04-02 08:30:36,2023-04-02 08:30:36,To EUR Savings,-0.1,0,EUR,COMPLETED,192.41
TRANSFER,Current,2023-04-02 09:10:14,2023-04-02 09:10:14,To EUR Savings,-0.92,0,EUR,COMPLETED,191.49
CARD_PAYMENT,Current,2023-03-31 19:42:43,2023-04-02 10:07:41,Uber Eats,-16.5,0,EUR,COMPLETED,174.99
CARD_PAYMENT,Current,2023-04-01 12:46:07,2023-04-02 10:55:34,Uber Eats,-17.05,0,EUR,COMPLETED,157.94
CARD_PAYMENT,Current,2023-04-01 08:10:30,2023-04-02 11:35:12,Pad Port Miraflores,-3.55,0,EUR,COMPLETED,154.39
TRANSFER,Current,2023-04-02 14:49:58,2023-04-02 14:49:58,To EUR Savings,-0.5,0,EUR,COMPLETED,153.89
TOPUP,Current,2023-04-02 18:03:44,2023-04-02 18:03:47,Apple Pay Top-Up by *6660,200,0,EUR,COMPLETED,353.89
TRANSFER,Current,2023-04-03 10:19:53,2023-04-03 10:19:53,To EUR Savings,-20,0,EUR,COMPLETED,333.89
CARD_PAYMENT,Current,2023-04-02 09:10:14,2023-04-03 11:34:27,Pingo Doce,-20.08,0,EUR,COMPLETED,313.81
CARD_PAYMENT,Current,2023-04-02 14:49:57,2023-04-03 11:35:18,Verbasco Rest,-74.5,0,EUR,COMPLETED,239.31
CARD_PAYMENT,Current,2023-04-02 08:30:36,2023-04-03 11:36:02,Carnaxide Wtc,-1.9,0,EUR,COMPLETED,237.41
TRANSFER,Current,2023-04-04 08:53:54,2023-04-04 08:53:54,To EUR Savings,-0.66,0,EUR,COMPLETED,236.75
TRANSFER,Current,2023-04-04 12:04:57,2023-04-04 12:04:57,To EUR Savings,-0.43,0,EUR,COMPLETED,236.32
TRANSFER,Current,2023-04-05 08:47:15,2023-04-05 08:47:15,To EUR Savings,-0.2,0,EUR,COMPLETED,236.12
CARD_PAYMENT,Current,2023-04-04 08:53:54,2023-04-05 09:24:07,Uber,-12.59,0,EUR,COMPLETED,223.53
CARD_PAYMENT,Current,2023-04-04 12:04:57,2023-04-05 09:29:49,Uber,-10.57,0,EUR,COMPLETED,212.96
CARD_PAYMENT,Current,2023-04-05 08:47:15,2023-04-06 10:33:38,Minipreço,-7.8,0,EUR,COMPLETED,205.16
TRANSFER,Current,2023-04-06 13:55:51,2023-04-06 13:55:51,To EUR,1028.31,0,EUR,COMPLETED,1233.47
TRANSFER,Current,2023-04-06 13:58:57,2023-04-06 13:58:57,To EUR Savings,-0.69,0,EUR,COMPLETED,1232.78
TOPUP,Current,2023-04-06 13:59:50,2023-04-06 13:59:56,Apple Pay Top-Up by *6660,200,0,EUR,COMPLETED,1432.78
TRANSFER,Current,2023-04-06 15:42:19,2023-04-06 15:42:19,To EUR Savings,-0.56,0,EUR,COMPLETED,1432.22
TRANSFER,Current,2023-04-07 00:21:21,2023-04-07 00:21:21,To EUR Savings,-0.8,0,EUR,COMPLETED,1431.42
CARD_PAYMENT,Current,2023-04-07 01:04:00,,EVIO,-5,0,EUR,REVERTED,
CARD_PAYMENT,Current,2023-04-07 01:04:00,,EVIO,-5,0,EUR,REVERTED,
CARD_PAYMENT,Current,2023-04-07 01:04:00,,EVIO,-5,0,EUR,REVERTED,
TRANSFER,Current,2023-04-07 01:04:00,2023-04-07 01:04:00,To EUR Savings,-1,0,EUR,COMPLETED,1430.42
TRANSFER,Current,2023-04-07 01:04:00,2023-04-07 01:04:00,To EUR Savings,-1,0,EUR,COMPLETED,1429.42
TRANSFER,Current,2023-04-07 01:04:00,2023-04-07 01:04:00,To EUR Savings,-1,0,EUR,COMPLETED,1428.42
TRANSFER,Current,2023-04-07 08:19:37,2023-04-07 08:19:37,To EUR Savings,-1,0,EUR,COMPLETED,1427.42
TRANSFER,Current,2023-04-07 08:27:08,2023-04-07 08:27:08,To EUR Savings,-0.45,0,EUR,COMPLETED,1426.97
CARD_PAYMENT,Current,2023-04-06 13:58:55,2023-04-07 10:24:19,Chargeguru,-1028.31,0,EUR,COMPLETED,398.66
TRANSFER,Current,2023-04-07 20:24:44,2023-04-07 20:24:44,To EUR Savings,-0.31,0,EUR,COMPLETED,398.35
TRANSFER,Current,2023-04-08 08:28:49,2023-04-08 08:28:49,To EUR Savings,-0.1,0,EUR,COMPLETED,398.25
TOPUP,Current,2023-04-08 08:50:33,2023-04-08 08:50:38,Apple Pay Top-Up by *6660,200,0,EUR,COMPLETED,598.25
CARD_PAYMENT,Current,2023-04-07 08:19:37,2023-04-08 09:15:59,Miió,-50,0,EUR,COMPLETED,548.25
TRANSFER,Current,2023-04-08 09:18:05,2023-04-08 09:18:05,To EUR Savings,-0.89,0,EUR,COMPLETED,547.36
CARD_PAYMENT,Current,2023-04-07 00:21:21,2023-04-08 10:28:21,Amadeu Batista E,-84.2,0,EUR,COMPLETED,463.16
TRANSFER,Current,2023-04-08 14:51:23,2023-04-08 14:51:23,To EUR Savings,-1,0,EUR,COMPLETED,462.16
TRANSFER,Current,2023-04-08 15:36:45,2023-04-08 15:36:45,To EUR Savings,-0.01,0,EUR,COMPLETED,462.15
TRANSFER,Current,2023-04-08 18:22:38,2023-04-08 18:22:38,To EUR Savings,-1,0,EUR,COMPLETED,461.15
TRANSFER,Current,2023-04-09 08:21:04,2023-04-09 08:21:04,To EUR Savings,-0.1,0,EUR,COMPLETED,461.05
TRANSFER,Current,2023-04-09 09:01:47,2023-04-09 09:01:47,To EUR Savings,-0.01,0,EUR,COMPLETED,461.04
TRANSFER,Current,2023-04-09 09:15:53,2023-04-09 09:15:53,To EUR Savings,-0.05,0,EUR,COMPLETED,460.99
TRANSFER,Current,2023-04-09 09:31:35,2023-04-09 09:31:35,To EUR Savings,-0.02,0,EUR,COMPLETED,460.97
CARD_PAYMENT,Current,2023-04-07 08:27:08,2023-04-09 09:43:33,Pad Port Miraflores,-3.55,0,EUR,COMPLETED,457.42
CARD_PAYMENT,Current,2023-04-07 20:24:44,2023-04-09 09:55:00,Uber Eats,-43.69,0,EUR,COMPLETED,413.73
CARD_PAYMENT,Current,2023-04-08 15:36:44,2023-04-09 10:12:05,Google,-19.99,0,EUR,COMPLETED,393.74
CARD_PAYMENT,Current,2023-04-08 18:22:38,2023-04-09 12:40:45,IKEA,-7,0,EUR,COMPLETED,386.74
TRANSFER,Current,2023-04-09 17:16:00,2023-04-09 17:16:00,To EUR Savings,-1,0,EUR,COMPLETED,385.74
CARD_PAYMENT,Current,2023-04-08 14:51:23,2023-04-10 08:33:11,Nata Do Bairro,-9,0,EUR,COMPLETED,376.74
CARD_PAYMENT,Current,2023-04-08 08:28:49,2023-04-10 08:34:04,Carnaxide Wtc,-1.9,0,EUR,COMPLETED,374.84
CARD_PAYMENT,Current,2023-04-08 09:18:05,2023-04-10 08:34:20,Pingo Doce,-38.11,0,EUR,COMPLETED,336.73
CARD_PAYMENT,Current,2023-04-09 09:01:47,2023-04-10 09:18:35,Apple,-19.99,0,EUR,COMPLETED,316.74
CARD_PAYMENT,Current,2023-04-09 17:16:00,2023-04-10 09:23:23,Ventura Licitra,-3,0,EUR,COMPLETED,313.74
CARD_PAYMENT,Current,2023-04-06 15:42:18,2023-04-10 09:36:08,Amazon,-18.44,0,EUR,COMPLETED,295.3
TRANSFER,Current,2023-04-10 10:22:01,2023-04-10 10:22:01,To EUR Savings,-20,0,EUR,COMPLETED,275.3
CARD_PAYMENT,Current,2023-04-09 09:15:52,2023-04-10 10:40:58,Gleba,-4.95,0,EUR,COMPLETED,270.35
CARD_PAYMENT,Current,2023-04-09 09:31:34,2023-04-10 10:40:58,Carnaxide Wtc,-9.98,0,EUR,COMPLETED,260.37
CARD_PAYMENT,Current,2023-04-09 08:21:04,2023-04-10 10:41:58,Carnaxide Wtc,-1.9,0,EUR,COMPLETED,258.47
TRANSFER,Current,2023-04-13 19:16:06,2023-04-13 19:16:06,To EUR Savings,-0.71,0,EUR,COMPLETED,257.76
TOPUP,Current,2023-04-14 08:26:17,2023-04-14 08:26:19,Apple Pay Top-Up by *6660,200,0,EUR,COMPLETED,457.76
TRANSFER,Current,2023-04-14 13:31:15,2023-04-14 13:31:15,To EUR Savings,-0.46,0,EUR,COMPLETED,457.3
TRANSFER,Current,2023-04-15 08:04:18,2023-04-15 08:04:18,To EUR Savings,-0.45,0,EUR,COMPLETED,456.85
CARD_PAYMENT,Current,2023-04-14 13:31:15,2023-04-15 10:12:42,Uber Eats,-33.54,0,EUR,COMPLETED,423.31
CARD_PAYMENT,Current,2023-04-13 19:16:06,2023-04-15 10:19:56,Uber Eats,-19.29,0,EUR,COMPLETED,404.02
TRANSFER,Current,2023-04-15 14:49:53,2023-04-15 14:49:53,To EUR Savings,-1,0,EUR,COMPLETED,403.02
TRANSFER,Current,2023-04-15 21:06:16,2023-04-15 21:06:16,To EUR Savings,-0.7,0,EUR,COMPLETED,402.32
TRANSFER,Current,2023-04-16 10:09:03,2023-04-16 10:09:03,To EUR Savings,-0.75,0,EUR,COMPLETED,401.57
TRANSFER,Current,2023-04-16 10:35:23,2023-04-16 10:35:23,To EUR Savings,-1,0,EUR,COMPLETED,400.57
TRANSFER,Current,2023-04-16 13:55:28,2023-04-16 13:55:28,To EUR Savings,-0.9,0,EUR,COMPLETED,399.67
TRANSFER,Current,2023-04-16 16:06:47,2023-04-16 16:06:47,To EUR Savings,-1,0,EUR,COMPLETED,398.67
TRANSFER,Current,2023-04-16 20:07:37,2023-04-16 20:07:37,To EUR Savings,-0.05,0,EUR,COMPLETED,398.62
CARD_PAYMENT,Current,2023-04-15 08:04:17,2023-04-17 08:46:18,Pad Port Miraflores,-3.55,0,EUR,COMPLETED,395.07
CARD_PAYMENT,Current,2023-04-15 14:49:47,2023-04-17 08:46:30,Pensao Rest Floresta,-61,0,EUR,COMPLETED,334.07
TOPUP,Current,2023-04-17 08:50:37,2023-04-17 08:50:43,Apple Pay Top-Up by *6660,200,0,EUR,COMPLETED,534.07
CARD_PAYMENT,Current,2023-04-15 21:06:16,2023-04-17 09:41:32,Alvaros Cafe Unipess,-38.3,0,EUR,COMPLETED,495.77
CARD_PAYMENT,Current,2023-04-16 10:09:03,2023-04-17 09:41:51,Oleigois,-10.25,0,EUR,COMPLETED,485.52
CARD_PAYMENT,Current,2023-04-16 13:55:28,2023-04-17 09:41:54,Cafe Rest Beira Rio,-40.1,0,EUR,COMPLETED,445.42
CARD_PAYMENT,Current,2023-04-16 10:35:23,2023-04-17 09:41:54,Irmaos Figueiredos,-70,0,EUR,COMPLETED,375.42
CARD_PAYMENT,Current,2023-04-16 16:06:46,2023-04-17 09:41:58,A Piriquita Da N2,-6,0,EUR,COMPLETED,369.42
TRANSFER,Current,2023-04-17 10:16:03,2023-04-17 10:16:03,To EUR Savings,-20,0,EUR,COMPLETED,349.42
CARD_PAYMENT,Current,2023-04-16 20:07:36,2023-04-17 11:10:49,Brisa,-6.95,0,EUR,COMPLETED,342.47
TRANSFER,Current,2023-04-17 21:40:58,2023-04-17 21:40:58,To EUR Savings,-0.51,0,EUR,COMPLETED,341.96
TRANSFER,Current,2023-04-18 16:58:45,2023-04-18 16:58:45,To EUR Savings,-1,0,EUR,COMPLETED,340.96
CARD_PAYMENT,Current,2023-04-17 21:40:58,2023-04-19 09:55:03,YouTube,-8.49,0,EUR,COMPLETED,332.47
CARD_PAYMENT,Current,2023-04-18 16:58:45,2023-04-19 09:56:58,Miió,-50,0,EUR,COMPLETED,282.47
TRANSFER,Current,2023-04-19 14:00:09,2023-04-19 14:00:09,To EUR Savings,-1,0,EUR,COMPLETED,281.47
TRANSFER,Current,2023-04-20 07:41:24,2023-04-20 07:41:24,To EUR Savings,-0.45,0,EUR,COMPLETED,281.02
CARD_PAYMENT,Current,2023-04-19 14:00:08,2023-04-20 10:18:33,Rest Boca Do Mar,-25,0,EUR,COMPLETED,256.02
TRANSFER,Current,2023-04-20 12:45:44,2023-04-20 12:45:44,To EUR Savings,-0.95,0,EUR,COMPLETED,255.07
CARD_PAYMENT,Current,2023-04-20 12:45:44,2023-04-21 10:28:47,Uber Eats,-17.05,0,EUR,COMPLETED,238.02
CARD_PAYMENT,Current,2023-04-20 07:41:23,2023-04-21 12:57:33,Pad Port Miraflores,-3.55,0,EUR,COMPLETED,234.47
TRANSFER,Current,2023-04-22 08:17:29,2023-04-22 08:17:29,To EUR Savings,-0.1,0,EUR,COMPLETED,234.37
TRANSFER,Current,2023-04-22 09:10:27,2023-04-22 09:10:27,To EUR Savings,-0.55,0,EUR,COMPLETED,233.82
TRANSFER,Current,2023-04-22 09:30:50,2023-04-22 09:30:50,To EUR Savings,-0.82,0,EUR,COMPLETED,233
TRANSFER,Current,2023-04-22 13:47:17,2023-04-22 13:47:17,To EUR Savings,-1,0,EUR,COMPLETED,232
TRANSFER,Current,2023-04-22 15:02:42,2023-04-22 15:02:42,To EUR Savings,-0.01,0,EUR,COMPLETED,231.99
TRANSFER,Current,2023-04-22 15:14:35,2023-04-22 15:14:35,To EUR Savings,-0.2,0,EUR,COMPLETED,231.79
TRANSFER,Current,2023-04-23 08:29:35,2023-04-23 08:29:35,To EUR Savings,-0.1,0,EUR,COMPLETED,231.69
CARD_PAYMENT,Current,2023-04-22 15:02:37,2023-04-23 10:43:57,Apple,-2.99,0,EUR,COMPLETED,228.7
CARD_PAYMENT,Current,2023-04-22 09:30:50,2023-04-23 12:20:07,Pingo Doce,-26.18,0,EUR,COMPLETED,202.52
CARD_PAYMENT,Current,2023-04-22 09:10:27,2023-04-23 12:20:07,Auchan,-42.45,0,EUR,COMPLETED,160.07
CARD_PAYMENT,Current,2023-04-22 08:17:29,2023-04-23 12:20:34,Carnaxide Wtc,-1.9,0,EUR,COMPLETED,158.17
CARD_PAYMENT,Current,2023-04-22 13:47:17,2023-04-23 12:20:39,Saisish,-25,0,EUR,COMPLETED,133.17
CARD_PAYMENT,Current,2023-04-22 15:14:33,2023-04-23 12:20:49,Santini,-7.8,0,EUR,COMPLETED,125.37
TOPUP,Current,2023-04-23 18:01:15,2023-04-23 18:01:18,Apple Pay Top-Up by *6660,200,0,EUR,COMPLETED,325.37
TRANSFER,Current,2023-04-24 10:15:51,2023-04-24 10:15:51,To EUR Savings,-20,0,EUR,COMPLETED,305.37
CARD_PAYMENT,Current,2023-04-23 08:29:35,2023-04-24 11:28:37,Carnaxide Wtc,-1.9,0,EUR,COMPLETED,303.47
CARD_PAYMENT,Current,2023-04-24 17:59:18,,OpenAI,-4.54,0,EUR,REVERTED,
TRANSFER,Current,2023-04-24 17:59:19,2023-04-24 17:59:19,To EUR Savings,-0.46,0,EUR,COMPLETED,303.01
TRANSFER,Current,2023-04-25 08:09:41,2023-04-25 08:09:41,To EUR Savings,-1,0,EUR,COMPLETED,302.01
TRANSFER,Current,2023-04-25 08:14:15,2023-04-25 08:14:15,To EUR Savings,-0.45,0,EUR,COMPLETED,301.56
TRANSFER,Current,2023-04-25 15:01:27,2023-04-25 15:01:27,To EUR Savings,-0.4,0,EUR,COMPLETED,301.16
TOPUP,Current,2023-04-25 21:58:55,2023-04-25 21:59:00,Apple Pay Top-Up by *6660,200,0,EUR,COMPLETED,501.16
CARD_PAYMENT,Current,2023-04-25 08:09:41,2023-04-26 09:47:53,Miió,-50,0,EUR,COMPLETED,451.16
CARD_PAYMENT,Current,2023-04-25 15:01:27,2023-04-26 12:26:41,Restaurante Mammy,-70.6,0,EUR,COMPLETED,380.56
CARD_PAYMENT,Current,2023-04-25 08:14:15,2023-04-26 12:28:01,Pad Port Miraflores,-3.55,0,EUR,COMPLETED,377.01
TRANSFER,Current,2023-04-27 00:32:45,2023-04-27 00:32:45,To EUR Savings,-0.01,0,EUR,COMPLETED,377
TRANSFER,Current,2023-04-27 00:33:37,2023-04-27 00:33:37,To EUR Savings,-0.51,0,EUR,COMPLETED,376.49
TRANSFER,Current,2023-04-27 13:06:45,2023-04-27 13:06:45,To EUR Savings,-0.95,0,EUR,COMPLETED,375.54
CARD_PAYMENT,Current,2023-04-27 13:06:41,2023-04-28 10:19:51,Uber Eats,-17.05,0,EUR,COMPLETED,358.49
CARD_PAYMENT,Current,2023-04-27 00:32:45,2023-04-28 10:27:30,Apple,-1.99,0,EUR,COMPLETED,356.5
CARD_PAYMENT,Current,2023-04-27 00:33:35,2023-04-28 10:27:30,Apple,-5.49,0,EUR,COMPLETED,351.01
TRANSFER,Current,2023-04-28 13:59:37,2023-04-28 13:59:37,To EUR Savings,-0.01,0,EUR,COMPLETED,351
TRANSFER,Current,2023-04-28 14:03:54,2023-04-28 14:03:54,To EUR Savings,-0.01,0,EUR,COMPLETED,350.99
TRANSFER,Current,2023-04-29 08:28:40,2023-04-29 08:28:40,To EUR Savings,-0.05,0,EUR,COMPLETED,350.94
CARD_PAYMENT,Current,2023-04-28 13:59:02,2023-04-29 11:01:08,Apple,-6.99,0,EUR,COMPLETED,343.95
CARD_PAYMENT,Current,2023-04-28 14:03:43,2023-04-29 11:01:21,Google,-2.99,0,EUR,COMPLETED,340.96
TRANSFER,Current,2023-04-29 11:56:58,2023-04-29 11:56:58,To EUR Savings,-0.39,0,EUR,COMPLETED,340.57
TRANSFER,Current,2023-04-29 20:43:28,2023-04-29 20:43:28,To EUR Savings,-0.35,0,EUR,COMPLETED,340.22
TRANSFER,Current,2023-04-30 08:17:44,2023-04-30 08:17:44,To EUR Savings,-0.1,0,EUR,COMPLETED,340.12
CARD_PAYMENT,Current,2023-04-29 11:56:57,2023-04-30 10:53:08,Minipreço,-5.61,0,EUR,COMPLETED,334.51
TRANSFER,Current,2023-04-30 19:56:49,2023-04-30 19:56:49,To EUR Savings,-0.1,0,EUR,COMPLETED,334.41
TOPUP,Current,2023-04-30 21:26:36,2023-04-30 21:26:39,Apple Pay Top-Up by *6660,200,0,EUR,COMPLETED,534.41
TRANSFER,Current,2023-05-01 08:16:38,2023-05-01 08:16:38,To EUR Savings,-0.1,0,EUR,COMPLETED,534.31
CARD_PAYMENT,Current,2023-04-29 20:43:28,2023-05-01 10:02:43,Vira Frangosvira Fra,-51.65,0,EUR,COMPLETED,482.66
CARD_PAYMENT,Current,2023-04-29 08:28:40,2023-05-01 10:08:20,Pad Port Miraflores,-3.95,0,EUR,COMPLETED,478.71
CARD_PAYMENT,Current,2023-04-30 19:56:49,2023-05-01 10:56:03,Pingo Doce,-27.9,0,EUR,COMPLETED,450.81
TRANSFER,Current,2023-05-01 10:56:05,2023-05-01 10:56:05,To EUR Savings,-20,0,EUR,COMPLETED,430.81
CARD_PAYMENT,Current,2023-04-30 08:17:44,2023-05-01 10:57:54,Carnaxide Wtc,-1.9,0,EUR,COMPLETED,428.91
CARD_PAYMENT,Current,2023-05-01 13:07:26,,Espaco 20,-21.6,0,EUR,REVERTED,
TRANSFER,Current,2023-05-01 13:07:26,2023-05-01 13:07:26,To EUR Savings,-0.4,0,EUR,COMPLETED,428.51
TRANSFER,Current,2023-05-01 14:41:01,2023-05-01 14:41:01,To EUR Savings,-0.44,0,EUR,COMPLETED,428.07
CARD_PAYMENT,Current,2023-05-01 08:16:38,2023-05-02 11:01:15,Carnaxide Wtc,-1.9,0,EUR,COMPLETED,426.17
CARD_PAYMENT,Current,2023-05-01 14:41:01,2023-05-02 11:01:40,Aproveitideias,-40.56,0,EUR,COMPLETED,385.61
TRANSFER,Current,2023-05-03 09:35:50,2023-05-03 09:35:50,To EUR Savings,-0.62,0,EUR,COMPLETED,384.99
CARD_PAYMENT,Current,2023-05-03 09:35:50,2023-05-04 10:27:56,Google,-11.38,0,EUR,COMPLETED,373.61
TRANSFER,Current,2023-05-04 13:05:48,2023-05-04 13:05:48,To EUR Savings,-0.46,0,EUR,COMPLETED,373.15
CARD_PAYMENT,Current,2023-05-04 13:05:47,2023-05-05 10:47:11,Uber Eats,-34.54,0,EUR,COMPLETED,338.61
TRANSFER,Current,2023-05-05 23:43:02,2023-05-05 23:43:02,To EUR Savings,-1,0,EUR,COMPLETED,337.61
TRANSFER,Current,2023-05-06 08:28:41,2023-05-06 08:28:41,To EUR Savings,-0.45,0,EUR,COMPLETED,337.16
CARD_PAYMENT,Current,2023-05-05 23:43:02,2023-05-06 14:06:59,Miió,-20,0,EUR,COMPLETED,317.16
TRANSFER,Current,2023-05-06 17:23:32,2023-05-06 17:23:32,To EUR Savings,-0.77,0,EUR,COMPLETED,316.39
TRANSFER,Current,2023-05-07 08:30:55,2023-05-07 08:30:55,To EUR Savings,-0.1,0,EUR,COMPLETED,316.29
CARD_PAYMENT,Current,2023-05-06 17:23:32,2023-05-07 11:09:41,Minipreço,-7.23,0,EUR,COMPLETED,309.06
CARD_PAYMENT,Current,2023-05-06 08:28:40,2023-05-08 09:44:20,Pad Port Miraflores,-3.55,0,EUR,COMPLETED,305.51
TRANSFER,Current,2023-05-08 10:17:53,2023-05-08 10:17:53,To EUR Savings,-20,0,EUR,COMPLETED,285.51
CARD_PAYMENT,Current,2023-05-07 08:30:55,2023-05-08 12:22:00,Carnaxide Wtc,-1.9,0,EUR,COMPLETED,283.61
TRANSFER,Current,2023-05-09 13:56:50,2023-05-09 13:56:50,To EUR Savings,-0.7,0,EUR,COMPLETED,282.91
TRANSFER,Current,2023-05-10 07:51:04,2023-05-10 07:51:04,To EUR Savings,-1,0,EUR,COMPLETED,281.91
TRANSFER,Current,2023-05-10 08:01:25,2023-05-10 08:01:25,To EUR Savings,-0.45,0,EUR,COMPLETED,281.46
CARD_PAYMENT,Current,2023-05-09 13:56:49,2023-05-10 13:38:57,Minipreço,-1.3,0,EUR,COMPLETED,280.16
TRANSFER,Current,2023-05-10 14:41:42,2023-05-10 14:41:42,To EUR Savings,-0.1,0,EUR,COMPLETED,280.06
CARD_PAYMENT,Current,2023-05-10 07:51:04,2023-05-11 10:31:43,Miió,-20,0,EUR,COMPLETED,260.06
CARD_PAYMENT,Current,2023-05-10 14:41:42,2023-05-11 10:45:25,Aerofarma Laboratorios S.A.I.C,-2.9,0,EUR,COMPLETED,257.16
CARD_PAYMENT,Current,2023-05-10 08:01:24,2023-05-11 13:46:45,Pad Port Miraflores,-3.55,0,EUR,COMPLETED,253.61
TRANSFER,Current,2023-05-12 13:28:57,2023-05-12 13:28:57,To EUR Savings,-0.41,0,EUR,COMPLETED,253.2
TRANSFER,Current,2023-05-12 19:29:04,2023-05-12 19:29:04,To EUR Savings,-0.01,0,EUR,COMPLETED,253.19
TRANSFER,Current,2023-05-13 13:04:38,2023-05-13 13:04:38,To EUR Savings,-0.86,0,EUR,COMPLETED,252.33
CARD_PAYMENT,Current,2023-05-12 13:28:56,2023-05-13 16:18:14,Center Parcs,-2.59,0,EUR,COMPLETED,249.74
CARD_PAYMENT,Current,2023-05-12 19:29:04,2023-05-13 16:32:57,Hilton,-10.99,0,EUR,COMPLETED,238.75
TRANSFER,Current,2023-05-13 19:02:12,2023-05-13 19:02:12,To EUR Savings,-0.17,0,EUR,COMPLETED,238.58
TOPUP,Current,2023-05-13 19:48:34,2023-05-13 19:48:38,Apple Pay Top-Up by *6660,200,0,EUR,COMPLETED,438.58
TRANSFER,Current,2023-05-13 20:26:51,2023-05-13 20:26:51,To EUR Savings,-0.46,0,EUR,COMPLETED,438.12
TRANSFER,Current,2023-05-14 02:56:03,2023-05-14 02:56:03,To EUR Savings,-0.78,0,EUR,COMPLETED,437.34
TRANSFER,Current,2023-05-14 09:42:24,2023-05-14 09:42:24,To EUR Savings,-0.13,0,EUR,COMPLETED,437.21
TRANSFER,Current,2023-05-14 10:17:23,2023-05-14 10:17:23,To EUR Savings,-0.56,0,EUR,COMPLETED,436.65
CARD_PAYMENT,Current,2023-05-13 20:26:51,2023-05-14 14:58:25,CheeMc Soho,-38.54,0.39,EUR,COMPLETED,397.72
TRANSFER,Current,2023-05-14 15:03:34,2023-05-14 15:03:34,To EUR Savings,-0.77,0,EUR,COMPLETED,396.95
CARD_PAYMENT,Current,2023-05-13 13:04:38,2023-05-14 15:06:06,Sainsbury's,-9.14,0.09,EUR,COMPLETED,387.72
CARD_PAYMENT,Current,2023-05-14 02:56:03,2023-05-14 15:17:06,Transport for London,-8.22,0.08,EUR,COMPLETED,379.42
TRANSFER,Current,2023-05-15 02:27:08,2023-05-15 02:27:08,To EUR Savings,-0.88,0,EUR,COMPLETED,378.54
TOPUP,Current,2023-05-15 08:23:58,2023-05-15 08:24:00,Apple Pay Top-Up by *6660,200,0,EUR,COMPLETED,578.54
TRANSFER,Current,2023-05-15 09:46:49,2023-05-15 09:46:49,To EUR Savings,-0.46,0,EUR,COMPLETED,578.08
TRANSFER,Current,2023-05-15 10:21:19,2023-05-15 10:21:19,To EUR Savings,-20,0,EUR,COMPLETED,558.08
CARD_PAYMENT,Current,2023-05-13 19:02:12,2023-05-15 15:10:32,Uber,-15.83,0.16,EUR,COMPLETED,542.09
CARD_PAYMENT,Current,2023-05-14 10:17:23,2023-05-15 15:13:38,Big Bus Tours,-103.44,1.03,EUR,COMPLETED,437.62
CARD_PAYMENT,Current,2023-05-14 15:03:33,2023-05-15 15:17:00,Caffé Concerto,-61.23,0.61,EUR,COMPLETED,375.78
CARD_PAYMENT,Current,2023-05-15 02:27:08,2023-05-15 16:15:38,Transport for London,-5.12,0,EUR,COMPLETED,370.66
TRANSFER,Current,2023-05-15 19:29:35,2023-05-15 19:29:35,To EUR Savings,-0.54,0,EUR,COMPLETED,370.12
TRANSFER,Current,2023-05-15 19:38:16,2023-05-15 19:38:16,To EUR Savings,-0.52,0,EUR,COMPLETED,369.6
CARD_PAYMENT,Current,2023-05-15 19:38:16,2023-05-16 17:07:50,Tesco,-5.48,0,EUR,COMPLETED,364.12
CARD_PAYMENT,Current,2023-05-15 19:29:35,2023-05-16 17:25:36,Fantasia Grill House,-19.46,0,EUR,COMPLETED,344.66
TRANSFER,Current,2023-05-16 21:44:05,2023-05-16 21:44:05,To EUR Savings,-0.23,0,EUR,COMPLETED,344.43
TRANSFER,Current,2023-05-16 21:47:05,2023-05-16 21:47:05,To EUR Savings,-0.27,0,EUR,COMPLETED,344.16
CARD_PAYMENT,Current,2023-05-16 21:47:04,2023-05-17 15:44:15,Tesco,-1.73,0,EUR,COMPLETED,342.43
TRANSFER,Current,2023-05-17 16:09:29,2023-05-17 16:09:29,To EUR Savings,-0.4,0,EUR,COMPLETED,342.03
CARD_PAYMENT,Current,2023-05-16 21:44:05,2023-05-17 16:13:45,Fantasia Grill House,-18.77,0,EUR,COMPLETED,323.26
TRANSFER,Current,2023-05-17 21:20:13,2023-05-17 21:20:13,To EUR Savings,-0.77,0,EUR,COMPLETED,322.49
TRANSFER,Current,2023-05-17 21:40:58,2023-05-17 21:40:58,To EUR Savings,-0.51,0,EUR,COMPLETED,321.98
TRANSFER,Current,2023-05-18 03:12:55,2023-05-18 03:12:55,To EUR Savings,-0.98,0,EUR,COMPLETED,321
TRANSFER,Current,2023-05-18 12:24:55,2023-05-18 12:24:55,To EUR Savings,-0.21,0,EUR,COMPLETED,320.79
TRANSFER,Current,2023-05-18 15:09:47,2023-05-18 15:09:47,To EUR Savings,-0.88,0,EUR,COMPLETED,319.91
TRANSFER,Current,2023-05-18 15:10:10,2023-05-18 15:10:10,To EUR Savings,-0.39,0,EUR,COMPLETED,319.52
CARD_PAYMENT,Current,2023-05-17 16:09:29,2023-05-18 15:19:34,Tesco,-5.6,0,EUR,COMPLETED,313.92
TRANSFER,Current,2023-05-18 15:35:06,2023-05-18 15:35:06,To EUR Savings,-0.48,0,EUR,COMPLETED,313.44
CARD_PAYMENT,Current,2023-05-17 21:20:13,2023-05-18 16:06:56,Marathon Restaurant,-9.23,0,EUR,COMPLETED,304.21
CARD_PAYMENT,Current,2023-05-18 03:12:55,2023-05-18 16:07:30,Transport for London,-2.02,0,EUR,COMPLETED,302.19
TRANSFER,Current,2023-05-18 16:56:32,2023-05-18 16:56:32,To EUR Savings,-0.7,0,EUR,COMPLETED,301.49
CARD_PAYMENT,Current,2023-05-14 09:42:24,2023-05-18 17:02:59,Hilton,-52.87,0.53,EUR,COMPLETED,248.09
TRANSFER,Current,2023-05-19 03:16:15,2023-05-19 03:16:15,To EUR Savings,-0.66,0,EUR,COMPLETED,247.43
CARD_PAYMENT,Current,2023-05-17 21:40:58,2023-05-19 10:31:41,YouTube,-8.49,0,EUR,COMPLETED,238.94
CARD_PAYMENT,Current,2023-05-18 15:35:06,2023-05-19 15:28:08,WHSmith,-56.52,0,EUR,COMPLETED,182.42
CARD_PAYMENT,Current,2023-05-19 03:16:15,2023-05-19 15:34:06,Transport for London,-15.34,0,EUR,COMPLETED,167.08
CARD_PAYMENT,Current,2023-05-15 09:46:49,2023-05-19 16:45:49,Hilton,-19.54,0,EUR,COMPLETED,147.54
CARD_PAYMENT,Current,2023-05-18 12:24:54,2023-05-19 16:49:22,Heathrowexp,-28.79,0,EUR,COMPLETED,118.75
TRANSFER,Current,2023-05-19 19:13:54,2023-05-19 19:13:54,To EUR Savings,-0.81,0,EUR,COMPLETED,117.94
TOPUP,Current,2023-05-19 19:15:55,2023-05-19 19:15:58,Apple Pay Top-Up by *6660,200,0,EUR,COMPLETED,317.94
TRANSFER,Current,2023-05-20 07:13:22,2023-05-20 07:13:22,To EUR Savings,-1,0,EUR,COMPLETED,316.94
TRANSFER,Current,2023-05-20 07:18:56,2023-05-20 07:18:56,To EUR Savings,-0.45,0,EUR,COMPLETED,316.49
TRANSFER,Current,2023-05-20 09:15:56,2023-05-20 09:15:56,To EUR Savings,-0.27,0,EUR,COMPLETED,316.22
TRANSFER,Current,2023-05-20 09:32:22,2023-05-20 09:32:22,To EUR Savings,-0.05,0,EUR,COMPLETED,316.17
TRANSFER,Current,2023-05-20 11:23:39,2023-05-20 11:23:39,To EUR Savings,-0.72,0,EUR,COMPLETED,315.45
CARD_PAYMENT,Current,2023-05-18 15:09:46,2023-05-20 16:33:05,Pret,-12.12,0,EUR,COMPLETED,303.33
CARD_PAYMENT,Current,2023-05-18 15:10:10,2023-05-20 16:33:05,Pret,-4.61,0,EUR,COMPLETED,298.72
CARD_PAYMENT,Current,2023-05-18 16:56:32,2023-05-20 16:33:05,Pret,-2.3,0,EUR,COMPLETED,296.42
TRANSFER,Current,2023-05-21 08:20:43,2023-05-21 08:20:43,To EUR Savings,-0.1,0,EUR,COMPLETED,296.32
CARD_PAYMENT,Current,2023-05-19 19:13:54,2023-05-21 09:04:00,Uber Eats,-34.19,0,EUR,COMPLETED,262.13
CARD_PAYMENT,Current,2023-05-20 07:13:22,2023-05-21 09:53:54,Miió,-20,0,EUR,COMPLETED,242.13
CARD_PAYMENT,Current,2023-05-20 09:15:55,2023-05-21 10:47:19,Pingo Doce,-41.73,0,EUR,COMPLETED,200.4
CARD_PAYMENT,Current,2023-05-20 09:32:22,2023-05-21 10:47:19,Auchan,-59.95,0,EUR,COMPLETED,140.45
CARD_PAYMENT,Current,2023-05-20 07:18:56,2023-05-21 11:06:09,Pad Port Miraflores,-3.55,0,EUR,COMPLETED,136.9
TRANSFER,Current,2023-05-21 11:07:23,2023-05-21 11:07:23,To EUR,80,0,EUR,COMPLETED,216.9
CARD_PAYMENT,Current,2023-05-20 11:23:38,2023-05-21 15:14:29,GitHub,-9.28,0.09,EUR,COMPLETED,207.53
TRANSFER,Current,2023-05-22 10:15:18,2023-05-22 10:15:18,To EUR Savings,-20,0,EUR,COMPLETED,187.53
CARD_PAYMENT,Current,2023-05-21 08:20:42,2023-05-22 10:49:49,Carnaxide Wtc,-1.9,0,EUR,COMPLETED,185.63
TRANSFER,Current,2023-05-23 08:41:22,2023-05-23 08:41:22,To EUR Savings,-0.06,0,EUR,COMPLETED,185.57
CARD_PAYMENT,Current,2023-05-23 08:41:22,2023-05-24 11:09:59,Minipreço,-0.94,0,EUR,COMPLETED,184.63
TRANSFER,Current,2023-05-24 17:42:49,2023-05-24 17:42:49,To EUR Savings,-1,0,EUR,COMPLETED,183.63
CARD_PAYMENT,Current,2023-05-24 17:42:49,2023-05-25 11:41:44,Tsh Amadora,-19,0,EUR,COMPLETED,164.63
TRANSFER,Current,2023-05-25 12:44:23,2023-05-25 12:44:23,To EUR Savings,-0.85,0,EUR,COMPLETED,163.78
CARD_PAYMENT,Current,2023-05-25 12:44:23,2023-05-26 09:40:31,Uber Eats,-18.15,0,EUR,COMPLETED,145.63
TRANSFER,Current,2023-05-27 00:33:26,2023-05-27 00:33:26,To EUR Savings,-0.01,0,EUR,COMPLETED,145.62
TRANSFER,Current,2023-05-27 00:33:47,2023-05-27 00:33:47,To EUR Savings,-0.51,0,EUR,COMPLETED,145.11
TRANSFER,Current,2023-05-27 08:19:18,2023-05-27 08:19:18,To EUR Savings,-0.6,0,EUR,COMPLETED,144.51
TRANSFER,Current,2023-05-27 12:42:06,2023-05-27 12:42:06,To EUR Savings,-0.04,0,EUR,COMPLETED,144.47
TRANSFER,Current,2023-05-28 08:25:42,2023-05-28 08:25:42,To EUR Savings,-0.1,0,EUR,COMPLETED,144.37
CARD_PAYMENT,Current,2023-05-27 00:33:26,2023-05-28 09:48:09,Apple,-1.99,0,EUR,COMPLETED,142.38
CARD_PAYMENT,Current,2023-05-27 00:33:46,2023-05-28 10:12:08,Apple,-5.49,0,EUR,COMPLETED,136.89
CARD_PAYMENT,Current,2023-05-27 12:42:06,2023-05-28 12:20:58,Minipreço,-18.96,0,EUR,COMPLETED,117.93
TRANSFER,Current,2023-05-28 13:59:15,2023-05-28 13:59:15,To EUR Savings,-0.01,0,EUR,COMPLETED,117.92
TRANSFER,Current,2023-05-28 14:03:41,2023-05-28 14:03:41,To EUR Savings,-0.01,0,EUR,COMPLETED,117.91
CARD_PAYMENT,Current,2023-05-27 08:19:18,2023-05-28 14:47:37,Carnaxide Wtc,-1.4,0,EUR,COMPLETED,116.51
CARD_PAYMENT,Current,2023-05-28 13:59:15,2023-05-29 09:39:48,Apple,-6.99,0,EUR,COMPLETED,109.52
CARD_PAYMENT,Current,2023-05-28 14:03:41,2023-05-29 10:15:11,Google,-2.99,0,EUR,COMPLETED,106.53
TRANSFER,Current,2023-05-29 10:16:21,2023-05-29 10:16:21,To EUR Savings,-20,0,EUR,COMPLETED,86.53
CARD_PAYMENT,Current,2023-05-28 08:25:42,2023-05-29 11:26:14,Carnaxide Wtc,-1.9,0,EUR,COMPLETED,84.63
TOPUP,Current,2023-05-29 16:58:03,2023-05-29 16:58:07,Apple Pay Top-Up by *6660,200,0,EUR,COMPLETED,284.63
TRANSFER,Current,2023-05-30 02:54:16,2023-05-30 02:54:16,To EUR Savings,-0.05,0,EUR,COMPLETED,284.58
TRANSFER,Current,2023-05-30 07:52:20,2023-05-30 07:52:20,To EUR Savings,-0.6,0,EUR,COMPLETED,283.98
TRANSFER,Current,2023-05-30 09:01:14,2023-05-30 09:01:14,To EUR Savings,-1,0,EUR,COMPLETED,282.98
TRANSFER,Current,2023-05-30 13:19:26,2023-05-30 13:19:26,To EUR Savings,-0.1,0,EUR,COMPLETED,282.88
TRANSFER,Current,2023-05-30 20:20:54,2023-05-30 20:20:54,To EUR Savings,-0.3,0,EUR,COMPLETED,282.58
CARD_PAYMENT,Current,2023-05-30 02:54:16,2023-05-31 09:10:56,Apple,-18.95,0,EUR,COMPLETED,263.63
CARD_REFUND,Current,2023-05-30 02:54:19,2023-05-31 09:40:04,Apple,6.76,0,EUR,COMPLETED,270.39
CARD_PAYMENT,Current,2023-05-30 09:01:14,2023-05-31 09:46:40,Miió,-50,0,EUR,COMPLETED,220.39
TOPUP,Current,2023-05-31 09:57:30,2023-05-31 09:57:32,Apple Pay Top-Up by *6660,200,0,EUR,COMPLETED,420.39
CARD_PAYMENT,Current,2023-05-30 13:19:24,2023-05-31 10:49:27,Alvaros Cafe Unipess,-20.9,0,EUR,COMPLETED,399.49
CARD_PAYMENT,Current,2023-05-30 07:52:20,2023-05-31 11:28:44,Brisa,-2.4,0,EUR,COMPLETED,397.09
TRANSFER,Current,2023-06-01 13:01:56,2023-06-01 13:01:56,To EUR Savings,-0.85,0,EUR,COMPLETED,396.24
CARD_PAYMENT,Current,2023-05-30 20:20:54,2023-06-01 14:06:11,Alvaros Cafe Unipess,-21.7,0,EUR,COMPLETED,374.54
TRANSFER,Current,2023-06-01 15:00:00,2023-06-01 15:00:00,To EUR Savings,-0.7,0,EUR,COMPLETED,373.84
TOPUP,Current,2023-06-02 08:41:47,2023-06-02 08:41:50,Apple Pay Top-Up by *6660,400,0,EUR,COMPLETED,773.84
CARD_PAYMENT,Current,2023-06-01 13:01:56,2023-06-02 10:23:02,Uber Eats,-18.15,0,EUR,COMPLETED,755.69
TRANSFER,Current,2023-06-02 12:45:58,2023-06-02 12:45:58,To EUR Savings,-0.71,0,EUR,COMPLETED,754.98
TOPUP,Current,2023-06-02 12:59:51,2023-06-02 12:59:59,Apple Pay Top-Up by *6660,1586.92,0,EUR,COMPLETED,2341.9
TRANSFER,Current,2023-06-02 13:00:17,2023-06-02 13:00:17,To EUR Savings,-0.69,0,EUR,COMPLETED,2341.21
TRANSFER,Current,2023-06-02 19:35:25,2023-06-02 19:35:25,To EUR Savings,-0.5,0,EUR,COMPLETED,2340.71
TRANSFER,Current,2023-06-03 08:11:35,2023-06-03 08:11:35,To EUR Savings,-0.1,0,EUR,COMPLETED,2340.61
CARD_PAYMENT,Current,2023-06-02 13:00:17,2023-06-03 10:06:34,Chargeguru,-1028.31,0,EUR,COMPLETED,1312.3
CARD_PAYMENT,Current,2023-06-02 12:45:58,2023-06-03 10:13:17,Uber Eats,-34.29,0,EUR,COMPLETED,1278.01
TRANSFER,Current,2023-06-03 14:39:01,2023-06-03 14:39:01,To EUR Savings,-1,0,EUR,COMPLETED,1277.01
TRANSFER,Current,2023-06-03 14:44:27,2023-06-03 14:44:27,To EUR Savings,-0.05,0,EUR,COMPLETED,1276.96
TRANSFER,Current,2023-06-03 16:50:50,2023-06-03 16:50:50,To EUR Savings,-0.61,0,EUR,COMPLETED,1276.35
CARD_PAYMENT,Current,2023-06-02 19:35:25,2023-06-03 18:56:59,Jean Louis David,-18.5,0,EUR,COMPLETED,1257.85
TRANSFER,Current,2023-06-03 19:47:07,2023-06-03 19:47:07,To EUR Savings,-0.9,0,EUR,COMPLETED,1256.95
CARD_PAYMENT,Current,2023-06-01 15:00:00,2023-06-04 09:23:00,Booking,-279.3,0,EUR,COMPLETED,977.65
CARD_PAYMENT,Current,2023-06-03 16:50:49,2023-06-04 10:41:39,Ze Do Bacalhau,-5.39,0,EUR,COMPLETED,972.26
CARD_PAYMENT,Current,2023-06-03 14:39:01,2023-06-04 10:41:39,Piparoza Boutique,-119,0,EUR,COMPLETED,853.26
CARD_PAYMENT,Current,2023-06-03 19:47:06,2023-06-04 10:53:25,Evora Hotel,-11.1,0,EUR,COMPLETED,842.16
TRANSFER,Current,2023-06-04 15:12:47,2023-06-04 15:12:47,To EUR Savings,-1,0,EUR,COMPLETED,841.16
CARD_PAYMENT,Current,2023-06-03 14:44:27,2023-06-04 16:34:51,Wu Xiaochuan,-5.95,0,EUR,COMPLETED,835.21
CARD_PAYMENT,Current,2023-06-03 08:11:35,2023-06-04 16:40:11,Carnaxide Wtc,-1.9,0,EUR,COMPLETED,833.31
TRANSFER,Current,2023-06-04 20:17:15,2023-06-04 20:17:15,To EUR Savings,-0.84,0,EUR,COMPLETED,832.47
TRANSFER,Current,2023-06-05 10:21:19,2023-06-05 10:21:19,To EUR Savings,-20,0,EUR,COMPLETED,812.47
CARD_PAYMENT,Current,2023-06-04 15:12:47,2023-06-05 11:15:31,Cafe Boavista,-24,0,EUR,COMPLETED,788.47
CARD_PAYMENT,Current,2023-06-04 20:17:15,2023-06-06 11:50:29,Pingo Doce,-43.16,0,EUR,COMPLETED,745.31
TRANSFER,Current,2023-06-08 08:23:57,2023-06-08 08:23:57,To EUR Savings,-0.1,0,EUR,COMPLETED,745.21
CARD_PAYMENT,Current,2023-06-08 08:23:57,2023-06-09 12:15:17,Carnaxide Wtc,-1.9,0,EUR,COMPLETED,743.31
TRANSFER,Current,2023-06-09 12:48:14,2023-06-09 12:48:14,To EUR Savings,-0.71,0,EUR,COMPLETED,742.6
TRANSFER,Current,2023-06-10 08:11:21,2023-06-10 08:11:21,To EUR Savings,-0.1,0,EUR,COMPLETED,742.5
CARD_PAYMENT,Current,2023-06-09 12:48:14,2023-06-10 10:02:02,Uber Eats,-34.29,0,EUR,COMPLETED,708.21
TRANSFER,Current,2023-06-10 12:51:39,2023-06-10 12:51:39,To EUR Savings,-1,0,EUR,COMPLETED,707.21
TRANSFER,Current,2023-06-10 13:36:28,2023-06-10 13:36:28,To EUR Savings,-0.7,0,EUR,COMPLETED,706.51
TRANSFER,Current,2023-06-10 20:43:17,2023-06-10 20:43:17,To EUR Savings,-1,0,EUR,COMPLETED,705.51
TRANSFER,Current,2023-06-11 08:35:23,2023-06-11 08:35:23,To EUR Savings,-0.1,0,EUR,COMPLETED,705.41
TRANSFER,Current,2023-06-11 09:14:41,2023-06-11 09:14:41,To EUR Savings,-0.05,0,EUR,COMPLETED,705.36
CARD_PAYMENT,Current,2023-06-10 08:11:21,2023-06-11 14:39:24,Carnaxide Wtc,-1.9,0,EUR,COMPLETED,703.46
CARD_PAYMENT,Current,2023-06-10 12:51:39,2023-06-11 15:20:25,Taste A Story,-30,0,EUR,COMPLETED,673.46
CARD_PAYMENT,Current,2023-06-10 13:36:28,2023-06-11 16:12:20,Feira Do Livro 2023,-2.3,0,EUR,COMPLETED,671.16
TRANSFER,Current,2023-06-11 16:29:24,2023-06-11 16:29:24,To EUR Savings,-1,0,EUR,COMPLETED,670.16
TRANSFER,Current,2023-06-12 10:16:14,2023-06-12 10:16:14,To EUR Savings,-20,0,EUR,COMPLETED,650.16
CARD_PAYMENT,Current,2023-06-10 20:43:17,2023-06-12 10:26:27,O Rei Das Tostas,-27,0,EUR,COMPLETED,623.16
CARD_PAYMENT,Current,2023-06-11 08:35:23,2023-06-12 12:06:45,Carnaxide Wtc,-1.9,0,EUR,COMPLETED,621.26
CARD_PAYMENT,Current,2023-06-11 09:14:41,2023-06-12 12:06:49,Pingo Doce,-23.95,0,EUR,COMPLETED,597.31
CARD_PAYMENT,Current,2023-06-11 16:29:23,2023-06-12 12:09:06,Kefi Greek Bistro,-34,0,EUR,COMPLETED,563.31
TOPUP,Current,2023-06-12 18:46:21,2023-06-12 18:46:26,Apple Pay Top-Up by *6660,1420.11,0,EUR,COMPLETED,1983.42
TRANSFER,Current,2023-06-12 18:46:46,2023-06-12 18:46:46,To EUR Savings,-0.89,0,EUR,COMPLETED,1982.53
TRANSFER,Current,2023-06-13 08:08:22,2023-06-13 08:08:22,To EUR Savings,-0.1,0,EUR,COMPLETED,1982.43
TRANSFER,Current,2023-06-13 19:51:02,2023-06-13 19:51:02,To EUR Savings,-0.26,0,EUR,COMPLETED,1982.17
CARD_PAYMENT,Current,2023-06-13 08:08:22,2023-06-14 17:19:03,Carnaxide Wtc,-1.9,0,EUR,COMPLETED,1980.27
CARD_PAYMENT,Current,2023-06-12 18:46:45,2023-06-15 10:06:25,Airbnb,-1420.11,0,EUR,COMPLETED,560.16
CARD_PAYMENT,Current,2023-06-13 19:51:01,2023-06-15 10:08:28,Uber Eats,-61.74,0,EUR,COMPLETED,498.42
TRANSFER,Current,2023-06-16 12:57:25,2023-06-16 12:57:25,To EUR Savings,-0.58,0,EUR,COMPLETED,497.84
TRANSFER,Current,2023-06-17 07:52:23,2023-06-17 07:52:23,To EUR Savings,-0.45,0,EUR,COMPLETED,497.39
TRANSFER,Current,2023-06-17 09:13:02,2023-06-17 09:13:02,To EUR Savings,-0.15,0,EUR,COMPLETED,497.24
TRANSFER,Current,2023-06-17 10:10:56,2023-06-17 10:10:56,To EUR,1151,0,EUR,COMPLETED,1648.24
TRANSFER,Current,2023-06-17 10:13:56,2023-06-17 10:13:56,To EUR Savings,-1,0,EUR,COMPLETED,1647.24
TRANSFER,Current,2023-06-17 10:49:44,2023-06-17 10:49:44,To EUR Savings,-0.01,0,EUR,COMPLETED,1647.23
CARD_PAYMENT,Current,2023-06-16 12:57:25,2023-06-17 11:24:46,Uber Eats,-33.42,0,EUR,COMPLETED,1613.81
TRANSFER,Current,2023-06-17 15:00:39,2023-06-17 15:00:39,To EUR Savings,-0.24,0,EUR,COMPLETED,1613.57
TRANSFER,Current,2023-06-17 19:52:03,2023-06-17 19:52:03,To EUR Savings,-0.26,0,EUR,COMPLETED,1613.31
TRANSFER,Current,2023-06-17 21:40:58,2023-06-17 21:40:58,To EUR Savings,-0.51,0,EUR,COMPLETED,1612.8
TRANSFER,Current,2023-06-18 08:17:45,2023-06-18 08:17:45,To EUR Savings,-0.1,0,EUR,COMPLETED,1612.7
TRANSFER,Current,2023-06-18 09:14:49,2023-06-18 09:14:49,To EUR Savings,-0.13,0,EUR,COMPLETED,1612.57
TRANSFER,Current,2023-06-18 12:24:19,2023-06-18 12:24:19,To EUR Savings,-0.01,0,EUR,COMPLETED,1612.56
CARD_PAYMENT,Current,2023-06-17 15:00:39,2023-06-18 14:50:26,PayPal,-48.76,0,EUR,COMPLETED,1563.8
CARD_PAYMENT,Current,2023-06-17 10:13:56,2023-06-18 14:53:50,PayPal,-1151,0,EUR,COMPLETED,412.8
CARD_PAYMENT,Current,2023-06-17 09:13:02,2023-06-18 17:24:17,Auchan,-67.85,0,EUR,COMPLETED,344.95
CARD_PAYMENT,Current,2023-06-17 10:49:44,2023-06-18 17:24:32,Fnac,-92.99,0,EUR,COMPLETED,251.96
CARD_PAYMENT,Current,2023-06-17 07:52:22,2023-06-18 17:24:46,Pad Port Miraflores,-3.55,0,EUR,COMPLETED,248.41
TRANSFER,Current,2023-06-19 08:39:46,2023-06-19 08:39:46,To EUR Savings,-1,0,EUR,COMPLETED,247.41
TRANSFER,Current,2023-06-19 08:42:40,2023-06-19 08:42:40,To EUR Savings,-0.84,0,EUR,COMPLETED,246.57
CARD_PAYMENT,Current,2023-06-17 19:52:03,2023-06-19 09:50:36,Uber Eats,-48.74,0,EUR,COMPLETED,197.83
CARD_PAYMENT,Current,2023-06-17 21:40:58,2023-06-19 10:04:50,YouTube,-8.49,0,EUR,COMPLETED,189.34
TRANSFER,Current,2023-06-19 10:14:28,2023-06-19 10:14:28,To EUR Savings,-20,0,EUR,COMPLETED,169.34
CARD_PAYMENT,Current,2023-06-18 08:17:45,2023-06-19 11:48:19,Carnaxide Wtc,-1.9,0,EUR,COMPLETED,167.44
CARD_PAYMENT,Current,2023-06-18 09:14:49,2023-06-19 11:48:22,Pingo Doce,-23.87,0,EUR,COMPLETED,143.57
CARD_PAYMENT,Current,2023-06-18 12:24:19,2023-06-19 11:49:29,Auchan,-1.99,0,EUR,COMPLETED,141.58
TOPUP,Current,2023-06-19 12:47:17,2023-06-19 12:47:24,Apple Pay Top-Up by *6660,200,0,EUR,COMPLETED,341.58
TRANSFER,Current,2023-06-19 13:24:30,2023-06-19 13:24:30,To EUR Savings,-0.8,0,EUR,COMPLETED,340.78
TRANSFER,Current,2023-06-19 17:49:17,2023-06-19 17:49:17,To EUR Savings,-0.8,0,EUR,COMPLETED,339.98
CARD_PAYMENT,Current,2023-06-19 08:39:45,2023-06-20 10:35:29,Miió,-50,0,EUR,COMPLETED,289.98
CARD_PAYMENT,Current,2023-06-19 08:42:40,2023-06-20 10:59:41,PRIO,-1.16,0,EUR,COMPLETED,288.82
CARD_PAYMENT,Current,2023-06-19 13:24:26,2023-06-20 11:00:17,Cafe O Silverio,-24.2,0,EUR,COMPLETED,264.62
CARD_PAYMENT,Current,2023-06-19 17:49:17,2023-06-20 11:00:55,PRIO,-1.2,0,EUR,COMPLETED,263.42
TRANSFER,Current,2023-06-21 16:14:49,2023-06-21 16:14:49,To EUR Savings,-0.28,0,EUR,COMPLETED,263.14
TRANSFER,Current,2023-06-22 09:09:18,2023-06-22 09:09:18,To EUR Savings,-0.33,0,EUR,COMPLETED,262.81
TRANSFER,Current,2023-06-22 13:04:06,2023-06-22 13:04:06,To EUR Savings,-0.46,0,EUR,COMPLETED,262.35
CARD_PAYMENT,Current,2023-06-21 16:14:49,2023-06-22 17:54:07,Amazon,-8.72,0,EUR,COMPLETED,253.63
TOPUP,Current,2023-06-23 08:22:49,2023-06-23 08:23:04,Apple Pay Top-Up by *6660,3000,0,EUR,COMPLETED,3253.63
TRANSFER,Current,2023-06-23 08:23:55,2023-06-23 08:23:55,To EUR Rainy day,-2679.31,0,EUR,COMPLETED,574.32
CARD_PAYMENT,Current,2023-06-22 13:04:05,2023-06-23 10:27:49,Uber Eats,-26.54,0,EUR,COMPLETED,547.78
TRANSFER,Current,2023-06-23 15:30:40,2023-06-23 15:30:40,To EUR Savings,-0.21,0,EUR,COMPLETED,547.57
TRANSFER,Current,2023-06-24 08:13:37,2023-06-24 08:13:37,To EUR Savings,-0.1,0,EUR,COMPLETED,547.47
TRANSFER,Current,2023-06-24 09:34:56,2023-06-24 09:34:56,To EUR Savings,-0.14,0,EUR,COMPLETED,547.33
CARD_PAYMENT,Current,2023-06-22 09:09:18,2023-06-24 10:32:25,Amazon,-14.67,0,EUR,COMPLETED,532.66
TRANSFER,Current,2023-06-24 12:49:14,2023-06-24 12:49:14,To EUR Savings,-0.47,0,EUR,COMPLETED,532.19
CARD_PAYMENT,Current,2023-06-23 15:30:40,2023-06-24 17:47:31,Amazon,-7.79,0,EUR,COMPLETED,524.4
TRANSFER,Current,2023-06-24 19:50:47,2023-06-24 19:50:47,To EUR Savings,-0.48,0,EUR,COMPLETED,523.92
TRANSFER,Current,2023-06-25 07:23:52,2023-06-25 07:23:52,To EUR Savings,-0.05,0,EUR,COMPLETED,523.87
TRANSFER,Current,2023-06-25 09:17:12,2023-06-25 09:17:12,To EUR Savings,-0.01,0,EUR,COMPLETED,523.86
CARD_PAYMENT,Current,2023-06-24 12:49:14,2023-06-25 11:12:59,Uber Eats,-22.53,0,EUR,COMPLETED,501.33
TRANSFER,Current,2023-06-25 21:03:26,2023-06-25 21:03:26,To EUR Savings,-1,0,EUR,COMPLETED,500.33
CARD_PAYMENT,Current,2023-06-24 09:34:56,2023-06-26 09:34:35,Well S Alges,-3.86,0,EUR,COMPLETED,496.47
CARD_PAYMENT,Current,2023-06-24 08:13:37,2023-06-26 09:34:39,Carnaxide Wtc,-1.9,0,EUR,COMPLETED,494.57
CARD_PAYMENT,Current,2023-06-24 19:50:47,2023-06-26 09:38:14,Uber Eats,-32.52,0,EUR,COMPLETED,462.05
TRANSFER,Current,2023-06-26 10:17:46,2023-06-26 10:17:46,To EUR Savings,-20,0,EUR,COMPLETED,442.05
CARD_PAYMENT,Current,2023-06-25 09:17:11,2023-06-26 12:35:04,Norauto Alfragide,-3.99,0,EUR,COMPLETED,438.06
CARD_PAYMENT,Current,2023-06-25 07:23:51,2023-06-26 12:35:49,Pad Port Miraflores,-3.95,0,EUR,COMPLETED,434.11
TRANSFER,Current,2023-06-27 00:33:48,2023-06-27 00:33:48,To EUR Savings,-0.51,0,EUR,COMPLETED,433.6
TRANSFER,Current,2023-06-27 00:39:38,2023-06-27 00:39:38,To EUR Savings,-0.01,0,EUR,COMPLETED,433.59
TRANSFER,Current,2023-06-27 07:29:47,2023-06-27 07:29:47,To EUR Savings,-0.05,0,EUR,COMPLETED,433.54
CARD_PAYMENT,Current,2023-06-25 21:03:26,2023-06-27 10:13:34,Fio De Azeite,-28,0,EUR,COMPLETED,405.54
TRANSFER,Current,2023-06-27 14:23:41,2023-06-27 14:23:41,To EUR Savings,-1,0,EUR,COMPLETED,404.54
TRANSFER,Current,2023-06-27 17:32:14,2023-06-27 17:32:14,To EUR Savings,-0.31,0,EUR,COMPLETED,404.23
TRANSFER,Current,2023-06-27 17:40:36,2023-06-27 17:40:36,To EUR Savings,-0.32,0,EUR,COMPLETED,403.91
CARD_PAYMENT,Current,2023-06-27 00:33:48,2023-06-28 09:15:51,Apple,-5.49,0,EUR,COMPLETED,398.42
TRANSFER,Current,2023-06-28 10:02:03,2023-06-28 10:02:03,To EUR Savings,-0.4,0,EUR,COMPLETED,398.02
CARD_PAYMENT,Current,2023-06-27 00:39:38,2023-06-28 10:07:10,Apple,-1.99,0,EUR,COMPLETED,396.03
TOPUP,Current,2023-06-28 10:12:56,2023-06-28 10:13:02,Apple Pay Top-Up by *6660,400,0,EUR,COMPLETED,796.03
CARD_PAYMENT,Current,2023-06-27 17:40:36,2023-06-28 10:33:57,Intermarché,-154.68,0,EUR,COMPLETED,641.35
CARD_PAYMENT,Current,2023-06-27 17:32:14,2023-06-28 10:33:57,Intermarché,-7.69,0,EUR,COMPLETED,633.66
CARD_PAYMENT,Current,2023-06-27 07:29:47,2023-06-28 11:43:22,Pad Port Miraflores,-3.95,0,EUR,COMPLETED,629.71
CARD_PAYMENT,Current,2023-06-27 14:23:41,2023-06-28 11:43:51,Tasca Do Celso,-92,0,EUR,COMPLETED,537.71
TRANSFER,Current,2023-06-28 12:05:47,2023-06-28 12:05:47,To EUR Savings,-0.8,0,EUR,COMPLETED,536.91
TRANSFER,Current,2023-06-28 14:03:44,2023-06-28 14:03:44,To EUR Savings,-0.01,0,EUR,COMPLETED,536.9
TRANSFER,Current,2023-06-29 09:17:06,2023-06-29 09:17:06,To EUR Savings,-0.7,0,EUR,COMPLETED,536.2
TRANSFER,Current,2023-06-29 09:35:52,2023-06-29 09:35:52,To EUR Savings,-0.45,0,EUR,COMPLETED,535.75
TRANSFER,Current,2023-06-29 10:28:24,2023-06-29 10:28:24,To EUR Savings,-0.76,0,EUR,COMPLETED,534.99
CARD_PAYMENT,Current,2023-06-28 14:03:44,2023-06-29 10:52:18,Google,-2.99,0,EUR,COMPLETED,532
TRANSFER,Current,2023-06-29 15:58:01,2023-06-29 15:58:01,To EUR Savings,-0.2,0,EUR,COMPLETED,531.8
CARD_PAYMENT,Current,2023-06-28 10:02:03,2023-06-29 16:18:53,The Bakery Arrifana,-17.6,0,EUR,COMPLETED,514.2
CARD_PAYMENT,Current,2023-06-28 12:05:46,2023-06-29 16:29:45,Meu Super,-17.2,0,EUR,COMPLETED,497
TRANSFER,Current,2023-06-30 02:54:20,2023-06-30 02:54:20,To EUR Savings,-0.05,0,EUR,COMPLETED,496.95
CARD_PAYMENT,Current,2023-06-29 10:28:24,2023-06-30 10:54:32,Intermarché,-46.24,0,EUR,COMPLETED,450.71
TRANSFER,Current,2023-06-30 11:21:35,2023-06-30 11:21:35,To EUR Savings,-0.7,0,EUR,COMPLETED,450.01
TRANSFER,Current,2023-06-30 12:25:08,2023-06-30 12:25:08,To EUR Savings,-0.01,0,EUR,COMPLETED,450
TRANSFER,Current,2023-06-30 12:32:28,2023-06-30 12:32:28,To EUR Savings,-0.9,0,EUR,COMPLETED,449.1
CARD_PAYMENT,Current,2023-06-29 15:58:00,2023-06-30 17:13:07,Munich,-17.8,0,EUR,COMPLETED,431.3
CARD_PAYMENT,Current,2023-06-29 09:35:52,2023-06-30 17:29:25,Biologico,-7.55,0,EUR,COMPLETED,423.75
CARD_PAYMENT,Current,2023-06-29 09:17:06,2023-06-30 17:29:34,The Bakery Arrifana,-4.3,0,EUR,COMPLETED,419.45
TRANSFER,Current,2023-06-30 19:30:36,2023-06-30 19:30:36,To EUR Savings,-0.8,0,EUR,COMPLETED,418.65
TRANSFER,Current,2023-07-01 09:24:47,2023-07-01 09:24:47,To EUR Savings,-0.1,0,EUR,COMPLETED,418.55
CARD_PAYMENT,Current,2023-06-30 02:54:20,2023-07-01 10:16:14,Apple,-18.95,0,EUR,COMPLETED,399.6
CARD_PAYMENT,Current,2023-06-30 11:21:35,2023-07-01 10:33:59,O Zé,-5.3,0,EUR,COMPLETED,394.3
CARD_PAYMENT,Current,2023-06-30 12:25:07,2023-07-01 13:25:11,Meu Super,-21.99,0,EUR,COMPLETED,372.31
CARD_PAYMENT,Current,2023-06-30 19:30:36,2023-07-01 13:42:58,Fonte Do Vale,-13.2,0,EUR,COMPLETED,359.11
TRANSFER,Current,2023-07-01 13:48:03,2023-07-01 13:48:03,To EUR Savings,-0.6,0,EUR,COMPLETED,358.51
TRANSFER,Current,2023-07-02 04:41:59,2023-07-02 04:41:59,To EUR Savings,-0.91,0,EUR,COMPLETED,357.6
TRANSFER,Current,2023-07-02 09:16:26,2023-07-02 09:16:26,To EUR Savings,-0.5,0,EUR,COMPLETED,357.1
TRANSFER,Current,2023-07-02 10:18:55,2023-07-02 10:18:55,To EUR Savings,-0.42,0,EUR,COMPLETED,356.68
TRANSFER,Current,2023-07-02 10:34:51,2023-07-02 10:34:51,To EUR Savings,-0.9,0,EUR,COMPLETED,355.78
CARD_PAYMENT,Current,2023-07-02 04:41:59,2023-07-02 14:37:53,OpenAI,-3.09,0.03,EUR,COMPLETED,352.66
CARD_PAYMENT,Current,2023-07-01 13:48:03,2023-07-02 14:44:54,Fonte Do Vale,-58.4,0,EUR,COMPLETED,294.26
CARD_PAYMENT,Current,2023-06-30 12:32:28,2023-07-02 18:18:51,The Bakery Arrifana,-5.1,0,EUR,COMPLETED,289.16
CARD_PAYMENT,Current,2023-07-01 09:24:47,2023-07-02 18:21:14,The Bakery Arrifana,-3.9,0,EUR,COMPLETED,285.26
CARD_PAYMENT,Current,2023-07-02 10:18:55,2023-07-03 09:53:46,Intermarché,-38.58,0,EUR,COMPLETED,246.68
TRANSFER,Current,2023-07-03 10:18:35,2023-07-03 10:18:35,To EUR Savings,-20,0,EUR,COMPLETED,226.68
TOPUP,Current,2023-07-03 12:37:01,2023-07-03 12:37:05,Apple Pay Top-Up by *6660,400,0,EUR,COMPLETED,626.68
TRANSFER,Current,2023-07-03 14:40:18,2023-07-03 14:40:18,To EUR Savings,-0.75,0,EUR,COMPLETED,625.93
CARD_PAYMENT,Current,2023-07-02 09:16:26,2023-07-03 15:02:37,The Bakery Arrifana,-5.5,0,EUR,COMPLETED,620.43
CARD_PAYMENT,Current,2023-07-02 10:34:50,2023-07-03 15:16:37,Meu Super,-3.1,0,EUR,COMPLETED,617.33
CARD_PAYMENT,Current,2023-07-03 14:40:18,2023-07-04 09:23:00,Rest Trinca Espinhas,-145.25,0,EUR,COMPLETED,472.08
TRANSFER,Current,2023-07-05 09:14:08,2023-07-05 09:14:08,To EUR Savings,-0.79,0,EUR,COMPLETED,471.29
CARD_PAYMENT,Current,2023-07-05 09:14:07,2023-07-05 17:22:08,GitHub,-9.21,0,EUR,COMPLETED,462.08
TRANSFER,Current,2023-07-06 12:55:12,2023-07-06 12:55:12,To EUR Savings,-0.58,0,EUR,COMPLETED,461.5
CARD_PAYMENT,Current,2023-07-06 12:55:12,2023-07-07 09:39:06,Uber Eats,-33.42,0,EUR,COMPLETED,428.08
TRANSFER,Current,2023-07-07 21:10:47,2023-07-07 21:10:47,To EUR Savings,-0.85,0,EUR,COMPLETED,427.23
TRANSFER,Current,2023-07-08 07:38:41,2023-07-08 07:38:41,To EUR Savings,-0.05,0,EUR,COMPLETED,427.18
TRANSFER,Current,2023-07-08 13:17:31,2023-07-08 13:17:31,To EUR Savings,-0.55,0,EUR,COMPLETED,426.63
CARD_PAYMENT,Current,2023-07-07 21:10:47,2023-07-08 17:05:52,Taverna Dos Pereiras,-60.15,0,EUR,COMPLETED,366.48
TRANSFER,Current,2023-07-08 23:41:31,2023-07-08 23:41:31,To EUR Savings,-0.5,0,EUR,COMPLETED,365.98
TRANSFER,Current,2023-07-09 08:17:52,2023-07-09 08:17:52,To EUR Savings,-0.25,0,EUR,COMPLETED,365.73
TRANSFER,Current,2023-07-09 09:18:05,2023-07-09 09:18:05,To EUR Savings,-0.39,0,EUR,COMPLETED,365.34
TRANSFER,Current,2023-07-09 09:40:36,2023-07-09 09:40:36,To EUR Savings,-0.61,0,EUR,COMPLETED,364.73
TRANSFER,Current,2023-07-09 10:16:46,2023-07-09 10:16:46,To EUR Savings,-0.87,0,EUR,COMPLETED,363.86
CARD_PAYMENT,Current,2023-07-08 13:17:31,2023-07-09 10:46:54,Minipreço,-5.45,0,EUR,COMPLETED,358.41
CARD_PAYMENT,Current,2023-07-08 07:38:41,2023-07-09 14:25:55,Pad Port Miraflores,-3.95,0,EUR,COMPLETED,354.46
TRANSFER,Current,2023-07-10 10:20:44,2023-07-10 10:20:44,To EUR Savings,-20,0,EUR,COMPLETED,334.46
TOPUP,Current,2023-07-10 21:23:36,2023-07-10 21:23:47,Apple Pay Top-Up by *6660,200,0,EUR,COMPLETED,534.46
CARD_PAYMENT,Current,2023-07-09 08:17:51,2023-07-11 10:38:04,Carnaxide Wtc,-2.75,0,EUR,COMPLETED,531.71
CARD_PAYMENT,Current,2023-07-09 09:40:36,2023-07-11 10:38:09,Auchan,-56.39,0,EUR,COMPLETED,475.32
CARD_PAYMENT,Current,2023-07-09 09:18:05,2023-07-11 10:38:09,Pingo Doce,-24.61,0,EUR,COMPLETED,450.71
CARD_PAYMENT,Current,2023-07-09 10:16:46,2023-07-11 10:38:13,Cortefiel,-65.13,0,EUR,COMPLETED,385.58
CARD_PAYMENT,Current,2023-07-08 23:41:31,2023-07-11 10:41:03,Live Experiences,-6.5,0,EUR,COMPLETED,379.08
TRANSFER,Current,2023-07-12 12:57:41,2023-07-12 12:57:41,To EUR Savings,-0.58,0,EUR,COMPLETED,378.5
CARD_PAYMENT,Current,2023-07-12 12:57:41,2023-07-13 09:54:55,Uber Eats,-33.42,0,EUR,COMPLETED,345.08
TRANSFER,Current,2023-07-13 20:35:58,2023-07-13 20:35:58,To EUR Savings,-0.74,0,EUR,COMPLETED,344.34
CARD_PAYMENT,Current,2023-07-13 20:35:58,2023-07-14 19:21:24,GoFundMe,-10.26,0,EUR,COMPLETED,334.08
TRANSFER,Current,2023-07-14 21:00:17,2023-07-14 21:00:17,To EUR Savings,-0.32,0,EUR,COMPLETED,333.76
TRANSFER,Current,2023-07-15 07:12:22,2023-07-15 07:12:22,To EUR Savings,-0.05,0,EUR,COMPLETED,333.71
CARD_PAYMENT,Current,2023-07-15 11:49:21,2023-07-16 11:10:46,Confeitaria Amaral,-12.4,0,EUR,COMPLETED,321.31
CARD_PAYMENT,Current,2023-07-15 09:50:43,2023-07-16 11:11:09,Pensao Rest Floresta,-7.1,0,EUR,COMPLETED,314.21
CARD_PAYMENT,Current,2023-07-15 07:12:22,2023-07-16 15:43:42,Pad Port Miraflores,-3.95,0,EUR,COMPLETED,310.26
CARD_PAYMENT,Current,2023-07-14 21:00:17,2023-07-16 15:49:41,Pingo Doce,-18.68,0,EUR,COMPLETED,291.58
TRANSFER,Current,2023-07-17 10:14:28,2023-07-17 10:14:28,To EUR Savings,-20,0,EUR,COMPLETED,271.58
TRANSFER,Current,2023-07-17 21:40:58,2023-07-17 21:40:58,To EUR Savings,-0.51,0,EUR,COMPLETED,271.07
TRANSFER,Current,2023-07-17 21:50:52,2023-07-17 21:50:52,To EUR Savings,-1,0,EUR,COMPLETED,270.07
CARD_PAYMENT,Current,2023-07-17 21:50:52,2023-07-18 10:52:46,Miió,-50,0,EUR,COMPLETED,220.07
CARD_PAYMENT,Current,2023-07-17 21:40:58,2023-07-19 09:41:24,YouTube,-8.49,0,EUR,COMPLETED,211.58
TRANSFER,Current,2023-07-19 10:41:59,2023-07-19 10:41:59,To EUR Savings,-1,0,EUR,COMPLETED,210.58
TRANSFER,Current,2023-07-19 12:55:51,2023-07-19 12:55:51,To EUR Savings,-0.05,0,EUR,COMPLETED,210.53
CARD_PAYMENT,Current,2023-07-19 07:33:31,2023-07-20 13:02:20,A Padaria Portuguesa,-3.95,0,EUR,COMPLETED,206.58
CARD_PAYMENT,Current,2023-07-19 09:07:54,2023-07-20 14:14:57,Clinica Medica E,-60,0,EUR,COMPLETED,146.58
TRANSFER,Current,2023-07-21 13:07:32,2023-07-21 13:07:32,To EUR Savings,-0.08,0,EUR,COMPLETED,146.5
TRANSFER,Current,2023-07-22 07:23:43,2023-07-22 07:23:43,To EUR Savings,-0.05,0,EUR,COMPLETED,146.45
CARD_PAYMENT,Current,2023-07-21 13:07:32,2023-07-22 12:23:37,Uber Eats,-32.92,0,EUR,COMPLETED,113.53
TRANSFER,Current,2023-07-22 13:58:27,2023-07-22 13:58:27,To EUR Savings,-0.81,0,EUR,COMPLETED,112.72
TRANSFER,Current,2023-07-22 20:17:31,2023-07-22 20:17:31,To EUR Savings,-0.71,0,EUR,COMPLETED,112.01
TRANSFER,Current,2023-07-23 08:07:18,2023-07-23 08:07:18,To EUR Savings,-0.25,0,EUR,COMPLETED,111.76
TOPUP,Current,2023-07-23 10:50:10,2023-07-23 10:50:14,Apple Pay Top-Up by *6660,400,0,EUR,COMPLETED,511.76
TRANSFER,Current,2023-07-23 11:24:39,2023-07-23 11:24:39,To EUR Savings,-0.21,0,EUR,COMPLETED,511.55
CARD_PAYMENT,Current,2023-07-22 07:23:42,2023-07-23 13:22:30,Pad Port Miraflores,-3.95,0,EUR,COMPLETED,507.6
CARD_PAYMENT,Current,2023-07-22 13:58:26,2023-07-23 13:23:26,Controlauto Aboboda,-34.19,0,EUR,COMPLETED,473.41
TRANSFER,Current,2023-07-23 17:26:19,2023-07-23 17:26:19,To EUR Savings,-1,0,EUR,COMPLETED,472.41
TRANSFER,Current,2023-07-23 18:08:39,2023-07-23 18:08:39,To EUR Savings,-0.05,0,EUR,COMPLETED,472.36
CARD_PAYMENT,Current,2023-07-22 20:17:31,2023-07-24 09:52:45,Uber Eats,-66.29,0,EUR,COMPLETED,406.07
TRANSFER,Current,2023-07-24 10:13:52,2023-07-24 10:13:52,To EUR Savings,-20,0,EUR,COMPLETED,386.07
CARD_PAYMENT,Current,2023-07-23 11:24:39,2023-07-24 10:16:01,Minipreço,-14.79,0,EUR,COMPLETED,371.28
CARD_PAYMENT,Current,2023-07-23 18:08:38,2023-07-24 10:17:02,Allegro,-8.95,0,EUR,COMPLETED,362.33
CARD_PAYMENT,Current,2023-07-23 08:07:18,2023-07-24 12:14:18,Carnaxide Wtc,-2.75,0,EUR,COMPLETED,359.58
TRANSFER,Current,2023-07-24 14:45:50,2023-07-24 14:45:50,To EUR Savings,-0.01,0,EUR,COMPLETED,359.57
CARD_PAYMENT,Current,2023-07-23 17:26:19,2023-07-25 09:26:01,PayPal,-83,0,EUR,COMPLETED,276.57
TRANSFER,Current,2023-07-26 20:14:08,2023-07-26 20:14:08,To EUR Savings,-0.87,0,EUR,COMPLETED,275.7
TRANSFER,Current,2023-07-27 00:32:33,2023-07-27 00:32:33,To EUR Savings,-0.01,0,EUR,COMPLETED,275.69
TRANSFER,Current,2023-07-27 00:35:19,2023-07-27 00:35:19,To EUR Savings,-0.51,0,EUR,COMPLETED,275.18
CARD_PAYMENT,Current,2023-07-24 14:45:50,2023-07-27 10:14:43,PlayStation,-24.99,0,EUR,COMPLETED,250.19
TRANSFER,Current,2023-07-27 13:07:20,2023-07-27 13:07:20,To EUR Savings,-0.08,0,EUR,COMPLETED,250.11
TRANSFER,Current,2023-07-27 20:36:30,2023-07-27 20:36:30,To EUR Savings,-0.1,0,EUR,COMPLETED,250.01
TRANSFER,Current,2023-07-27 20:39:48,2023-07-27 20:39:48,To EUR Savings,-0.5,0,EUR,COMPLETED,249.51
TRANSFER,Current,2023-07-27 20:52:03,2023-07-27 20:52:03,To EUR Savings,-1,0,EUR,COMPLETED,248.51
CARD_PAYMENT,Current,2023-07-27 00:35:19,2023-07-28 11:02:19,Apple,-5.49,0,EUR,COMPLETED,243.02
CARD_PAYMENT,Current,2023-07-27 00:32:33,2023-07-28 11:02:31,Apple,-1.99,0,EUR,COMPLETED,241.03
CARD_PAYMENT,Current,2023-07-27 13:07:20,2023-07-28 11:13:52,Uber Eats,-32.92,0,EUR,COMPLETED,208.11
CARD_PAYMENT,Current,2023-07-26 20:14:08,2023-07-28 11:39:06,Minipreço,-14.13,0,EUR,COMPLETED,193.98
TRANSFER,Current,2023-07-28 11:58:39,2023-07-28 11:58:39,To EUR Savings,-0.01,0,EUR,COMPLETED,193.97
TRANSFER,Current,2023-07-28 14:03:44,2023-07-28 14:03:44,To EUR Savings,-0.01,0,EUR,COMPLETED,193.96
TRANSFER,Current,2023-07-29 08:12:19,2023-07-29 08:12:19,To EUR Savings,-0.25,0,EUR,COMPLETED,193.71
TOPUP,Current,2023-07-29 08:45:25,2023-07-29 08:45:28,Apple Pay Top-Up by *6660,400,0,EUR,COMPLETED,593.71
TRANSFER,Current,2023-07-29 08:52:16,2023-07-29 08:52:16,To EUR Savings,-0.51,0,EUR,COMPLETED,593.2
CARD_PAYMENT,Current,2023-07-28 14:03:44,2023-07-29 10:44:22,Google,-2.99,0,EUR,COMPLETED,590.21
CARD_PAYMENT,Current,2023-07-27 20:36:30,2023-07-29 11:03:09,Receita Pomposa,-15.9,0,EUR,COMPLETED,574.31
CARD_PAYMENT,Current,2023-07-27 20:39:48,2023-07-29 11:03:09,Saisish,-7.5,0,EUR,COMPLETED,566.81
CARD_PAYMENT,Current,2023-07-27 20:52:03,2023-07-29 16:22:04,Mercado de Algés,-6,0,EUR,COMPLETED,560.81
CARD_PAYMENT,Current,2023-07-28 11:58:39,2023-07-29 17:12:02,PayPal,-39.99,0,EUR,COMPLETED,520.82
TRANSFER,Current,2023-07-29 21:29:01,2023-07-29 21:29:01,To EUR Savings,-0.3,0,EUR,COMPLETED,520.52
TRANSFER,Current,2023-07-30 02:54:04,2023-07-30 02:54:04,To EUR Savings,-0.05,0,EUR,COMPLETED,520.47
TRANSFER,Current,2023-07-30 08:19:42,2023-07-30 08:19:42,To EUR Savings,-0.25,0,EUR,COMPLETED,520.22
TRANSFER,Current,2023-07-30 08:51:13,2023-07-30 08:51:13,To EUR Savings,-0.38,0,EUR,COMPLETED,519.84
CARD_PAYMENT,Current,2023-07-29 08:12:19,2023-07-30 14:21:03,Carnaxide Wtc,-2.75,0,EUR,COMPLETED,517.09
CARD_PAYMENT,Current,2023-07-29 08:52:16,2023-07-30 14:21:03,Carnaxide Wtc,-16.49,0,EUR,COMPLETED,500.6
TRANSFER,Current,2023-07-30 20:51:41,2023-07-30 20:51:41,To EUR Savings,-0.3,0,EUR,COMPLETED,500.3
CARD_PAYMENT,Current,2023-07-30 02:54:04,2023-07-31 09:30:56,Apple,-18.95,0,EUR,COMPLETED,481.35
TRANSFER,Current,2023-07-31 10:19:50,2023-07-31 10:19:50,To EUR Savings,-20,0,EUR,COMPLETED,461.35
CARD_PAYMENT,Current,2023-07-30 08:19:42,2023-07-31 10:32:52,Carnaxide Wtc,-2.75,0,EUR,COMPLETED,458.6
CARD_PAYMENT,Current,2023-07-30 08:51:13,2023-07-31 10:32:56,Carnaxide Wtc,-2.62,0,EUR,COMPLETED,455.98
CARD_PAYMENT,Current,2023-07-29 21:29:00,2023-07-31 11:13:12,Tricana Da Barra,-46.7,0,EUR,COMPLETED,409.28
TRANSFER,Current,2023-07-31 11:13:32,2023-07-31 11:13:32,To EUR Savings,-0.05,0,EUR,COMPLETED,409.23
TRANSFER,Current,2023-07-31 13:08:46,2023-07-31 13:08:46,To EUR Savings,-0.3,0,EUR,COMPLETED,408.93
TRANSFER,Current,2023-07-31 16:34:45,2023-07-31 16:34:45,To EUR Savings,-1,0,EUR,COMPLETED,407.93
TRANSFER,Current,2023-07-31 18:27:46,2023-07-31 18:27:46,To EUR Savings,-0.52,0,EUR,COMPLETED,407.41
CARD_PAYMENT,Current,2023-07-31 11:13:32,2023-08-01 10:25:43,Brisa,-10.95,0,EUR,COMPLETED,396.46
CARD_PAYMENT,Current,2023-07-31 16:34:45,2023-08-01 10:51:23,Miió,-50,0,EUR,COMPLETED,346.46
TRANSFER,Current,2023-08-01 11:02:28,2023-08-01 11:02:28,To EUR Savings,-0.9,0,EUR,COMPLETED,345.56
CARD_PAYMENT,Current,2023-07-30 20:51:40,2023-08-01 11:38:10,Angels' Bar,-37.7,0,EUR,COMPLETED,307.86
CARD_PAYMENT,Current,2023-07-31 13:08:46,2023-08-01 11:39:02,Burguezia Do Leitao,-8.7,0,EUR,COMPLETED,299.16
CARD_PAYMENT,Current,2023-07-31 18:27:46,2023-08-01 11:41:03,Lidl,-6.48,0,EUR,COMPLETED,292.68
TRANSFER,Current,2023-08-01 14:51:34,2023-08-01 14:51:34,To EUR Savings,-0.5,0,EUR,COMPLETED,292.18
TRANSFER,Current,2023-08-02 09:19:32,2023-08-02 09:19:32,To EUR Savings,-0.25,0,EUR,COMPLETED,291.93
CARD_PAYMENT,Current,2023-08-01 14:51:34,2023-08-02 11:14:36,Quinta Lixa,-8.5,0,EUR,COMPLETED,283.43
CARD_PAYMENT,Current,2023-08-01 11:02:28,2023-08-02 11:19:07,Confeitaria Lailai,-7.1,0,EUR,COMPLETED,276.33
TRANSFER,Current,2023-08-02 11:43:32,2023-08-02 11:43:32,To EUR Savings,-0.6,0,EUR,COMPLETED,275.73
TRANSFER,Current,2023-08-02 19:28:44,2023-08-02 19:28:44,To EUR Savings,-0.66,0,EUR,COMPLETED,275.07
CARD_PAYMENT,Current,2023-08-02 11:43:31,2023-08-03 11:11:14,Confeitaria Lailai,-4.4,0,EUR,COMPLETED,270.67
CARD_PAYMENT,Current,2023-08-02 09:19:32,2023-08-03 11:11:31,Frigideiras da Sé,-6.75,0,EUR,COMPLETED,263.92
CARD_PAYMENT,Current,2023-08-02 19:28:44,2023-08-03 15:51:09,Continente,-18.34,0,EUR,COMPLETED,245.58
TRANSFER,Current,2023-08-04 08:47:49,2023-08-04 08:47:49,To EUR Savings,-0.01,0,EUR,COMPLETED,245.57
TOPUP,Current,2023-08-04 08:50:10,2023-08-04 08:50:12,Apple Pay Top-Up by *6660,200,0,EUR,COMPLETED,445.57
TRANSFER,Current,2023-08-04 13:47:30,2023-08-04 13:47:30,To EUR Savings,-0.1,0,EUR,COMPLETED,445.47
TRANSFER,Current,2023-08-04 19:12:16,2023-08-04 19:12:16,To EUR Savings,-0.86,0,EUR,COMPLETED,444.61
CARD_PAYMENT,Current,2023-08-04 08:47:49,2023-08-05 15:56:50,Jos Freitas,-2.99,0,EUR,COMPLETED,441.62
CARD_PAYMENT,Current,2023-08-04 13:47:30,2023-08-05 15:59:01,Alvaros Cafe Unipess,-30.9,0,EUR,COMPLETED,410.72
CARD_PAYMENT,Current,2023-08-04 19:12:16,2023-08-05 15:59:42,Minipreço,-20.14,0,EUR,COMPLETED,390.58
TRANSFER,Current,2023-08-05 17:43:15,2023-08-05 17:43:15,To EUR Savings,-0.9,0,EUR,COMPLETED,389.68
CARD_PAYMENT,Current,2023-08-05 17:43:14,2023-08-06 03:08:24,GitHub,-9.1,0.09,EUR,COMPLETED,380.49
TRANSFER,Current,2023-08-06 07:51:37,2023-08-06 07:51:37,To EUR Savings,-1,0,EUR,COMPLETED,379.49
TRANSFER,Current,2023-08-06 10:13:13,2023-08-06 10:13:13,To EUR Savings,-1,0,EUR,COMPLETED,378.49
TRANSFER,Current,2023-08-07 10:14:51,2023-08-07 10:14:51,To EUR Savings,-20,0,EUR,COMPLETED,358.49
CARD_PAYMENT,Current,2023-08-06 07:51:37,2023-08-07 11:14:02,Miió,-50,0,EUR,COMPLETED,308.49
CARD_PAYMENT,Current,2023-08-06 10:13:13,2023-08-07 11:18:32,Miió,-10,0,EUR,COMPLETED,298.49
TRANSFER,Current,2023-08-07 20:11:42,2023-08-07 20:11:42,To EUR Savings,-0.4,0,EUR,COMPLETED,298.09
CARD_PAYMENT,Current,2023-08-07 20:11:42,2023-08-09 10:58:10,Petiscos Pego Escuro,-22.6,0,EUR,COMPLETED,275.49
TRANSFER,Current,2023-08-10 12:42:47,2023-08-10 12:42:47,To EUR Savings,-0.2,0,EUR,COMPLETED,275.29
TRANSFER,Current,2023-08-10 13:12:34,2023-08-10 13:12:34,To EUR Savings,-0.1,0,EUR,COMPLETED,275.19
TRANSFER,Current,2023-08-10 19:10:08,2023-08-10 19:10:08,To EUR Savings,-0.8,0,EUR,COMPLETED,274.39
CARD_PAYMENT,Current,2023-08-10 12:42:47,2023-08-11 10:58:49,Petiscos Pego Escuro,-21.8,0,EUR,COMPLETED,252.59
CARD_PAYMENT,Current,2023-08-10 13:12:34,2023-08-11 10:58:49,Petiscos Pego Escuro,-3.9,0,EUR,COMPLETED,248.69
CARD_PAYMENT,Current,2023-08-10 19:10:08,2023-08-11 13:35:51,Brisa,-4.2,0,EUR,COMPLETED,244.49
TRANSFER,Current,2023-08-11 21:12:31,2023-08-11 21:12:31,To EUR Savings,-0.6,0,EUR,COMPLETED,243.89
TRANSFER,Current,2023-08-12 08:33:51,2023-08-12 08:33:51,To EUR Savings,-0.25,0,EUR,COMPLETED,243.64
TRANSFER,Current,2023-08-12 09:28:40,2023-08-12 09:28:40,To EUR Savings,-0.52,0,EUR,COMPLETED,243.12
TRANSFER,Current,2023-08-12 09:45:02,2023-08-12 09:45:02,To EUR Savings,-0.67,0,EUR,COMPLETED,242.45
TRANSFER,Current,2023-08-13 07:32:50,2023-08-13 07:32:50,To EUR Savings,-0.05,0,EUR,COMPLETED,242.4
CARD_PAYMENT,Current,2023-08-11 21:12:31,2023-08-13 11:50:29,Tricana Da Barra,-40.4,0,EUR,COMPLETED,202
TRANSFER,Current,2023-08-13 12:38:44,2023-08-13 12:38:44,To EUR Savings,-1,0,EUR,COMPLETED,201
CARD_PAYMENT,Current,2023-08-12 08:33:50,2023-08-13 13:23:15,Carnaxide Wtc,-2.75,0,EUR,COMPLETED,198.25
CARD_PAYMENT,Current,2023-08-12 09:28:40,2023-08-13 13:23:55,Carnaxide Wtc,-3.48,0,EUR,COMPLETED,194.77
CARD_PAYMENT,Current,2023-08-12 09:45:01,2023-08-13 13:23:59,Pingo Doce,-39.33,0,EUR,COMPLETED,155.44
TRANSFER,Current,2023-08-13 17:10:31,2023-08-13 17:10:31,To EUR Savings,-0.9,0,EUR,COMPLETED,154.54
CARD_PAYMENT,Current,2023-08-13 12:38:44,2023-08-14 09:50:24,Scut Marketing,-10,0,EUR,COMPLETED,144.54
TRANSFER,Current,2023-08-14 10:12:54,2023-08-14 10:12:54,To EUR Savings,-20,0,EUR,COMPLETED,124.54
CARD_PAYMENT,Current,2023-08-13 07:32:49,2023-08-14 12:13:12,Pad Port Miraflores,-3.95,0,EUR,COMPLETED,120.59
CARD_PAYMENT,Current,2023-08-13 17:10:30,2023-08-14 12:17:53,Pastelaria Fradinho,-6.1,0,EUR,COMPLETED,114.49
TOPUP,Current,2023-08-14 18:47:19,2023-08-14 18:47:25,Apple Pay Top-Up by *6660,400,0,EUR,COMPLETED,514.49
TRANSFER,Current,2023-08-14 20:38:14,2023-08-14 20:38:14,To EUR Savings,-0.24,0,EUR,COMPLETED,514.25
TRANSFER,Current,2023-08-14 20:43:18,2023-08-14 20:43:18,To EUR Savings,-0.4,0,EUR,COMPLETED,513.85
TRANSFER,Current,2023-08-15 19:06:11,2023-08-15 19:06:11,To EUR Savings,-0.5,0,EUR,COMPLETED,513.35
CARD_PAYMENT,Current,2023-08-14 20:38:14,2023-08-16 09:42:42,Uber Eats,-31.76,0,EUR,COMPLETED,481.59
CARD_PAYMENT,Current,2023-08-14 20:43:18,2023-08-16 09:53:33,Minipreço,-3.6,0,EUR,COMPLETED,477.99
CARD_PAYMENT,Current,2023-08-15 19:06:11,2023-08-16 09:54:39,Britavola,-25.5,0,EUR,COMPLETED,452.49
TRANSFER,Current,2023-08-16 13:10:11,2023-08-16 13:10:11,To EUR Savings,-0.27,0,EUR,COMPLETED,452.22
CARD_PAYMENT,Current,2023-08-16 13:10:11,2023-08-17 11:35:01,Minipreço,-6.73,0,EUR,COMPLETED,445.49
TRANSFER,Current,2023-08-17 13:03:39,2023-08-17 13:03:39,To EUR Savings,-0.16,0,EUR,COMPLETED,445.33
TRANSFER,Current,2023-08-17 21:40:58,2023-08-17 21:40:58,To EUR Savings,-0.51,0,EUR,COMPLETED,444.82
CARD_PAYMENT,Current,2023-08-17 13:03:39,2023-08-18 10:59:51,Uber Eats,-42.84,0,EUR,COMPLETED,401.98
TRANSFER,Current,2023-08-19 08:07:36,2023-08-19 08:07:36,To EUR Savings,-0.1,0,EUR,COMPLETED,401.88
CARD_PAYMENT,Current,2023-08-17 21:40:58,2023-08-19 11:24:13,YouTube,-8.49,0,EUR,COMPLETED,393.39
TRANSFER,Current,2023-08-19 13:28:04,2023-08-19 13:28:04,To EUR Savings,-0.5,0,EUR,COMPLETED,392.89
TRANSFER,Current,2023-08-19 13:36:20,2023-08-19 13:36:20,To EUR Savings,-0.2,0,EUR,COMPLETED,392.69
TRANSFER,Current,2023-08-19 13:39:51,2023-08-19 13:39:51,To EUR Savings,-1,0,EUR,COMPLETED,391.69
TRANSFER,Current,2023-08-19 14:09:40,2023-08-19 14:09:40,To EUR Savings,-1,0,EUR,COMPLETED,390.69
TRANSFER,Current,2023-08-20 08:09:09,2023-08-20 08:09:09,To EUR Savings,-0.1,0,EUR,COMPLETED,390.59
TRANSFER,Current,2023-08-20 09:27:15,2023-08-20 09:27:15,To EUR Savings,-0.03,0,EUR,COMPLETED,390.56
TRANSFER,Current,2023-08-20 09:42:12,2023-08-20 09:42:12,To EUR Savings,-0.19,0,EUR,COMPLETED,390.37
TRANSFER,Current,2023-08-20 13:16:34,2023-08-20 13:16:34,To EUR Savings,-0.06,0,EUR,COMPLETED,390.31
CARD_PAYMENT,Current,2023-08-19 13:28:04,2023-08-20 14:00:14,Saisish,-12.5,0,EUR,COMPLETED,377.81
CARD_PAYMENT,Current,2023-08-19 13:36:20,2023-08-20 14:00:14,Mercado De Alges,-5.8,0,EUR,COMPLETED,372.01
CARD_PAYMENT,Current,2023-08-19 13:39:50,2023-08-20 14:00:14,Mercado de Algés,-6,0,EUR,COMPLETED,366.01
CARD_PAYMENT,Current,2023-08-19 14:09:40,2023-08-20 14:00:14,Mercado De Alges,-4,0,EUR,COMPLETED,362.01
CARD_PAYMENT,Current,2023-08-21 07:51:23,,EVIO,-5,0,EUR,REVERTED,
TRANSFER,Current,2023-08-21 07:51:23,2023-08-21 07:51:23,To EUR Savings,-1,0,EUR,COMPLETED,361.01
TRANSFER,Current,2023-08-21 10:12:48,2023-08-21 10:12:48,To EUR Savings,-20,0,EUR,COMPLETED,341.01
CARD_PAYMENT,Current,2023-08-20 08:09:09,2023-08-21 10:42:11,Carnaxide Wtc,-1.9,0,EUR,COMPLETED,339.11
CARD_PAYMENT,Current,2023-08-20 09:27:14,2023-08-21 10:42:30,Auchan,-26.97,0,EUR,COMPLETED,312.14
CARD_PAYMENT,Current,2023-08-20 09:42:12,2023-08-21 10:42:36,Pingo Doce,-11.81,0,EUR,COMPLETED,300.33
CARD_PAYMENT,Current,2023-08-19 08:07:36,2023-08-21 11:56:20,Carnaxide Wtc,-1.9,0,EUR,COMPLETED,298.43
CARD_PAYMENT,Current,2023-08-20 13:16:34,2023-08-21 12:22:14,Uber Eats,-45.94,0,EUR,COMPLETED,252.49
TOPUP,Current,2023-08-22 10:54:22,2023-08-22 10:54:32,Apple Pay Top-Up by *6660,200,0,EUR,COMPLETED,452.49
TRANSFER,Current,2023-08-22 10:55:55,2023-08-22 10:55:55,Revolut Bank UAB,-100,0,EUR,COMPLETED,352.49
TRANSFER,Current,2023-08-23 09:14:49,2023-08-23 09:14:49,To EUR Savings,-0.05,0,EUR,COMPLETED,352.44
TRANSFER,Current,2023-08-23 09:55:26,2023-08-23 09:55:26,To EUR Savings,-0.65,0,EUR,COMPLETED,351.79
TRANSFER,Current,2023-08-24 08:00:16,2023-08-24 08:00:16,Revolut Bank UAB,406,0,EUR,COMPLETED,757.79
TRANSFER,Current,2023-08-24 08:11:03,2023-08-24 08:11:03,To EUR Savings,-0.25,0,EUR,COMPLETED,757.54
TRANSFER,Current,2023-08-24 12:39:55,2023-08-24 12:39:55,To EUR Savings,-0.08,0,EUR,COMPLETED,757.46
CARD_PAYMENT,Current,2023-08-23 09:55:26,2023-08-24 14:57:15,Carnaxide Wtc,-4.35,0,EUR,COMPLETED,753.11
CARD_PAYMENT,Current,2023-08-23 09:14:48,2023-08-24 15:02:56,Pad Port Miraflores,-3.95,0,EUR,COMPLETED,749.16
TRANSFER,Current,2023-08-24 19:11:04,2023-08-24 19:11:04,To EUR Savings,-0.5,0,EUR,COMPLETED,748.66
TRANSFER,Current,2023-08-25 08:04:28,2023-08-25 08:04:28,To EUR Savings,-0.25,0,EUR,COMPLETED,748.41
CARD_PAYMENT,Current,2023-08-24 12:39:54,2023-08-25 10:53:33,Uber Eats,-32.92,0,EUR,COMPLETED,715.49
CARD_PAYMENT,Current,2023-08-24 19:11:03,2023-08-25 11:24:43,Bilheteira Jbt,-12.5,0,EUR,COMPLETED,702.99
CARD_PAYMENT,Current,2023-08-24 08:11:03,2023-08-25 16:58:50,Carnaxide Wtc,-2.75,0,EUR,COMPLETED,700.24
TRANSFER,Current,2023-08-25 21:17:37,2023-08-25 21:17:37,To EUR Savings,-0.78,0,EUR,COMPLETED,699.46
TRANSFER,Current,2023-08-25 23:58:42,2023-08-25 23:58:42,To EUR Savings,-0.76,0,EUR,COMPLETED,698.7
TRANSFER,Current,2023-08-26 07:50:54,2023-08-26 07:50:54,To EUR Savings,-0.05,0,EUR,COMPLETED,698.65
TRANSFER,Current,2023-08-26 11:31:11,2023-08-26 11:31:11,To EUR Savings,-0.31,0,EUR,COMPLETED,698.34
CARD_PAYMENT,Current,2023-08-25 08:04:28,2023-08-26 17:03:43,Carnaxide Wtc,-2.75,0,EUR,COMPLETED,695.59
TRANSFER,Current,2023-08-27 00:32:23,2023-08-27 00:32:23,To EUR Savings,-0.01,0,EUR,COMPLETED,695.58
TRANSFER,Current,2023-08-27 00:34:07,2023-08-27 00:34:07,To EUR Savings,-0.51,0,EUR,COMPLETED,695.07
TRANSFER,Current,2023-08-27 08:24:24,2023-08-27 08:24:24,To EUR Savings,-0.25,0,EUR,COMPLETED,694.82
TRANSFER,Current,2023-08-27 08:57:03,2023-08-27 08:57:03,To EUR Savings,-0.52,0,EUR,COMPLETED,694.3
TRANSFER,Current,2023-08-27 09:06:15,2023-08-27 09:06:15,To EUR Savings,-0.64,0,EUR,COMPLETED,693.66
CARD_PAYMENT,Current,2023-08-25 21:17:37,2023-08-27 10:28:36,Uber,-16.27,0,EUR,COMPLETED,677.39
CARD_PAYMENT,Current,2023-08-25 23:58:42,2023-08-27 10:52:21,Uber,-14.24,0,EUR,COMPLETED,663.15
CARD_PAYMENT,Current,2023-08-26 11:31:11,2023-08-27 11:16:47,Minipreço,-3.69,0,EUR,COMPLETED,659.46
TRANSFER,Current,2023-08-27 13:08:35,2023-08-27 13:08:35,To EUR Savings,-0.93,0,EUR,COMPLETED,658.53
TRANSFER,Current,2023-08-27 13:18:54,2023-08-27 13:18:54,To EUR Savings,-0.44,0,EUR,COMPLETED,658.09
CARD_PAYMENT,Current,2023-08-26 07:50:54,2023-08-27 19:30:26,Pad Port Miraflores,-3.95,0,EUR,COMPLETED,654.14
CARD_PAYMENT,Current,2023-08-27 22:59:48,,Uber,-9.26,0,EUR,REVERTED,
TRANSFER,Current,2023-08-27 22:59:48,2023-08-27 22:59:48,To EUR Savings,-0.74,0,EUR,COMPLETED,653.4
CARD_PAYMENT,Current,2023-08-27 23:04:00,,Uber,-9.26,0,EUR,REVERTED,
TRANSFER,Current,2023-08-27 23:04:00,2023-08-27 23:04:00,To EUR Savings,-0.74,0,EUR,COMPLETED,652.66
CARD_PAYMENT,Current,2023-08-27 23:08:01,,Uber,-9.36,0,EUR,REVERTED,
TRANSFER,Current,2023-08-27 23:08:01,2023-08-27 23:08:01,To EUR Savings,-0.64,0,EUR,COMPLETED,652.02
TRANSFER,Current,2023-08-27 23:16:36,2023-08-27 23:16:36,Revolut Bank UAB,-10,0,EUR,COMPLETED,642.02
CARD_PAYMENT,Current,2023-08-27 00:32:22,2023-08-28 09:55:59,Apple,-1.99,0,EUR,COMPLETED,640.03
CARD_PAYMENT,Current,2023-08-27 00:34:07,2023-08-28 10:09:43,Apple,-5.49,0,EUR,COMPLETED,634.54
CARD_PAYMENT,Current,2023-08-27 13:08:35,2023-08-28 10:13:50,Minipreço,-7.07,0,EUR,COMPLETED,627.47
TRANSFER,Current,2023-08-28 10:17:03,2023-08-28 10:17:03,To EUR Savings,-20,0,EUR,COMPLETED,607.47
CARD_PAYMENT,Current,2023-08-27 13:18:53,2023-08-28 10:25:12,Uber Eats,-28.56,0,EUR,COMPLETED,578.91
CARD_PAYMENT,Current,2023-08-27 08:24:24,2023-08-28 12:04:38,Carnaxide Wtc,-2.75,0,EUR,COMPLETED,576.16
CARD_PAYMENT,Current,2023-08-27 09:06:15,2023-08-28 12:04:41,Pingo Doce,-11.36,0,EUR,COMPLETED,564.8
CARD_PAYMENT,Current,2023-08-27 08:57:03,2023-08-28 12:04:41,Carnaxide Wtc,-3.48,0,EUR,COMPLETED,561.32
TRANSFER,Current,2023-08-28 14:04:16,2023-08-28 14:04:16,To EUR Savings,-0.01,0,EUR,COMPLETED,561.31
CARD_PAYMENT,Current,2023-08-28 14:04:15,2023-08-29 10:36:47,Google,-2.99,0,EUR,COMPLETED,558.32
TRANSFER,Current,2023-08-30 02:53:41,2023-08-30 02:53:41,To EUR Savings,-0.05,0,EUR,COMPLETED,558.27
CARD_PAYMENT,Current,2023-08-30 02:53:41,2023-08-31 10:56:22,Apple,-18.95,0,EUR,COMPLETED,539.32
TRANSFER,Current,2023-08-31 12:37:55,2023-08-31 12:37:55,To EUR Savings,-0.08,0,EUR,COMPLETED,539.24
CARD_PAYMENT,Current,2023-08-31 12:37:55,2023-09-01 10:01:54,Uber Eats,-32.92,0,EUR,COMPLETED,506.32
TRANSFER,Current,2023-09-01 21:56:20,2023-09-01 21:56:20,To EUR Savings,-0.93,0,EUR,COMPLETED,505.39
TRANSFER,Current,2023-09-02 07:39:50,2023-09-02 07:39:50,To EUR Savings,-0.05,0,EUR,COMPLETED,505.34
TRANSFER,Current,2023-09-02 11:26:55,2023-09-02 11:26:55,To EUR Savings,-0.18,0,EUR,COMPLETED,505.16
TRANSFER,Current,2023-09-03 08:05:01,2023-09-03 08:05:01,To EUR Savings,-0.25,0,EUR,COMPLETED,504.91
TRANSFER,Current,2023-09-03 09:54:30,2023-09-03 09:54:30,To EUR Savings,-0.2,0,EUR,COMPLETED,504.71
TRANSFER,Current,2023-09-03 10:15:35,2023-09-03 10:15:35,To EUR Savings,-0.32,0,EUR,COMPLETED,504.39
CARD_PAYMENT,Current,2023-09-01 21:56:20,2023-09-03 11:03:09,Rest Menu Flutuante,-26.07,0,EUR,COMPLETED,478.32
CARD_PAYMENT,Current,2023-09-02 11:26:55,2023-09-03 11:03:56,Minipreço,-5.82,0,EUR,COMPLETED,472.5
CARD_PAYMENT,Current,2023-09-02 07:39:49,2023-09-03 14:53:41,Pad Port Miraflores,-3.95,0,EUR,COMPLETED,468.55
TRANSFER,Current,2023-09-04 10:15:14,2023-09-04 10:15:14,To EUR Savings,-20,0,EUR,COMPLETED,448.55
TRANSFER,Current,2023-09-04 20:15:40,2023-09-04 20:15:40,To EUR Savings,-0.36,0,EUR,COMPLETED,448.19
CARD_PAYMENT,Current,2023-09-03 08:05:00,2023-09-05 09:18:52,Carnaxide Wtc,-2.75,0,EUR,COMPLETED,445.44
CARD_PAYMENT,Current,2023-09-03 09:54:30,2023-09-05 09:18:55,Auchan,-50.8,0,EUR,COMPLETED,394.64
CARD_PAYMENT,Current,2023-09-03 10:15:34,2023-09-05 09:18:58,Pingo Doce,-15.68,0,EUR,COMPLETED,378.96
TRANSFER,Current,2023-09-05 17:43:24,2023-09-05 17:43:24,To EUR Savings,-0.66,0,EUR,COMPLETED,378.3
CARD_PAYMENT,Current,2023-09-05 17:43:23,2023-09-06 03:09:02,GitHub,-9.34,0,EUR,COMPLETED,368.96
CARD_PAYMENT,Current,2023-09-04 20:15:40,2023-09-06 10:22:07,Minipreço,-8.64,0,EUR,COMPLETED,360.32
TRANSFER,Current,2023-09-07 12:52:39,2023-09-07 12:52:39,To EUR Savings,-0.83,0,EUR,COMPLETED,359.49
TRANSFER,Current,2023-09-08 14:03:03,2023-09-08 14:03:03,To EUR Savings,-1,0,EUR,COMPLETED,358.49
CARD_PAYMENT,Current,2023-09-07 12:52:39,2023-09-08 14:15:02,Uber Eats,-33.17,0,EUR,COMPLETED,325.32
TRANSFER,Current,2023-09-08 19:27:06,2023-09-08 19:27:06,To EUR Savings,-0.5,0,EUR,COMPLETED,324.82
TRANSFER,Current,2023-09-09 08:26:43,2023-09-09 08:26:43,To EUR Savings,-0.1,0,EUR,COMPLETED,324.72
CARD_PAYMENT,Current,2023-09-08 19:27:06,2023-09-09 11:37:26,Cinemas NOS,-14.5,0,EUR,COMPLETED,310.22
TRANSFER,Current,2023-09-10 08:27:00,2023-09-10 08:27:00,To EUR Savings,-0.1,0,EUR,COMPLETED,310.12
TRANSFER,Current,2023-09-10 12:07:24,2023-09-10 12:07:24,To EUR Savings,-0.03,0,EUR,COMPLETED,310.09
CARD_PAYMENT,Current,2023-09-09 08:26:42,2023-09-10 14:16:30,Carnaxide Wtc,-1.9,0,EUR,COMPLETED,308.19
CARD_PAYMENT,Current,2023-09-10 12:07:24,2023-09-11 09:39:12,Uber Eats,-34.97,0,EUR,COMPLETED,273.22
CARD_PAYMENT,Current,2023-09-08 14:03:03,2023-09-11 09:51:11,Nos Cinemas,-15,0,EUR,COMPLETED,258.22
TRANSFER,Current,2023-09-11 10:14:09,2023-09-11 10:14:09,To EUR Savings,-20,0,EUR,COMPLETED,238.22
CARD_PAYMENT,Current,2023-09-10 08:27:00,2023-09-11 11:32:07,Carnaxide Wtc,-1.9,0,EUR,COMPLETED,236.32
TRANSFER,Current,2023-09-12 12:51:34,2023-09-12 12:51:34,To EUR Savings,-0.94,0,EUR,COMPLETED,235.38
CARD_PAYMENT,Current,2023-09-12 12:51:34,2023-09-13 10:00:50,Uber Eats,-18.06,0,EUR,COMPLETED,217.32
TRANSFER,Current,2023-09-13 20:23:58,2023-09-13 20:23:58,To EUR Savings,-0.02,0,EUR,COMPLETED,217.3
TRANSFER,Current,2023-09-14 12:43:38,2023-09-14 12:43:38,To EUR Savings,-0.72,0,EUR,COMPLETED,216.58
CARD_PAYMENT,Current,2023-09-13 20:23:58,2023-09-15 10:35:51,Uber Eats,-50.98,0,EUR,COMPLETED,165.6
CARD_PAYMENT,Current,2023-09-14 12:43:38,2023-09-15 10:41:19,Uber Eats,-22.28,0,EUR,COMPLETED,143.32
TRANSFER,Current,2023-09-16 08:40:25,2023-09-16 08:40:25,To EUR Savings,-0.05,0,EUR,COMPLETED,143.27
TOPUP,Current,2023-09-16 21:01:34,2023-09-16 21:01:37,Apple Pay Top-Up by *6660,200,0,EUR,COMPLETED,343.27
TRANSFER,Current,2023-09-17 08:23:28,2023-09-17 08:23:28,To EUR Savings,-0.1,0,EUR,COMPLETED,343.17
TRANSFER,Current,2023-09-17 09:07:44,2023-09-17 09:07:44,To EUR Savings,-0.8,0,EUR,COMPLETED,342.37
TRANSFER,Current,2023-09-17 12:29:46,2023-09-17 12:29:46,To EUR Savings,-0.95,0,EUR,COMPLETED,341.42
TRANSFER,Current,2023-09-17 13:34:52,2023-09-17 13:34:52,To EUR Savings,-0.01,0,EUR,COMPLETED,341.41
CARD_PAYMENT,Current,2023-09-16 08:40:25,2023-09-17 17:48:29,A Padaria Portuguesa,-3.95,0,EUR,COMPLETED,337.46
TRANSFER,Current,2023-09-17 21:40:59,2023-09-17 21:40:59,To EUR Savings,-0.51,0,EUR,COMPLETED,336.95
CARD_PAYMENT,Current,2023-09-17 12:29:46,2023-09-18 09:43:34,Uber Eats,-19.05,0,EUR,COMPLETED,317.9
CARD_PAYMENT,Current,2023-09-17 13:34:52,2023-09-18 10:10:33,Apple,-5.99,0,EUR,COMPLETED,311.91
TRANSFER,Current,2023-09-18 10:12:50,2023-09-18 10:12:50,To EUR Savings,-20,0,EUR,COMPLETED,291.91
CARD_PAYMENT,Current,2023-09-17 09:07:44,2023-09-18 11:10:30,Pingo Doce,-24.2,0,EUR,COMPLETED,267.71
CARD_PAYMENT,Current,2023-09-17 08:23:28,2023-09-18 11:10:30,Carnaxide Wtc,-1.9,0,EUR,COMPLETED,265.81
TRANSFER,Current,2023-09-18 20:05:36,2023-09-18 20:05:36,To EUR Savings,-0.15,0,EUR,COMPLETED,265.66
CARD_PAYMENT,Current,2023-09-17 21:40:59,2023-09-19 09:49:24,YouTube,-8.49,0,EUR,COMPLETED,257.17
CARD_PAYMENT,Current,2023-09-18 20:05:36,2023-09-20 10:53:25,Minipreço,-12.85,0,EUR,COMPLETED,244.32
CARD_PAYMENT,Current,2023-09-21 13:09:59,,Uber,-0.7,0,EUR,REVERTED,
TRANSFER,Current,2023-09-21 13:09:59,2023-09-21 13:09:59,To EUR Savings,-0.3,0,EUR,COMPLETED,244.02
TRANSFER,Current,2023-09-21 13:11:12,2023-09-21 13:11:12,To EUR Savings,-0.3,0,EUR,COMPLETED,243.72
TRANSFER,Current,2023-09-23 08:25:10,2023-09-23 08:25:10,To EUR Savings,-0.1,0,EUR,COMPLETED,243.62
TRANSFER,Current,2023-09-23 21:43:16,2023-09-23 21:43:16,To EUR Savings,-0.01,0,EUR,COMPLETED,243.61
TOPUP,Current,2023-09-23 22:02:44,2023-09-23 22:02:47,Apple Pay Top-Up by *6660,200,0,EUR,COMPLETED,443.61
TRANSFER,Current,2023-09-24 08:08:17,2023-09-24 08:08:17,To EUR Savings,-0.1,0,EUR,COMPLETED,443.51
TRANSFER,Current,2023-09-24 09:06:41,2023-09-24 09:06:41,To EUR Savings,-0.45,0,EUR,COMPLETED,443.06
CARD_PAYMENT,Current,2023-09-21 13:11:12,2023-09-24 09:26:20,Uber Eats,-39.7,0,EUR,COMPLETED,403.36
CARD_PAYMENT,Current,2023-09-23 08:25:10,2023-09-24 14:57:23,Carnaxide Wtc,-1.9,0,EUR,COMPLETED,401.46
CARD_PAYMENT,Current,2023-09-24 08:08:17,2023-09-25 09:26:15,Carnaxide Wtc,-1.9,0,EUR,COMPLETED,399.56
CARD_PAYMENT,Current,2023-09-24 09:06:41,2023-09-25 09:26:19,Pingo Doce,-13.55,0,EUR,COMPLETED,386.01
CARD_PAYMENT,Current,2023-09-23 21:43:16,2023-09-25 09:52:53,PlayStation,-39.99,0,EUR,COMPLETED,346.02
TRANSFER,Current,2023-09-25 10:15:51,2023-09-25 10:15:51,To EUR Savings,-20,0,EUR,COMPLETED,326.02
TRANSFER,Current,2023-09-27 00:32:34,2023-09-27 00:32:34,To EUR Savings,-0.01,0,EUR,COMPLETED,326.01
TRANSFER,Current,2023-09-27 00:34:14,2023-09-27 00:34:14,To EUR Savings,-0.51,0,EUR,COMPLETED,325.5
CARD_PAYMENT,Current,2023-09-27 00:32:34,2023-09-28 09:51:59,Apple,-1.99,0,EUR,COMPLETED,323.51
CARD_PAYMENT,Current,2023-09-27 00:34:14,2023-09-28 09:56:41,Apple,-5.49,0,EUR,COMPLETED,318.02
TRANSFER,Current,2023-09-28 12:57:52,2023-09-28 12:57:52,To EUR Savings,-0.2,0,EUR,COMPLETED,317.82
TRANSFER,Current,2023-09-28 14:03:43,2023-09-28 14:03:43,To EUR Savings,-0.01,0,EUR,COMPLETED,317.81
CARD_PAYMENT,Current,2023-09-28 14:03:43,2023-09-29 11:25:26,Google,-2.99,0,EUR,COMPLETED,314.82
CARD_PAYMENT,Current,2023-09-28 12:57:52,2023-09-29 12:07:19,Uber Eats,-29.8,0,EUR,COMPLETED,285.02
TRANSFER,Current,2023-09-29 18:08:27,2023-09-29 18:08:27,To EUR Savings,-0.26,0,EUR,COMPLETED,284.76
TRANSFER,Current,2023-09-29 20:22:12,2023-09-29 20:22:12,To EUR Savings,-0.91,0,EUR,COMPLETED,283.85
TRANSFER,Current,2023-09-29 22:44:00,2023-09-29 22:44:00,To EUR Savings,-0.01,0,EUR,COMPLETED,283.84
TRANSFER,Current,2023-09-30 02:54:16,2023-09-30 02:54:16,To EUR Savings,-0.05,0,EUR,COMPLETED,283.79
TRANSFER,Current,2023-09-30 08:06:58,2023-09-30 08:06:58,To EUR Savings,-0.1,0,EUR,COMPLETED,283.69
TRANSFER,Current,2023-09-30 09:14:41,2023-09-30 09:14:41,To EUR Savings,-0.14,0,EUR,COMPLETED,283.55
TRANSFER,Current,2023-10-01 08:13:59,2023-10-01 08:13:59,To EUR Savings,-0.1,0,EUR,COMPLETED,283.45
CARD_PAYMENT,Current,2023-09-30 08:06:58,2023-10-01 10:18:27,Carnaxide Wtc,-1.9,0,EUR,COMPLETED,281.55
CARD_PAYMENT,Current,2023-09-30 09:14:41,2023-10-01 10:18:27,Auchan,-31.86,0,EUR,COMPLETED,249.69
CARD_PAYMENT,Current,2023-09-29 22:44:00,2023-10-01 10:23:50,PlayStation,-39.99,0,EUR,COMPLETED,209.7
CARD_PAYMENT,Current,2023-09-29 18:08:27,2023-10-01 10:23:50,Instant Gaming,-13.74,0,EUR,COMPLETED,195.96
TRANSFER,Current,2023-10-01 12:51:41,2023-10-01 12:51:41,To EUR Savings,-0.1,0,EUR,COMPLETED,195.86
TRANSFER,Current,2023-10-01 12:52:46,2023-10-01 12:52:46,To EUR Savings,-0.1,0,EUR,COMPLETED,195.76
TRANSFER,Current,2023-10-01 13:00:57,2023-10-01 13:00:57,To EUR Savings,-0.5,0,EUR,COMPLETED,195.26
TRANSFER,Current,2023-10-01 13:39:53,2023-10-01 13:39:53,To EUR Savings,-1,0,EUR,COMPLETED,194.26
TRANSFER,Current,2023-10-01 14:21:10,2023-10-01 14:21:10,To EUR Savings,-0.01,0,EUR,COMPLETED,194.25
CARD_PAYMENT,Current,2023-09-30 02:54:16,2023-10-01 15:06:18,Apple,-18.95,0,EUR,COMPLETED,175.3
TOPUP,Current,2023-10-01 15:53:23,2023-10-01 15:53:33,Apple Pay Top-Up by *6660,200,0,EUR,COMPLETED,375.3
TRANSFER,Current,2023-10-01 19:38:16,2023-10-01 19:38:16,To EUR Savings,-0.5,0,EUR,COMPLETED,374.8
CARD_PAYMENT,Current,2023-10-01 19:38:16,2023-10-02 09:40:59,Jean Louis David,-18.5,0,EUR,COMPLETED,356.3
CARD_REFUND,Current,2023-10-01 09:00:06,2023-10-02 09:42:35,Instant Gaming,13.74,0,EUR,COMPLETED,370.04
CARD_PAYMENT,Current,2023-10-01 12:51:41,2023-10-02 09:46:55,Puro Italiano,-10.9,0,EUR,COMPLETED,359.14
CARD_PAYMENT,Current,2023-10-01 08:13:59,2023-10-02 09:47:00,Carnaxide Wtc,-1.9,0,EUR,COMPLETED,357.24
TRANSFER,Current,2023-10-02 10:17:33,2023-10-02 10:17:33,To EUR Savings,-20,0,EUR,COMPLETED,337.24
CARD_PAYMENT,Current,2023-09-29 20:22:12,2023-10-02 10:24:07,Uber Eats,-29.09,0,EUR,COMPLETED,308.15
CARD_PAYMENT,Current,2023-10-01 13:00:56,2023-10-02 10:26:59,Mercado de Algés,-15.5,0,EUR,COMPLETED,292.65
CARD_PAYMENT,Current,2023-10-01 13:39:53,2023-10-02 10:26:59,Mercado De Alges,-7,0,EUR,COMPLETED,285.65
CARD_PAYMENT,Current,2023-10-01 12:52:45,2023-10-02 10:26:59,Receita Pomposa,-12.9,0,EUR,COMPLETED,272.75
CARD_PAYMENT,Current,2023-10-01 14:21:10,2023-10-02 10:37:16,PlayStation,-8.99,0,EUR,COMPLETED,263.76
TRANSFER,Current,2023-10-04 20:10:38,2023-10-04 20:10:38,Revolut Bank UAB,-12,0,EUR,COMPLETED,251.76
TRANSFER,Current,2023-10-05 08:16:10,2023-10-05 08:16:10,To EUR Savings,-0.1,0,EUR,COMPLETED,251.66
TRANSFER,Current,2023-10-05 11:34:16,2023-10-05 11:34:16,To EUR Savings,-0.56,0,EUR,COMPLETED,251.1
TRANSFER,Current,2023-10-05 11:36:27,2023-10-05 11:36:27,To EUR Savings,-0.27,0,EUR,COMPLETED,250.83
TRANSFER,Current,2023-10-05 17:58:16,2023-10-05 17:58:16,To EUR Savings,-0.48,0,EUR,COMPLETED,250.35
CARD_PAYMENT,Current,2023-10-05 17:58:15,2023-10-06 03:25:45,GitHub,-9.52,0,EUR,COMPLETED,240.83
CARD_PAYMENT,Current,2023-10-05 11:36:27,2023-10-06 10:13:07,Gleba,-3.73,0,EUR,COMPLETED,237.1
CARD_PAYMENT,Current,2023-10-05 11:34:16,2023-10-06 10:13:07,Auchan,-58.44,0,EUR,COMPLETED,178.66
CARD_PAYMENT,Current,2023-10-05 08:16:10,2023-10-06 10:20:04,Carnaxide Wtc,-1.9,0,EUR,COMPLETED,176.76
TRANSFER,Current,2023-10-06 12:51:27,2023-10-06 12:51:27,To EUR Savings,-0.2,0,EUR,COMPLETED,176.56
TRANSFER,Current,2023-10-07 08:13:48,2023-10-07 08:13:48,To EUR Savings,-0.1,0,EUR,COMPLETED,176.46
TRANSFER,Current,2023-10-07 09:39:48,2023-10-07 09:39:48,To EUR Savings,-0.65,0,EUR,COMPLETED,175.81
TRANSFER,Current,2023-10-07 13:14:41,2023-10-07 13:14:41,To EUR Savings,-1,0,EUR,COMPLETED,174.81
TRANSFER,Current,2023-10-08 08:19:40,2023-10-08 08:19:40,To EUR Savings,-0.1,0,EUR,COMPLETED,174.71
TRANSFER,Current,2023-10-08 09:13:19,2023-10-08 09:13:19,To EUR Savings,-0.23,0,EUR,COMPLETED,174.48
TOPUP,Current,2023-10-08 13:09:53,2023-10-08 13:09:58,Apple Pay Top-Up by *6660,400,0,EUR,COMPLETED,574.48
CARD_PAYMENT,Current,2023-10-07 09:39:48,2023-10-08 15:15:36,Carnaxide Wtc,-4.35,0,EUR,COMPLETED,570.13
CARD_PAYMENT,Current,2023-10-07 08:13:48,2023-10-08 15:15:54,Carnaxide Wtc,-1.9,0,EUR,COMPLETED,568.23
CARD_PAYMENT,Current,2023-10-07 13:14:41,2023-10-08 16:15:11,Saisish,-59,0,EUR,COMPLETED,509.23
CARD_PAYMENT,Current,2023-10-08 08:19:40,2023-10-09 10:00:47,Carnaxide Wtc,-1.9,0,EUR,COMPLETED,507.33
CARD_PAYMENT,Current,2023-10-08 09:13:19,2023-10-09 10:00:51,Pingo Doce,-31.77,0,EUR,COMPLETED,475.56
TRANSFER,Current,2023-10-09 10:12:31,2023-10-09 10:12:31,To EUR Savings,-20,0,EUR,COMPLETED,455.56
CARD_PAYMENT,Current,2023-10-06 12:51:27,2023-10-09 11:02:15,Uber Eats,-29.8,0,EUR,COMPLETED,425.76
TRANSFER,Current,2023-10-12 12:41:33,2023-10-12 12:41:33,To EUR Savings,-0.7,0,EUR,COMPLETED,425.06
TRANSFER,Current,2023-10-14 08:15:44,2023-10-14 08:15:44,To EUR Savings,-0.1,0,EUR,COMPLETED,424.96
CARD_PAYMENT,Current,2023-10-12 12:41:33,2023-10-14 13:40:42,Uber Eats,-34.3,0,EUR,COMPLETED,390.66
TRANSFER,Current,2023-10-14 15:27:07,2023-10-14 15:27:07,To EUR Savings,-0.1,0,EUR,COMPLETED,390.56
TRANSFER,Current,2023-10-14 16:08:38,2023-10-14 16:08:38,To EUR Savings,-1,0,EUR,COMPLETED,389.56
TRANSFER,Current,2023-10-15 08:20:20,2023-10-15 08:20:20,To EUR Savings,-0.1,0,EUR,COMPLETED,389.46
TRANSFER,Current,2023-10-15 09:05:17,2023-10-15 09:05:17,To EUR Savings,-0.45,0,EUR,COMPLETED,389.01
CARD_PAYMENT,Current,2023-10-14 16:08:38,2023-10-15 11:27:54,Bacalhoa Enoturismo,-18,0,EUR,COMPLETED,371.01
TRANSFER,Current,2023-10-15 13:08:42,2023-10-15 13:08:42,To EUR Savings,-0.11,0,EUR,COMPLETED,370.9
CARD_PAYMENT,Current,2023-10-14 15:27:07,2023-10-15 18:00:48,Taberna 22,-61.9,0,EUR,COMPLETED,309
CARD_PAYMENT,Current,2023-10-14 08:15:44,2023-10-15 18:02:41,Carnaxide Wtc,-1.9,0,EUR,COMPLETED,307.1
TRANSFER,Current,2023-10-16 10:14:37,2023-10-16 10:14:37,To EUR Savings,-20,0,EUR,COMPLETED,287.1
CARD_PAYMENT,Current,2023-10-15 13:08:42,2023-10-16 10:50:42,Minipreço,-8.89,0,EUR,COMPLETED,278.21
CARD_PAYMENT,Current,2023-10-15 08:20:20,2023-10-16 12:41:01,Carnaxide Wtc,-1.9,0,EUR,COMPLETED,276.31
CARD_PAYMENT,Current,2023-10-15 09:05:17,2023-10-16 12:41:07,Pingo Doce,-13.55,0,EUR,COMPLETED,262.76
TRANSFER,Current,2023-10-17 05:36:07,2023-10-17 05:36:07,To EUR Savings,-0.01,0,EUR,COMPLETED,262.75
TRANSFER,Current,2023-10-17 21:40:58,2023-10-17 21:40:58,To EUR Savings,-0.51,0,EUR,COMPLETED,262.24
CARD_PAYMENT,Current,2023-10-17 05:36:07,2023-10-18 09:52:29,Apple,-5.99,0,EUR,COMPLETED,256.25
CARD_PAYMENT,Current,2023-10-17 21:40:58,2023-10-19 14:36:46,YouTube,-8.49,0,EUR,COMPLETED,247.76
TRANSFER,Current,2023-10-20 13:04:34,2023-10-20 13:04:34,To EUR Savings,-0.2,0,EUR,COMPLETED,247.56
TRANSFER,Current,2023-10-20 13:10:03,2023-10-20 13:10:03,To EUR Savings,-0.01,0,EUR,COMPLETED,247.55
TRANSFER,Current,2023-10-21 08:12:07,2023-10-21 08:12:07,To EUR Savings,-0.1,0,EUR,COMPLETED,247.45
TOPUP,Current,2023-10-21 08:30:53,2023-10-21 08:30:55,Apple Pay Top-Up by *6660,200,0,EUR,COMPLETED,447.45
TRANSFER,Current,2023-10-21 10:47:13,2023-10-21 10:47:13,To EUR Savings,-1,0,EUR,COMPLETED,446.45
CARD_PAYMENT,Current,2023-10-20 13:10:03,2023-10-21 12:20:01,Uber,-4.99,0,EUR,COMPLETED,441.46
TRANSFER,Current,2023-10-21 15:26:35,2023-10-21 15:26:35,To EUR Savings,-0.1,0,EUR,COMPLETED,441.36
TRANSFER,Current,2023-10-22 08:33:13,2023-10-22 08:33:13,To EUR Savings,-0.05,0,EUR,COMPLETED,441.31
CARD_PAYMENT,Current,2023-10-20 13:04:34,2023-10-22 09:52:17,Uber Eats,-29.8,0,EUR,COMPLETED,411.51
CARD_PAYMENT,Current,2023-10-21 15:26:34,2023-10-22 10:33:01,Ricrem I,-100.9,0,EUR,COMPLETED,310.61
CARD_PAYMENT,Current,2023-10-21 10:47:12,2023-10-22 18:41:30,Restaurant,-4,0,EUR,COMPLETED,306.61
CARD_PAYMENT,Current,2023-10-21 08:12:07,2023-10-22 18:43:03,Carnaxide Wtc,-1.9,0,EUR,COMPLETED,304.71
TRANSFER,Current,2023-10-23 10:11:44,2023-10-23 10:11:44,To EUR Savings,-20,0,EUR,COMPLETED,284.71
CARD_PAYMENT,Current,2023-10-22 08:33:12,2023-10-23 12:42:49,A Padaria Portuguesa,-3.95,0,EUR,COMPLETED,280.76
TRANSFER,Current,2023-10-23 12:56:08,2023-10-23 12:56:08,To EUR Savings,-0.01,0,EUR,COMPLETED,280.75
TRANSFER,Current,2023-10-24 13:23:13,2023-10-24 13:23:13,To EUR Savings,-0.01,0,EUR,COMPLETED,280.74
CARD_PAYMENT,Current,2023-10-23 12:56:08,2023-10-25 10:48:32,Apple,-9.99,0,EUR,COMPLETED,270.75
TRANSFER,Current,2023-10-25 19:07:47,2023-10-25 19:07:47,To EUR Savings,-1,0,EUR,COMPLETED,269.75
TRANSFER,Current,2023-10-25 19:41:15,2023-10-25 19:41:15,To EUR Savings,-0.2,0,EUR,COMPLETED,269.55
CARD_PAYMENT,Current,2023-10-24 13:23:13,2023-10-26 10:53:13,Google,-2.99,0,EUR,COMPLETED,266.56
CARD_PAYMENT,Current,2023-10-25 19:41:15,2023-10-26 11:32:44,Musa,-51.8,0,EUR,COMPLETED,214.76
CARD_PAYMENT,Current,2023-10-25 19:07:47,2023-10-26 11:32:44,Musa,-25,0,EUR,COMPLETED,189.76
TRANSFER,Current,2023-10-26 12:55:43,2023-10-26 12:55:43,To EUR Savings,-0.2,0,EUR,COMPLETED,189.56
TRANSFER,Current,2023-10-27 00:32:43,2023-10-27 00:32:43,To EUR Savings,-0.01,0,EUR,COMPLETED,189.55
TRANSFER,Current,2023-10-27 00:35:04,2023-10-27 00:35:04,To EUR Savings,-0.51,0,EUR,COMPLETED,189.04
TOPUP,Current,2023-10-27 14:28:11,2023-10-27 14:28:15,Apple Pay Top-Up by *6660,400,0,EUR,COMPLETED,589.04
TRANSFER,Current,2023-10-27 14:29:34,2023-10-27 14:29:34,To EUR Savings,-0.6,0,EUR,COMPLETED,588.44
TRANSFER,Current,2023-10-28 08:08:46,2023-10-28 08:08:46,To EUR Savings,-0.1,0,EUR,COMPLETED,588.34
TRANSFER,Current,2023-10-28 09:00:32,2023-10-28 09:00:32,To EUR Savings,-0.02,0,EUR,COMPLETED,588.32
CARD_PAYMENT,Current,2023-10-27 00:35:04,2023-10-28 13:49:25,Apple,-5.49,0,EUR,COMPLETED,582.83
CARD_PAYMENT,Current,2023-10-27 00:32:43,2023-10-28 13:50:28,Apple,-1.99,0,EUR,COMPLETED,580.84
TRANSFER,Current,2023-10-28 14:03:43,2023-10-28 14:03:43,To EUR Savings,-0.01,0,EUR,COMPLETED,580.83
CARD_PAYMENT,Current,2023-10-26 12:55:43,2023-10-28 14:37:43,Uber Eats,-29.8,0,EUR,COMPLETED,551.03
TRANSFER,Current,2023-10-28 17:48:28,2023-10-28 17:48:28,To EUR Savings,-0.5,0,EUR,COMPLETED,550.53
TRANSFER,Current,2023-10-28 21:18:57,2023-10-28 21:18:57,To EUR Savings,-0.1,0,EUR,COMPLETED,550.43
TRANSFER,Current,2023-10-29 07:47:21,2023-10-29 07:47:21,To EUR Savings,-1,0,EUR,COMPLETED,549.43
TRANSFER,Current,2023-10-29 08:05:46,2023-10-29 08:05:46,To EUR Savings,-0.05,0,EUR,COMPLETED,549.38
TRANSFER,Current,2023-10-29 09:21:38,2023-10-29 09:21:38,To EUR Savings,-1,0,EUR,COMPLETED,548.38
CARD_PAYMENT,Current,2023-10-28 17:48:28,2023-10-29 09:46:36,IKEA,-7.5,0,EUR,COMPLETED,540.88
TRANSFER,Current,2023-10-29 11:37:57,2023-10-29 11:37:57,To EUR Savings,-1,0,EUR,COMPLETED,539.88
TRANSFER,Current,2023-10-29 12:41:27,2023-10-29 12:41:27,To EUR Savings,-0.3,0,EUR,COMPLETED,539.58
CARD_PAYMENT,Current,2023-10-28 21:18:57,2023-10-29 13:28:38,Meson Serranito,-41.9,0,EUR,COMPLETED,497.68
CARD_PAYMENT,Current,2023-10-28 08:08:46,2023-10-29 14:12:30,Carnaxide Wtc,-1.9,0,EUR,COMPLETED,495.78
CARD_PAYMENT,Current,2023-10-28 09:00:32,2023-10-29 14:12:33,Carnaxide Wtc,-32.98,0,EUR,COMPLETED,462.8
TRANSFER,Current,2023-10-29 15:08:17,2023-10-29 15:08:17,To EUR Savings,-0.87,0,EUR,COMPLETED,461.93
TRANSFER,Current,2023-10-29 20:19:03,2023-10-29 20:19:03,To EUR Savings,-0.8,0,EUR,COMPLETED,461.13
TRANSFER,Current,2023-10-30 01:53:57,2023-10-30 01:53:57,To EUR Savings,-0.05,0,EUR,COMPLETED,461.08
TOPUP,Current,2023-10-30 08:02:26,2023-10-30 08:02:29,Apple Pay Top-Up by *6660,400,0,EUR,COMPLETED,861.08
TRANSFER,Current,2023-10-30 08:28:18,2023-10-30 08:28:18,To EUR Savings,-1,0,EUR,COMPLETED,860.08
TRANSFER,Current,2023-10-30 09:14:06,2023-10-30 09:14:06,To EUR Savings,-20,0,EUR,COMPLETED,840.08
TRANSFER,Current,2023-10-30 09:56:31,2023-10-30 09:56:31,To EUR Savings,-0.25,0,EUR,COMPLETED,839.83
CARD_PAYMENT,Current,2023-10-27 14:29:34,2023-10-30 10:38:22,Airbnb,-158.4,0,EUR,COMPLETED,681.43
CARD_PAYMENT,Current,2023-10-29 07:47:21,2023-10-30 10:51:44,Miió,-75,0,EUR,COMPLETED,606.43
TRANSFER,Current,2023-10-30 11:04:56,2023-10-30 11:04:56,To EUR Savings,-0.8,0,EUR,COMPLETED,605.63
CARD_PAYMENT,Current,2023-10-28 14:03:43,2023-10-30 11:13:59,Google,-2.99,0,EUR,COMPLETED,602.64
TRANSFER,Current,2023-10-30 11:15:09,2023-10-30 11:15:09,To EUR Savings,-0.1,0,EUR,COMPLETED,602.54
CARD_PAYMENT,Current,2023-10-29 20:19:03,2023-10-30 11:19:29,Restaurante Alferez,-108.2,0,EUR,COMPLETED,494.34
CARD_PAYMENT,Current,2023-10-29 12:41:27,2023-10-30 11:20:16,Anca Lolo,-4.7,0,EUR,COMPLETED,489.64
CARD_PAYMENT,Current,2023-10-29 09:21:38,2023-10-30 11:35:23,Pasteleria Sancti Petri.,-9,0,EUR,COMPLETED,480.64
CARD_PAYMENT,Current,2023-10-29 08:05:46,2023-10-30 11:36:33,BBVA,-16.95,0,EUR,COMPLETED,463.69
CARD_PAYMENT,Current,2023-10-29 11:37:56,2023-10-30 12:14:55,Cafe Bernal,-6,0,EUR,COMPLETED,457.69
TRANSFER,Current,2023-10-30 13:46:15,2023-10-30 13:46:15,To EUR Savings,-0.2,0,EUR,COMPLETED,457.49
TRANSFER,Current,2023-10-30 13:52:37,2023-10-30 13:52:37,To EUR Savings,-0.84,0,EUR,COMPLETED,456.65
TRANSFER,Current,2023-10-30 15:16:46,2023-10-30 15:16:46,To EUR Savings,-1,0,EUR,COMPLETED,455.65
TRANSFER,Current,2023-10-30 16:02:09,2023-10-30 16:02:09,To EUR Savings,-0.67,0,EUR,COMPLETED,454.98
TRANSFER,Current,2023-10-30 16:14:02,2023-10-30 16:14:02,To EUR Savings,-1,0,EUR,COMPLETED,453.98
TRANSFER,Current,2023-10-30 16:21:57,2023-10-30 16:21:57,To EUR Savings,-0.9,0,EUR,COMPLETED,453.08
CARD_PAYMENT,Current,2023-10-29 15:08:17,2023-10-30 16:22:56,The Trafalgar Sports bar,-47.13,0.47,EUR,COMPLETED,405.48
TRANSFER,Current,2023-10-30 18:27:41,2023-10-30 18:27:41,To EUR Savings,-0.25,0,EUR,COMPLETED,405.23
CARD_PAYMENT,Current,2023-10-30 16:21:57,2023-10-31 10:27:17,Puerto de Cuba,-2.1,0,EUR,COMPLETED,403.13
CARD_PAYMENT,Current,2023-10-30 13:46:14,2023-10-31 10:36:11,El Papelon Torre Sevilla,-27.8,0,EUR,COMPLETED,375.33
CARD_PAYMENT,Current,2023-10-30 01:53:57,2023-10-31 10:59:49,Apple,-18.95,0,EUR,COMPLETED,356.38
CARD_PAYMENT,Current,2023-10-30 18:27:40,2023-10-31 11:18:48,IKEA,-9.75,0,EUR,COMPLETED,346.63
CARD_PAYMENT,Current,2023-10-30 11:04:56,2023-10-31 11:21:29,La Marquesa De Las Huevas,-6.2,0,EUR,COMPLETED,340.43
CARD_PAYMENT,Current,2023-10-30 11:15:08,2023-10-31 11:22:41,BBVA,-7.9,0,EUR,COMPLETED,332.53
CARD_PAYMENT,Current,2023-10-30 08:28:18,2023-10-31 11:23:19,Interparking,-6.55,0,EUR,COMPLETED,325.98
CARD_PAYMENT,Current,2023-10-30 09:56:30,2023-10-31 11:23:46,Calle Compañía,-8.75,0,EUR,COMPLETED,317.23
CARD_PAYMENT,Current,2023-10-30 15:16:46,2023-10-31 17:21:10,Heladerias Bolas,-9,0,EUR,COMPLETED,308.23
TRANSFER,Current,2023-11-01 09:40:32,2023-11-01 09:40:32,To EUR Savings,-0.05,0,EUR,COMPLETED,308.18
TRANSFER,Current,2023-11-01 13:25:35,2023-11-01 13:25:35,To EUR Savings,-0.01,0,EUR,COMPLETED,308.17
CARD_PAYMENT,Current,2023-10-30 13:52:37,2023-11-01 14:53:29,Uber,-8.16,0,EUR,COMPLETED,300.01
CARD_PAYMENT,Current,2023-10-30 16:02:08,2023-11-01 15:10:59,Uber,-8.62,0,EUR,COMPLETED,291.39
TRANSFER,Current,2023-11-02 12:49:40,2023-11-02 12:49:40,To EUR Savings,-0.2,0,EUR,COMPLETED,291.19
CARD_PAYMENT,Current,2023-10-30 16:14:02,2023-11-02 13:05:23,Uber,-1,0,EUR,COMPLETED,290.19
TRANSFER,Current,2023-11-03 11:58:47,2023-11-03 11:58:47,To EUR Savings,-0.1,0,EUR,COMPLETED,290.09
TOPUP,Current,2023-11-03 20:56:26,2023-11-03 20:56:32,Apple Pay Top-Up by *6660,200,0,EUR,COMPLETED,490.09
TRANSFER,Current,2023-11-04 08:15:02,2023-11-04 08:15:02,To EUR Savings,-0.1,0,EUR,COMPLETED,489.99
TRANSFER,Current,2023-11-04 08:39:56,2023-11-04 08:39:56,To EUR Savings,-0.65,0,EUR,COMPLETED,489.34
TRANSFER,Current,2023-11-04 09:20:00,2023-11-04 09:20:00,To EUR Savings,-0.24,0,EUR,COMPLETED,489.1
CARD_PAYMENT,Current,2023-11-02 12:49:39,2023-11-04 19:25:37,Uber Eats,-29.8,0,EUR,COMPLETED,459.3
CARD_PAYMENT,Current,2023-11-01 09:40:32,2023-11-04 19:27:46,Paddle,-39.95,0,EUR,COMPLETED,419.35
CARD_PAYMENT,Current,2023-11-01 13:25:35,2023-11-04 19:55:49,PlayStation,-8.99,0,EUR,COMPLETED,410.36
CARD_PAYMENT,Current,2023-11-03 11:58:47,2023-11-04 19:56:30,Secretlabnl,-27.9,0,EUR,COMPLETED,382.46
TRANSFER,Current,2023-11-05 08:13:45,2023-11-05 08:13:45,To EUR Savings,-0.1,0,EUR,COMPLETED,382.36
CARD_PAYMENT,Current,2023-11-04 08:39:56,2023-11-05 12:26:19,Carnaxide Wtc,-4.35,0,EUR,COMPLETED,378.01
CARD_PAYMENT,Current,2023-11-04 08:15:02,2023-11-05 12:26:19,Carnaxide Wtc,-1.9,0,EUR,COMPLETED,376.11
CARD_PAYMENT,Current,2023-11-04 09:20:00,2023-11-05 12:26:24,Auchan,-56.76,0,EUR,COMPLETED,319.35
TRANSFER,Current,2023-11-05 20:22:46,2023-11-05 20:22:46,To EUR Savings,-0.51,0,EUR,COMPLETED,318.84
TRANSFER,Current,2023-11-06 09:10:30,2023-11-06 09:10:30,To EUR Savings,-20,0,EUR,COMPLETED,298.84
CARD_PAYMENT,Current,2023-11-05 08:13:44,2023-11-06 11:03:24,Carnaxide Wtc,-1.9,0,EUR,COMPLETED,296.94
CARD_PAYMENT,Current,2023-11-05 20:22:45,2023-11-07 12:27:34,Uber Eats,-60.49,0,EUR,COMPLETED,236.45
TRANSFER,Current,2023-11-07 12:43:18,2023-11-07 12:43:18,To EUR Savings,-0.16,0,EUR,COMPLETED,236.29
CARD_PAYMENT,Current,2023-11-07 12:43:17,2023-11-08 10:43:05,Minipreço,-6.84,0,EUR,COMPLETED,229.45
TRANSFER,Current,2023-11-09 12:51:33,2023-11-09 12:51:33,To EUR Savings,-0.2,0,EUR,COMPLETED,229.25
TRANSFER,Current,2023-11-09 21:00:10,2023-11-09 21:00:10,To EUR Savings,-0.17,0,EUR,COMPLETED,229.08
CARD_PAYMENT,Current,2023-11-09 12:51:33,2023-11-10 12:59:44,Uber Eats,-29.8,0,EUR,COMPLETED,199.28
TRANSFER,Current,2023-11-11 08:14:20,2023-11-11 08:14:20,To EUR Savings,-0.1,0,EUR,COMPLETED,199.18
CARD_PAYMENT,Current,2023-11-09 21:00:10,2023-11-11 11:40:43,Minipreço,-11.83,0,EUR,COMPLETED,187.35
TRANSFER,Current,2023-11-12 08:10:28,2023-11-12 08:10:28,To EUR Savings,-0.1,0,EUR,COMPLETED,187.25
TRANSFER,Current,2023-11-12 09:12:11,2023-11-12 09:12:11,To EUR Savings,-0.67,0,EUR,COMPLETED,186.58
CARD_PAYMENT,Current,2023-11-11 08:14:20,2023-11-12 09:44:15,Carnaxide Wtc,-1.9,0,EUR,COMPLETED,184.68
TRANSFER,Current,2023-11-12 09:46:59,2023-11-12 09:46:59,To EUR Savings,-0.71,0,EUR,COMPLETED,183.97
TOPUP,Current,2023-11-12 12:12:58,2023-11-12 12:13:06,Apple Pay Top-Up by *6660,200,0,EUR,COMPLETED,383.97
TRANSFER,Current,2023-11-12 12:13:38,2023-11-12 12:13:38,Revolut Bank UAB,-12,0,EUR,COMPLETED,371.97
TRANSFER,Current,2023-11-12 14:29:37,2023-11-12 14:29:37,To EUR Savings,-0.5,0,EUR,COMPLETED,371.47
TRANSFER,Current,2023-11-12 18:10:28,2023-11-12 18:10:28,To EUR Savings,-0.62,0,EUR,COMPLETED,370.85
CARD_PAYMENT,Current,2023-11-12 18:10:27,2023-11-13 02:04:33,GitHub,-9.38,0.09,EUR,COMPLETED,361.38
TRANSFER,Current,2023-11-13 09:07:00,2023-11-13 09:07:00,To EUR Savings,-20,0,EUR,COMPLETED,341.38
CARD_PAYMENT,Current,2023-11-12 08:10:28,2023-11-13 10:01:13,Carnaxide Wtc,-1.9,0,EUR,COMPLETED,339.48
CARD_PAYMENT,Current,2023-11-12 09:12:10,2023-11-13 10:01:17,Pingo Doce,-17.33,0,EUR,COMPLETED,322.15
CARD_PAYMENT,Current,2023-11-12 14:29:37,2023-11-13 10:02:45,Soya Bar,-56.5,0,EUR,COMPLETED,265.65
CARD_PAYMENT,Current,2023-11-12 09:46:59,2023-11-13 11:53:12,Amazon,-18.29,0,EUR,COMPLETED,247.36
TRANSFER,Current,2023-11-14 10:59:08,2023-11-14 10:59:08,To EUR Savings,-0.32,0,EUR,COMPLETED,247.04
CARD_PAYMENT,Current,2023-11-14 10:59:08,2023-11-15 13:51:24,Paddle,-20.68,0,EUR,COMPLETED,226.36
TRANSFER,Current,2023-11-16 13:01:14,2023-11-16 13:01:14,To EUR Savings,-0.2,0,EUR,COMPLETED,226.16
TRANSFER,Current,2023-11-16 19:36:16,2023-11-16 19:36:16,To EUR Savings,-0.35,0,EUR,COMPLETED,225.81
TOPUP,Current,2023-11-16 19:38:24,2023-11-16 19:38:29,Apple Pay Top-Up by *6660,200,0,EUR,COMPLETED,425.81
TRANSFER,Current,2023-11-17 05:36:42,2023-11-17 05:36:42,To EUR Savings,-0.01,0,EUR,COMPLETED,425.8
CARD_PAYMENT,Current,2023-11-16 13:01:14,2023-11-17 12:25:33,Uber Eats,-29.8,0,EUR,COMPLETED,396
TRANSFER,Current,2023-11-17 21:40:58,2023-11-17 21:40:58,To EUR Savings,-0.51,0,EUR,COMPLETED,395.49
TRANSFER,Current,2023-11-17 23:00:41,2023-11-17 23:00:41,To EUR Savings,-1,0,EUR,COMPLETED,394.49
TRANSFER,Current,2023-11-18 08:11:08,2023-11-18 08:11:08,To EUR Savings,-0.1,0,EUR,COMPLETED,394.39
CARD_PAYMENT,Current,2023-11-16 19:36:16,2023-11-18 14:05:03,Uber Eats,-58.65,0,EUR,COMPLETED,335.74
CARD_PAYMENT,Current,2023-11-17 05:36:41,2023-11-18 14:06:13,Apple,-5.99,0,EUR,COMPLETED,329.75
TRANSFER,Current,2023-11-18 14:56:07,2023-11-18 14:56:07,To EUR Savings,-0.85,0,EUR,COMPLETED,328.9
TRANSFER,Current,2023-11-19 08:13:55,2023-11-19 08:13:55,To EUR Savings,-0.1,0,EUR,COMPLETED,328.8
TRANSFER,Current,2023-11-19 09:14:48,2023-11-19 09:14:48,To EUR Savings,-0.07,0,EUR,COMPLETED,328.73
CARD_PAYMENT,Current,2023-11-17 23:00:40,2023-11-19 10:52:35,Brasa De Sassoeiros,-30,0,EUR,COMPLETED,298.73
CARD_PAYMENT,Current,2023-11-18 14:56:07,2023-11-19 10:52:52,Portela Cafés,-4.15,0,EUR,COMPLETED,294.58
TRANSFER,Current,2023-11-19 12:59:53,2023-11-19 12:59:53,To EUR Savings,-0.08,0,EUR,COMPLETED,294.5
CARD_PAYMENT,Current,2023-11-18 08:11:08,2023-11-19 13:18:25,Carnaxide Wtc,-1.9,0,EUR,COMPLETED,292.6
CARD_PAYMENT,Current,2023-11-17 21:40:58,2023-11-19 16:04:31,Google,-8.49,0,EUR,COMPLETED,284.11
TRANSFER,Current,2023-11-20 09:07:47,2023-11-20 09:07:47,To EUR Savings,-20,0,EUR,COMPLETED,264.11
CARD_PAYMENT,Current,2023-11-19 12:59:53,2023-11-20 11:38:54,Uber Eats,-31.92,0,EUR,COMPLETED,232.19
TRANSFER,Current,2023-11-20 12:10:03,2023-11-20 12:10:03,To EUR Savings,-0.01,0,EUR,COMPLETED,232.18
CARD_PAYMENT,Current,2023-11-19 08:13:55,2023-11-20 16:03:19,Carnaxide Wtc,-1.9,0,EUR,COMPLETED,230.28
CARD_PAYMENT,Current,2023-11-19 09:14:47,2023-11-20 16:03:22,Pingo Doce,-13.93,0,EUR,COMPLETED,216.35
TRANSFER,Current,2023-11-21 08:36:07,2023-11-21 08:36:07,To EUR,1001.21,0,EUR,COMPLETED,1217.56
TRANSFER,Current,2023-11-21 08:36:29,2023-11-21 08:36:29,To EUR Rainy day,-1000,0,EUR,COMPLETED,217.56
TRANSFER,Current,2023-11-21 08:39:34,2023-11-21 08:39:34,To EUR Subscriptions,-100,0,EUR,COMPLETED,117.56
TOPUP,Current,2023-11-21 08:39:59,2023-11-21 08:40:01,Apple Pay Top-Up by *6660,200,0,EUR,COMPLETED,317.56
CARD_PAYMENT,Current,2023-11-20 12:10:02,2023-11-21 11:52:23,Uber,-4.99,0,EUR,COMPLETED,312.57
TRANSFER,Current,2023-11-23 18:36:31,2023-11-23 18:36:31,To EUR Savings,-0.05,0,EUR,COMPLETED,312.52
TRANSFER,Current,2023-11-23 22:17:39,2023-11-23 22:17:39,Revolut Bank UAB,-15,0,EUR,COMPLETED,297.52
TRANSFER,Current,2023-11-24 12:48:13,2023-11-24 12:48:13,To EUR Savings,-0.2,0,EUR,COMPLETED,297.32
CARD_PAYMENT,Current,2023-11-23 18:36:31,2023-11-24 16:02:44,Allegro,-21.95,0,EUR,COMPLETED,275.37
TRANSFER,Current,2023-11-25 08:26:42,2023-11-25 08:26:42,To EUR Savings,-0.1,0,EUR,COMPLETED,275.27
TRANSFER,Current,2023-11-25 08:49:48,2023-11-25 08:49:48,To EUR Savings,-0.65,0,EUR,COMPLETED,274.62
TRANSFER,Current,2023-11-25 09:12:58,2023-11-25 09:12:58,To EUR Savings,-0.62,0,EUR,COMPLETED,274
TRANSFER,Current,2023-11-25 09:39:08,2023-11-25 09:39:08,To EUR Savings,-0.9,0,EUR,COMPLETED,273.1
TOPUP,Current,2023-11-25 09:50:37,2023-11-25 09:51:00,Apple Pay Top-Up by *6660,200,0,EUR,COMPLETED,473.1
TRANSFER,Current,2023-11-25 10:22:38,2023-11-25 10:22:38,To EUR Savings,-0.05,0,EUR,COMPLETED,473.05
CARD_PAYMENT,Current,2023-11-24 12:48:13,2023-11-25 11:06:51,Uber Eats,-29.8,0,EUR,COMPLETED,443.25
TOPUP,Current,2023-11-25 11:49:20,2023-11-25 11:49:28,Apple Pay Top-Up by *6660,200,0,EUR,COMPLETED,643.25
TRANSFER,Current,2023-11-25 13:26:52,2023-11-25 13:26:52,To EUR Savings,-0.5,0,EUR,COMPLETED,642.75
TRANSFER,Current,2023-11-25 20:45:20,2023-11-25 20:45:20,To EUR Savings,-0.7,0,EUR,COMPLETED,642.05
TRANSFER,Current,2023-11-26 08:20:49,2023-11-26 08:20:49,To EUR Savings,-0.1,0,EUR,COMPLETED,641.95
TRANSFER,Current,2023-11-26 09:12:35,2023-11-26 09:12:35,To EUR Savings,-0.51,0,EUR,COMPLETED,641.44
TRANSFER,Current,2023-11-26 09:25:29,2023-11-26 09:25:29,To EUR Savings,-0.51,0,EUR,COMPLETED,640.93
CARD_PAYMENT,Current,2023-11-25 09:12:58,2023-11-26 09:59:38,Pingo Doce,-26.38,0,EUR,COMPLETED,614.55
CARD_PAYMENT,Current,2023-11-25 09:39:08,2023-11-26 09:59:41,Auchan,-34.1,0,EUR,COMPLETED,580.45
CARD_PAYMENT,Current,2023-11-25 10:22:38,2023-11-26 09:59:44,Massimo Dutti,-258.95,0,EUR,COMPLETED,321.5
CARD_PAYMENT,Current,2023-11-25 08:49:48,2023-11-26 10:05:23,Carnaxide Wtc,-4.35,0,EUR,COMPLETED,317.15
CARD_PAYMENT,Current,2023-11-25 08:26:42,2023-11-26 10:05:23,Carnaxide Wtc,-1.9,0,EUR,COMPLETED,315.25
CARD_PAYMENT,Current,2023-11-25 13:26:52,2023-11-26 17:01:06,Mercado De Alges,-11.5,0,EUR,COMPLETED,303.75
TRANSFER,Current,2023-11-27 09:07:22,2023-11-27 09:07:22,To EUR Savings,-20,0,EUR,COMPLETED,283.75
TRANSFER,Current,2023-11-27 09:44:45,2023-11-27 09:44:45,To EUR Savings,-1,0,EUR,COMPLETED,282.75
CARD_PAYMENT,Current,2023-11-26 08:20:49,2023-11-27 09:49:58,Carnaxide Wtc,-1.9,0,EUR,COMPLETED,280.85
CARD_PAYMENT,Current,2023-11-26 09:12:34,2023-11-27 09:50:01,Carnaxide Wtc,-16.49,0,EUR,COMPLETED,264.36
CARD_PAYMENT,Current,2023-11-26 09:25:28,2023-11-27 09:50:01,Pingo Doce,-12.49,0,EUR,COMPLETED,251.87
CARD_PAYMENT,Current,2023-11-25 20:45:20,2023-11-27 10:39:43,Uber Eats,-42.3,0,EUR,COMPLETED,209.57
CARD_PAYMENT,Current,2023-11-27 09:44:45,2023-11-28 11:45:23,PayPal,-20,0,EUR,COMPLETED,189.57
TRANSFER,Current,2023-11-28 13:06:16,2023-11-28 13:06:16,To EUR Savings,-0.01,0,EUR,COMPLETED,189.56
CARD_PAYMENT,Current,2023-11-28 13:06:16,2023-11-29 11:35:28,Google,-2.99,0,EUR,COMPLETED,186.57
TRANSFER,Current,2023-11-29 20:21:26,2023-11-29 20:21:26,To EUR Savings,-0.49,0,EUR,COMPLETED,186.08
TRANSFER,Current,2023-11-30 13:25:30,2023-11-30 13:25:30,To EUR Savings,-0.76,0,EUR,COMPLETED,185.32
CARD_PAYMENT,Current,2023-11-29 20:21:26,2023-11-30 15:45:48,Amazon,-14.51,0,EUR,COMPLETED,170.81
TRANSFER,Current,2023-12-01 08:13:12,2023-12-01 08:13:12,To EUR Savings,-0.1,0,EUR,COMPLETED,170.71
TRANSFER,Current,2023-12-01 13:20:11,2023-12-01 13:20:11,To EUR Savings,-0.26,0,EUR,COMPLETED,170.45
CARD_PAYMENT,Current,2023-11-30 13:25:30,2023-12-01 13:52:11,Minipreço,-12.24,0,EUR,COMPLETED,158.21
TOPUP,Current,2023-12-01 14:26:00,2023-12-01 14:26:05,Apple Pay Top-Up by *6660,200,0,EUR,COMPLETED,358.21
TRANSFER,Current,2023-12-02 08:33:26,2023-12-02 08:33:26,To EUR Savings,-0.1,0,EUR,COMPLETED,358.11
TRANSFER,Current,2023-12-02 09:02:06,2023-12-02 09:02:06,To EUR Savings,-0.53,0,EUR,COMPLETED,357.58
TRANSFER,Current,2023-12-02 09:18:24,2023-12-02 09:18:24,To EUR Savings,-0.71,0,EUR,COMPLETED,356.87
CARD_PAYMENT,Current,2023-12-01 13:20:10,2023-12-02 09:51:39,Uber Eats,-49.74,0,EUR,COMPLETED,307.13
CARD_PAYMENT,Current,2023-12-01 08:13:12,2023-12-02 12:54:31,Carnaxide Wtc,-1.9,0,EUR,COMPLETED,305.23
TRANSFER,Current,2023-12-02 15:05:27,2023-12-02 15:05:27,To EUR Savings,-0.86,0,EUR,COMPLETED,304.37
TRANSFER,Current,2023-12-02 16:21:59,2023-12-02 16:21:59,To EUR Savings,-1,0,EUR,COMPLETED,303.37
TRANSFER,Current,2023-12-03 08:37:11,2023-12-03 08:37:11,To EUR Savings,-0.1,0,EUR,COMPLETED,303.27
CARD_PAYMENT,Current,2023-12-02 09:18:23,2023-12-03 10:48:39,Pingo Doce,-24.29,0,EUR,COMPLETED,278.98
CARD_PAYMENT,Current,2023-12-02 08:33:26,2023-12-03 10:48:40,Carnaxide Wtc,-1.9,0,EUR,COMPLETED,277.08
CARD_PAYMENT,Current,2023-12-02 09:02:06,2023-12-03 10:48:40,Carnaxide Wtc,-7.47,0,EUR,COMPLETED,269.61
CARD_PAYMENT,Current,2023-12-02 15:05:27,2023-12-03 15:27:45,Minipreço,-8.14,0,EUR,COMPLETED,261.47
CARD_PAYMENT,Current,2023-12-02 16:21:59,2023-12-03 16:12:34,PlayStation,-10,0,EUR,COMPLETED,251.47
TRANSFER,Current,2023-12-04 09:06:24,2023-12-04 09:06:24,To EUR Savings,-20,0,EUR,COMPLETED,231.47
CARD_PAYMENT,Current,2023-12-03 08:37:11,2023-12-04 09:58:56,Carnaxide Wtc,-1.9,0,EUR,COMPLETED,229.57
CARD_PAYMENT,Current,2023-12-04 18:53:49,,PayPal,-28.99,0,EUR,REVERTED,
TRANSFER,Current,2023-12-04 18:53:49,2023-12-04 18:53:49,To EUR Savings,-0.01,0,EUR,COMPLETED,229.56
TRANSFER,Current,2023-12-04 22:21:48,2023-12-04 22:21:48,To EUR Savings,-0.01,0,EUR,COMPLETED,229.55
TRANSFER,Current,2023-12-05 20:39:50,2023-12-05 20:39:50,To EUR Savings,-0.2,0,EUR,COMPLETED,229.35
CARD_PAYMENT,Current,2023-12-04 22:21:47,2023-12-06 10:05:25,PayPal,-28.99,0,EUR,COMPLETED,200.36
CARD_PAYMENT,Current,2023-12-05 20:39:49,2023-12-06 13:41:58,UCI Cinemas,-9.8,0,EUR,COMPLETED,190.56
TRANSFER,Current,2023-12-06 21:22:34,2023-12-06 21:22:34,To EUR Savings,-0.8,0,EUR,COMPLETED,189.76
TRANSFER,Current,2023-12-07 08:43:27,2023-12-07 08:43:27,To EUR Savings,-0.09,0,EUR,COMPLETED,189.67
TRANSFER,Current,2023-12-07 11:16:09,2023-12-07 11:16:09,To EUR Savings,-0.2,0,EUR,COMPLETED,189.47
TRANSFER,Current,2023-12-07 12:45:21,2023-12-07 12:45:21,To EUR Savings,-0.67,0,EUR,COMPLETED,188.8
TRANSFER,Current,2023-12-07 21:05:28,2023-12-07 21:05:28,To EUR Savings,-0.9,0,EUR,COMPLETED,187.9
TRANSFER,Current,2023-12-08 08:05:41,2023-12-08 08:05:41,To EUR Savings,-0.1,0,EUR,COMPLETED,187.8
TRANSFER,Current,2023-12-08 08:24:53,2023-12-08 08:24:53,To EUR Savings,-0.1,0,EUR,COMPLETED,187.7
TOPUP,Current,2023-12-08 08:25:15,2023-12-08 08:25:18,Apple Pay Top-Up by *6660,200,0,EUR,COMPLETED,387.7
CARD_PAYMENT,Current,2023-12-06 21:22:34,2023-12-08 10:54:57,El Corte Inglés,-12.2,0,EUR,COMPLETED,375.5
CARD_PAYMENT,Current,2023-12-07 11:16:08,2023-12-08 11:07:15,Bolt,-6.8,0,EUR,COMPLETED,368.7
CARD_PAYMENT,Current,2023-12-07 08:43:27,2023-12-08 11:32:57,Uber,-9.91,0,EUR,COMPLETED,358.79
CARD_PAYMENT,Current,2023-12-07 12:45:21,2023-12-08 12:03:02,Uber Eats,-29.33,0,EUR,COMPLETED,329.46
TRANSFER,Current,2023-12-08 13:16:22,2023-12-08 13:16:22,To EUR Savings,-0.2,0,EUR,COMPLETED,329.26
TRANSFER,Current,2023-12-09 08:21:27,2023-12-09 08:21:27,To EUR Savings,-0.1,0,EUR,COMPLETED,329.16
CARD_PAYMENT,Current,2023-12-08 08:05:41,2023-12-09 13:50:51,Carnaxide Wtc,-1.9,0,EUR,COMPLETED,327.26
TRANSFER,Current,2023-12-09 14:56:02,2023-12-09 14:56:02,To EUR Savings,-0.01,0,EUR,COMPLETED,327.25
CARD_PAYMENT,Current,2023-12-08 08:24:53,2023-12-09 15:18:06,PayPal,-39.9,0,EUR,COMPLETED,287.35
CARD_PAYMENT,Current,2023-12-08 13:16:22,2023-12-09 15:39:08,Uber Eats,-29.8,0,EUR,COMPLETED,257.55
CARD_PAYMENT,Current,2023-12-07 21:05:28,2023-12-09 15:40:59,Subway,-23.1,0,EUR,COMPLETED,234.45
TRANSFER,Current,2023-12-10 08:30:56,2023-12-10 08:30:56,To EUR Savings,-0.1,0,EUR,COMPLETED,234.35
TRANSFER,Current,2023-12-10 10:09:02,2023-12-10 10:09:02,To EUR Savings,-0.01,0,EUR,COMPLETED,234.34
CARD_PAYMENT,Current,2023-12-09 08:21:27,2023-12-10 10:10:36,Carnaxide Wtc,-1.9,0,EUR,COMPLETED,232.44
TRANSFER,Current,2023-12-10 12:30:49,2023-12-10 12:30:49,To EUR Savings,-0.5,0,EUR,COMPLETED,231.94
CARD_PAYMENT,Current,2023-12-09 14:56:02,2023-12-10 19:10:50,PlayStation,-14.99,0,EUR,COMPLETED,216.95
TRANSFER,Current,2023-12-10 20:22:50,2023-12-10 20:22:50,To EUR Savings,-0.38,0,EUR,COMPLETED,216.57
TOPUP,Current,2023-12-10 23:21:08,2023-12-10 23:21:12,Apple Pay Top-Up by *6660,400,0,EUR,COMPLETED,616.57
TRANSFER,Current,2023-12-11 09:05:09,2023-12-11 09:05:09,To EUR Savings,-20,0,EUR,COMPLETED,596.57
CARD_PAYMENT,Current,2023-12-10 08:30:55,2023-12-11 10:35:16,Carnaxide Wtc,-1.9,0,EUR,COMPLETED,594.67
CARD_PAYMENT,Current,2023-12-10 10:09:02,2023-12-11 10:35:20,Cortefiel,-39.99,0,EUR,COMPLETED,554.68
TRANSFER,Current,2023-12-11 11:35:03,2023-12-11 11:35:03,To EUR Savings,-0.7,0,EUR,COMPLETED,553.98
TRANSFER,Current,2023-12-11 11:45:22,2023-12-11 11:45:22,To EUR Savings,-1,0,EUR,COMPLETED,552.98
TRANSFER,Current,2023-12-11 11:48:28,2023-12-11 11:48:28,To EUR Savings,-0.6,0,EUR,COMPLETED,552.38
CARD_PAYMENT,Current,2023-12-10 12:30:49,2023-12-11 12:29:32,Uber Eats,-43.5,0,EUR,COMPLETED,508.88
TRANSFER,Current,2023-12-11 17:01:04,2023-12-11 17:01:04,To EUR Savings,-0.14,0,EUR,COMPLETED,508.74
TRANSFER,Current,2023-12-11 21:42:57,2023-12-11 21:42:57,To EUR Savings,-0.5,0,EUR,COMPLETED,508.24
TRANSFER,Current,2023-12-12 00:03:51,2023-12-12 00:03:51,To EUR Savings,-1,0,EUR,COMPLETED,507.24
TRANSFER,Current,2023-12-12 10:04:53,2023-12-12 10:04:53,To EUR Savings,-0.8,0,EUR,COMPLETED,506.44
CARD_PAYMENT,Current,2023-12-11 11:35:02,2023-12-12 10:56:28,areas,-7.3,0,EUR,COMPLETED,499.14
CARD_PAYMENT,Current,2023-12-11 11:48:28,2023-12-12 10:56:31,areas,-2.4,0,EUR,COMPLETED,496.74
CARD_PAYMENT,Current,2023-12-11 11:45:22,2023-12-12 10:56:31,areas,-3,0,EUR,COMPLETED,493.74
CARD_PAYMENT,Current,2023-12-12 00:03:51,2023-12-12 11:44:16,Gate Gourmet,-7,0,EUR,COMPLETED,486.74
CARD_PAYMENT,Current,2023-12-11 21:42:57,2023-12-12 12:52:21,Wundermart,-3.5,0,EUR,COMPLETED,483.24
CARD_PAYMENT,Current,2023-12-10 20:22:50,2023-12-12 12:56:36,Minipreço,-2.62,0,EUR,COMPLETED,480.62
TRANSFER,Current,2023-12-12 13:21:55,2023-12-12 13:21:55,To EUR Savings,-0.2,0,EUR,COMPLETED,480.42
TRANSFER,Current,2023-12-12 18:18:29,2023-12-12 18:18:29,To EUR Savings,-0.71,0,EUR,COMPLETED,479.71
TRANSFER,Current,2023-12-12 22:25:37,2023-12-12 22:25:37,To EUR Savings,-0.5,0,EUR,COMPLETED,479.21
CARD_PAYMENT,Current,2023-12-12 18:18:28,2023-12-13 03:08:06,GitHub,-9.29,0,EUR,COMPLETED,469.92
TRANSFER,Current,2023-12-13 09:58:59,2023-12-13 09:58:59,To EUR Savings,-0.5,0,EUR,COMPLETED,469.42
CARD_PAYMENT,Current,2023-12-12 10:04:52,2023-12-13 10:08:16,Eye Filmmuseum,-6.2,0,EUR,COMPLETED,463.22
TRANSFER,Current,2023-12-13 11:24:39,2023-12-13 11:24:39,To EUR Savings,-0.5,0,EUR,COMPLETED,462.72
CARD_PAYMENT,Current,2023-12-12 22:25:36,2023-12-13 11:38:24,Wundermart,-3.5,0,EUR,COMPLETED,459.22
TRANSFER,Current,2023-12-13 11:42:28,2023-12-13 11:42:28,To EUR Savings,-0.5,0,EUR,COMPLETED,458.72
CARD_PAYMENT,Current,2023-12-12 13:21:55,2023-12-13 12:14:18,Vr Arcade Amsterdam,-2.8,0,EUR,COMPLETED,455.92
TRANSFER,Current,2023-12-13 17:29:00,2023-12-13 17:29:00,To EUR Savings,-0.8,0,EUR,COMPLETED,455.12
CARD_PAYMENT,Current,2023-12-13 11:42:28,2023-12-14 11:17:11,HMSHost International,-4.5,0,EUR,COMPLETED,450.62
CARD_PAYMENT,Current,2023-12-13 11:24:39,2023-12-14 11:17:11,HMSHost International,-4.5,0,EUR,COMPLETED,446.12
CARD_PAYMENT,Current,2023-12-13 09:58:58,2023-12-14 11:37:04,Ghm Bb,-10.5,0,EUR,COMPLETED,435.62
CARD_PAYMENT,Current,2023-12-13 17:29:00,2023-12-14 12:17:18,Gate Gourmet,-7.2,0,EUR,COMPLETED,428.42
TRANSFER,Current,2023-12-14 12:52:58,2023-12-14 12:52:58,To EUR Savings,-0.8,0,EUR,COMPLETED,427.62
TRANSFER,Current,2023-12-14 13:02:33,2023-12-14 13:02:33,To EUR Savings,-0.42,0,EUR,COMPLETED,427.2
CARD_PAYMENT,Current,2023-12-11 17:01:04,2023-12-15 11:48:15,NH City Center Amsterdam,-30.85,0,EUR,COMPLETED,396.35
CARD_PAYMENT,Current,2023-12-14 12:52:58,2023-12-15 12:37:24,Uber Eats,-33.2,0,EUR,COMPLETED,363.15
CARD_PAYMENT,Current,2023-12-14 13:02:33,2023-12-15 17:19:13,OpenAI,-22.58,0,EUR,COMPLETED,340.57
TRANSFER,Current,2023-12-16 08:20:07,2023-12-16 08:20:07,To EUR Savings,-0.1,0,EUR,COMPLETED,340.47
TRANSFER,Current,2023-12-16 08:48:48,2023-12-16 08:48:48,To EUR Savings,-0.52,0,EUR,COMPLETED,339.95
TRANSFER,Current,2023-12-16 09:11:31,2023-12-16 09:11:31,To EUR Savings,-0.15,0,EUR,COMPLETED,339.8
TRANSFER,Current,2023-12-16 13:10:54,2023-12-16 13:10:54,To EUR Savings,-0.5,0,EUR,COMPLETED,339.3
TRANSFER,Current,2023-12-16 13:18:48,2023-12-16 13:18:48,To EUR Savings,-1,0,EUR,COMPLETED,338.3
TRANSFER,Current,2023-12-16 13:47:44,2023-12-16 13:47:44,To EUR Savings,-1,0,EUR,COMPLETED,337.3
TRANSFER,Current,2023-12-17 05:34:52,2023-12-17 05:34:52,To EUR Savings,-0.01,0,EUR,COMPLETED,337.29
TRANSFER,Current,2023-12-17 08:37:19,2023-12-17 08:37:19,To EUR Savings,-0.1,0,EUR,COMPLETED,337.19
TRANSFER,Current,2023-12-17 09:43:00,2023-12-17 09:43:00,To EUR Savings,-0.33,0,EUR,COMPLETED,336.86
CARD_PAYMENT,Current,2023-12-16 08:20:06,2023-12-17 10:20:11,Carnaxide Wtc,-1.9,0,EUR,COMPLETED,334.96
CARD_PAYMENT,Current,2023-12-16 08:48:48,2023-12-17 10:20:15,Carnaxide Wtc,-3.48,0,EUR,COMPLETED,331.48
CARD_PAYMENT,Current,2023-12-16 09:11:31,2023-12-17 10:20:39,Socunha Tecidos Enxo,-45.85,0,EUR,COMPLETED,285.63
CARD_PAYMENT,Current,2023-12-16 13:18:48,2023-12-17 13:05:08,Mercado De Alges,-12,0,EUR,COMPLETED,273.63
CARD_PAYMENT,Current,2023-12-16 13:10:54,2023-12-17 13:05:08,Receita Pomposa,-40.5,0,EUR,COMPLETED,233.13
CARD_PAYMENT,Current,2023-12-16 13:47:44,2023-12-17 13:05:08,Mercado De Alges,-3,0,EUR,COMPLETED,230.13
TRANSFER,Current,2023-12-17 21:40:58,2023-12-17 21:40:58,To EUR Savings,-0.51,0,EUR,COMPLETED,229.62
TOPUP,Current,2023-12-18 08:46:15,2023-12-18 08:46:17,Apple Pay Top-Up by *6660,200,0,EUR,COMPLETED,429.62
CARD_PAYMENT,Current,2023-12-17 08:37:18,2023-12-18 10:56:24,Carnaxide Wtc,-1.9,0,EUR,COMPLETED,427.72
CARD_PAYMENT,Current,2023-12-17 09:42:59,2023-12-18 10:56:31,Pingo Doce,-25.67,0,EUR,COMPLETED,402.05
CARD_PAYMENT,Current,2023-12-17 05:34:51,2023-12-18 11:37:58,Apple,-5.99,0,EUR,COMPLETED,396.06
TRANSFER,Current,2023-12-18 13:33:26,2023-12-18 13:33:26,To EUR Savings,-20,0,EUR,COMPLETED,376.06
CARD_PAYMENT,Current,2023-12-17 21:40:58,2023-12-19 16:53:17,YouTube,-8.49,0,EUR,COMPLETED,367.57
TRANSFER,Current,2023-12-20 12:10:03,2023-12-20 12:10:03,To EUR Savings,-0.01,0,EUR,COMPLETED,367.56
TRANSFER,Current,2023-12-20 19:26:14,2023-12-20 19:26:14,To EUR Savings,-0.09,0,EUR,COMPLETED,367.47
TRANSFER,Current,2023-12-20 22:12:44,2023-12-20 22:12:44,To EUR Savings,-1,0,EUR,COMPLETED,366.47
TOPUP,Current,2023-12-20 22:15:02,2023-12-20 22:15:05,Apple Pay Top-Up by *6660,200,0,EUR,COMPLETED,566.47
TRANSFER,Current,2023-12-20 22:30:08,2023-12-20 22:30:08,To EUR Savings,-0.71,0,EUR,COMPLETED,565.76
TRANSFER,Current,2023-12-21 08:54:50,2023-12-21 08:54:50,To EUR Savings,-0.1,0,EUR,COMPLETED,565.66
TRANSFER,Current,2023-12-21 10:07:05,2023-12-21 10:07:05,To EUR Subscriptions,-100,0,EUR,COMPLETED,465.66
CARD_PAYMENT,Current,2023-12-20 12:10:02,2023-12-21 11:41:16,Uber,-4.99,0,EUR,COMPLETED,460.67
TRANSFER,Current,2023-12-21 12:38:50,2023-12-21 12:38:50,To EUR Savings,-0.76,0,EUR,COMPLETED,459.91
TRANSFER,Current,2023-12-21 15:56:54,2023-12-21 15:56:54,To EUR Savings,-0.06,0,EUR,COMPLETED,459.85
TRANSFER,Current,2023-12-21 16:05:18,2023-12-21 16:05:18,To EUR Savings,-1,0,EUR,COMPLETED,458.85
TRANSFER,Current,2023-12-21 17:07:58,2023-12-21 17:07:58,To EUR Savings,-0.3,0,EUR,COMPLETED,458.55
TOPUP,Current,2023-12-21 17:17:09,2023-12-21 17:17:13,Apple Pay Top-Up by *6660,400,0,EUR,COMPLETED,858.55
TRANSFER,Current,2023-12-22 08:34:29,2023-12-22 08:34:29,To EUR Savings,-0.1,0,EUR,COMPLETED,858.45
TRANSFER,Current,2023-12-22 10:43:15,2023-12-22 10:43:15,To EUR Savings,-0.26,0,EUR,COMPLETED,858.19
CARD_PAYMENT,Current,2023-12-21 08:54:50,2023-12-22 12:27:21,Carnaxide Wtc,-1.9,0,EUR,COMPLETED,856.29
CARD_PAYMENT,Current,2023-12-21 15:56:54,2023-12-22 12:27:45,Pingo Doce,-64.94,0,EUR,COMPLETED,791.35
CARD_PAYMENT,Current,2023-12-21 16:05:18,2023-12-22 12:27:48,Gpab Posto De Comb,-39,0,EUR,COMPLETED,752.35
CARD_PAYMENT,Current,2023-12-20 19:26:14,2023-12-22 16:06:29,Uber,-12.91,0,EUR,COMPLETED,739.44
CARD_PAYMENT,Current,2023-12-20 22:30:08,2023-12-22 16:23:52,Uber,-11.29,0,EUR,COMPLETED,728.15
CARD_PAYMENT,Current,2023-12-21 12:38:49,2023-12-22 16:53:59,Uber Eats,-29.24,0,EUR,COMPLETED,698.91
CARD_PAYMENT,Current,2023-12-21 17:07:58,2023-12-22 17:06:18,Minipreço,-5.7,0,EUR,COMPLETED,693.21
CARD_PAYMENT,Current,2023-12-20 22:12:44,2023-12-22 17:06:56,Rest O Velho Eurico,-165,0,EUR,COMPLETED,528.21
TRANSFER,Current,2023-12-22 17:44:17,2023-12-22 17:44:17,To EUR Savings,-0.2,0,EUR,COMPLETED,528.01
TRANSFER,Current,2023-12-23 08:31:12,2023-12-23 08:31:12,To EUR Savings,-0.1,0,EUR,COMPLETED,527.91
TRANSFER,Current,2023-12-23 11:56:10,2023-12-23 11:56:10,To EUR Savings,-0.85,0,EUR,COMPLETED,527.06
CARD_PAYMENT,Current,2023-12-22 10:43:15,2023-12-23 12:44:36,Pingo Doce,-13.74,0,EUR,COMPLETED,513.32
CARD_PAYMENT,Current,2023-12-22 17:42:35,2023-12-23 12:47:16,Palaphita D Guia,-55.8,0,EUR,COMPLETED,457.52
CARD_PAYMENT,Current,2023-12-22 08:34:29,2023-12-23 12:54:51,Carnaxide Wtc,-1.9,0,EUR,COMPLETED,455.62
TRANSFER,Current,2023-12-23 13:01:57,2023-12-23 13:01:57,To EUR Savings,-0.8,0,EUR,COMPLETED,454.82
TRANSFER,Current,2023-12-23 13:58:25,2023-12-23 13:58:25,Revolut Bank UAB,-12,0,EUR,COMPLETED,442.82
TRANSFER,Current,2023-12-23 17:31:53,2023-12-23 17:31:53,To EUR Savings,-0.61,0,EUR,COMPLETED,442.21
TRANSFER,Current,2023-12-23 19:33:42,2023-12-23 19:33:42,To EUR Savings,-0.5,0,EUR,COMPLETED,441.71
TRANSFER,Current,2023-12-24 08:32:19,2023-12-24 08:32:19,To EUR Savings,-0.1,0,EUR,COMPLETED,441.61
TRANSFER,Current,2023-12-24 09:14:48,2023-12-24 09:14:48,To EUR Savings,-0.64,0,EUR,COMPLETED,440.97
TRANSFER,Current,2023-12-24 14:42:53,2023-12-24 14:42:53,To EUR Savings,-0.9,0,EUR,COMPLETED,440.07
CARD_PAYMENT,Current,2023-12-23 11:56:10,2023-12-24 14:59:28,Brisa,-10.15,0,EUR,COMPLETED,429.92
CARD_PAYMENT,Current,2023-12-23 08:31:11,2023-12-24 15:00:45,Carnaxide Wtc,-1.9,0,EUR,COMPLETED,428.02
CARD_PAYMENT,Current,2023-12-23 17:31:52,2023-12-24 15:01:46,Pingo Doce,-3.39,0,EUR,COMPLETED,424.63
CARD_PAYMENT,Current,2023-12-23 13:01:57,2023-12-24 16:14:16,Burguezia Do Leitao,-61.2,0,EUR,COMPLETED,363.43
CARD_PAYMENT,Current,2023-12-23 19:33:42,2023-12-24 16:14:32,Burguezia Do Leitao,-10.5,0,EUR,COMPLETED,352.93
TRANSFER,Current,2023-12-25 09:05:40,2023-12-25 09:05:40,To EUR Savings,-20,0,EUR,COMPLETED,332.93
TOPUP,Current,2023-12-25 09:21:17,2023-12-25 09:21:19,Apple Pay Top-Up by *6660,200,0,EUR,COMPLETED,532.93
TRANSFER,Current,2023-12-25 12:58:21,2023-12-25 12:58:21,To EUR Savings,-0.05,0,EUR,COMPLETED,532.88
TRANSFER,Current,2023-12-25 12:58:49,2023-12-25 12:58:49,To EUR Savings,-1,0,EUR,COMPLETED,531.88
TRANSFER,Current,2023-12-25 13:39:18,2023-12-25 13:39:18,To EUR Savings,-0.4,0,EUR,COMPLETED,531.48
CARD_PAYMENT,Current,2023-12-24 08:32:19,2023-12-26 08:55:44,Carnaxide Wtc,-1.9,0,EUR,COMPLETED,529.58
CARD_PAYMENT,Current,2023-12-24 09:14:48,2023-12-26 08:55:46,Pingo Doce,-28.36,0,EUR,COMPLETED,501.22
CARD_PAYMENT,Current,2023-12-25 12:58:49,2023-12-26 08:58:03,Miió,-50,0,EUR,COMPLETED,451.22
CARD_PAYMENT,Current,2023-12-25 13:39:18,2023-12-26 09:08:33,Repsol,-5.6,0,EUR,COMPLETED,445.62
CARD_PAYMENT,Current,2023-12-25 12:58:20,2023-12-26 09:21:23,Vouzela,-6.95,0,EUR,COMPLETED,438.67
TRANSFER,Current,2023-12-26 13:00:15,2023-12-26 13:00:15,To EUR Savings,-0.8,0,EUR,COMPLETED,437.87
TRANSFER,Current,2023-12-26 14:28:25,2023-12-26 14:28:25,To EUR Savings,-0.15,0,EUR,COMPLETED,437.72
TRANSFER,Current,2023-12-26 15:32:18,2023-12-26 15:32:18,To EUR Savings,-0.3,0,EUR,COMPLETED,437.42
CARD_PAYMENT,Current,2023-12-24 14:42:53,2023-12-27 09:48:38,hotels.com,-94.1,0,EUR,COMPLETED,343.32
CARD_PAYMENT,Current,2023-12-26 13:00:14,2023-12-27 10:06:04,PRIO,-1.2,0,EUR,COMPLETED,342.12
CARD_PAYMENT,Current,2023-12-26 14:28:25,2023-12-27 10:06:37,Burguezia Do Leitao,-47.85,0,EUR,COMPLETED,294.27
CARD_PAYMENT,Current,2023-12-26 15:32:18,2023-12-27 10:16:20,Burguezia Do Leitao,-2.7,0,EUR,COMPLETED,291.57
TRANSFER,Current,2023-12-27 10:38:34,2023-12-27 10:38:34,To EUR Savings,-0.01,0,EUR,COMPLETED,291.56
TRANSFER,Current,2023-12-28 11:12:53,2023-12-28 11:12:53,To EUR Savings,-0.01,0,EUR,COMPLETED,291.55
TRANSFER,Current,2023-12-28 12:29:13,2023-12-28 12:29:13,To EUR Savings,-0.2,0,EUR,COMPLETED,291.35
TRANSFER,Current,2023-12-28 13:03:55,2023-12-28 13:03:55,To EUR Savings,-0.01,0,EUR,COMPLETED,291.34
TRANSFER,Current,2023-12-28 15:07:35,2023-12-28 15:07:35,To EUR Savings,-0.51,0,EUR,COMPLETED,290.83
TRANSFER,Current,2023-12-28 15:40:46,2023-12-28 15:40:46,To EUR Savings,-1,0,EUR,COMPLETED,289.83
CARD_PAYMENT,Current,2023-12-27 10:38:33,2023-12-28 16:18:00,PlayStation,-55.99,0,EUR,COMPLETED,233.84
TRANSFER,Current,2023-12-29 08:19:19,2023-12-29 08:19:19,To EUR Savings,-0.1,0,EUR,COMPLETED,233.74
TRANSFER,Current,2023-12-29 08:36:53,2023-12-29 08:36:53,To EUR Savings,-0.52,0,EUR,COMPLETED,233.22
TRANSFER,Current,2023-12-29 08:56:17,2023-12-29 08:56:17,To EUR Savings,-0.7,0,EUR,COMPLETED,232.52
CARD_PAYMENT,Current,2023-12-28 15:40:45,2023-12-29 10:21:50,Decathlon,-20,0,EUR,COMPLETED,212.52
CARD_PAYMENT,Current,2023-12-28 15:07:35,2023-12-29 10:21:50,Radio Popular,-3.49,0,EUR,COMPLETED,209.03
TRANSFER,Current,2023-12-29 13:11:19,2023-12-29 13:11:19,To EUR Savings,-0.57,0,EUR,COMPLETED,208.46
CARD_PAYMENT,Current,2023-12-28 11:12:53,2023-12-29 13:59:16,PlayStation,-8.99,0,EUR,COMPLETED,199.47
CARD_PAYMENT,Current,2023-12-28 12:29:13,2023-12-29 14:02:01,Uber Eats,-29.8,0,EUR,COMPLETED,169.67
CARD_PAYMENT,Current,2023-12-28 13:03:55,2023-12-29 14:13:04,Google,-2.99,0,EUR,COMPLETED,166.68
TOPUP,Current,2023-12-29 18:38:06,2023-12-29 18:38:09,Apple Pay Top-Up by *6660,400,0,EUR,COMPLETED,566.68
TRANSFER,Current,2023-12-30 02:53:45,2023-12-30 02:53:45,To EUR Savings,-0.05,0,EUR,COMPLETED,566.63
TRANSFER,Current,2023-12-30 08:36:00,2023-12-30 08:36:00,To EUR Savings,-0.1,0,EUR,COMPLETED,566.53
TRANSFER,Current,2023-12-30 09:04:23,2023-12-30 09:04:23,To EUR Savings,-0.16,0,EUR,COMPLETED,566.37
CARD_PAYMENT,Current,2023-12-29 08:36:53,2023-12-30 11:26:26,Carnaxide Wtc,-3.48,0,EUR,COMPLETED,562.89
CARD_PAYMENT,Current,2023-12-29 08:19:19,2023-12-30 11:26:27,Carnaxide Wtc,-1.9,0,EUR,COMPLETED,560.99
CARD_PAYMENT,Current,2023-12-29 08:56:16,2023-12-30 11:26:30,Pingo Doce,-62.3,0,EUR,COMPLETED,498.69
CARD_PAYMENT,Current,2023-12-29 13:11:18,2023-12-30 13:17:15,Minipreço,-9.43,0,EUR,COMPLETED,489.26
TRANSFER,Current,2023-12-31 08:38:37,2023-12-31 08:38:37,To EUR Savings,-0.1,0,EUR,COMPLETED,489.16
TRANSFER,Current,2023-12-31 09:23:30,2023-12-31 09:23:30,To EUR Savings,-0.01,0,EUR,COMPLETED,489.15
CARD_PAYMENT,Current,2023-12-30 08:36:00,2023-12-31 10:12:04,Carnaxide Wtc,-1.9,0,EUR,COMPLETED,487.25
CARD_PAYMENT,Current,2023-12-30 09:04:23,2023-12-31 10:12:07,Carnaxide Wtc,-15.84,0,EUR,COMPLETED,471.41
CARD_PAYMENT,Current,2023-12-30 02:53:44,2023-12-31 10:42:21,Apple,-21.95,0,EUR,COMPLETED,449.46
TRANSFER,Current,2024-01-01 09:42:59,2024-01-01 09:42:59,To EUR Savings,-20,0,EUR,COMPLETED,429.46
TRANSFER,Current,2024-01-02 08:30:08,2024-01-02 08:30:08,To EUR Savings,-0.1,0,EUR,COMPLETED,429.36
CARD_PAYMENT,Current,2023-12-31 08:38:36,2024-01-02 09:50:43,Carnaxide Wtc,-1.9,0,EUR,COMPLETED,427.46
CARD_PAYMENT,Current,2023-12-31 09:23:30,2024-01-02 09:50:43,Carnaxide Wtc,-6.99,0,EUR,COMPLETED,420.47
TRANSFER,Current,2024-01-02 10:14:46,2024-01-02 10:14:46,To EUR Savings,-0.05,0,EUR,COMPLETED,420.42
TRANSFER,Current,2024-01-02 10:29:40,2024-01-02 10:29:40,To EUR Savings,-0.53,0,EUR,COMPLETED,419.89
TRANSFER,Current,2024-01-03 08:24:45,2024-01-03 08:24:45,To EUR Savings,-0.1,0,EUR,COMPLETED,419.79
CARD_PAYMENT,Current,2024-01-02 10:29:40,2024-01-03 10:18:17,Minipreço,-9.47,0,EUR,COMPLETED,410.32
CARD_PAYMENT,Current,2024-01-02 10:14:46,2024-01-03 10:18:55,Farmacia Santa Rita,-0.95,0,EUR,COMPLETED,409.37
CARD_PAYMENT,Current,2024-01-02 08:30:08,2024-01-03 12:41:12,Carnaxide Wtc,-1.9,0,EUR,COMPLETED,407.47
CARD_PAYMENT,Current,2024-01-03 08:24:45,2024-01-04 12:14:52,Carnaxide Wtc,-1.9,0,EUR,COMPLETED,405.57
TRANSFER,Current,2024-01-04 12:51:10,2024-01-04 12:51:10,To EUR Savings,-0.2,0,EUR,COMPLETED,405.37
CARD_PAYMENT,Current,2024-01-04 12:51:10,2024-01-05 10:20:14,Uber Eats,-29.8,0,EUR,COMPLETED,375.57
TRANSFER,Current,2024-01-05 12:33:29,2024-01-05 12:33:29,To EUR Savings,-0.8,0,EUR,COMPLETED,374.77
TRANSFER,Current,2024-01-06 09:09:16,2024-01-06 09:09:16,To EUR Savings,-0.81,0,EUR,COMPLETED,373.96
TRANSFER,Current,2024-01-06 09:46:13,2024-01-06 09:46:13,To EUR Savings,-0.77,0,EUR,COMPLETED,373.19
CARD_PAYMENT,Current,2024-01-05 12:33:29,2024-01-06 12:16:02,Uber Eats,-17.2,0,EUR,COMPLETED,355.99
TRANSFER,Current,2024-01-07 08:40:06,2024-01-07 08:40:06,To EUR Savings,-0.1,0,EUR,COMPLETED,355.89
TRANSFER,Current,2024-01-07 08:58:08,2024-01-07 08:58:08,To EUR Savings,-0.52,0,EUR,COMPLETED,355.37
CARD_PAYMENT,Current,2024-01-06 08:37:17,2024-01-07 10:49:38,Carnaxide Wtc,-1.9,0,EUR,COMPLETED,353.47
CARD_PAYMENT,Current,2024-01-06 09:09:16,2024-01-07 10:49:38,Pingo Doce,-41.19,0,EUR,COMPLETED,312.28
CARD_PAYMENT,Current,2024-01-06 09:46:13,2024-01-07 10:49:50,Auchan,-74.23,0,EUR,COMPLETED,238.05
TRANSFER,Current,2024-01-07 14:43:20,2024-01-07 14:43:20,To EUR Savings,-1,0,EUR,COMPLETED,237.05
TOPUP,Current,2024-01-07 14:45:17,2024-01-07 14:45:19,Apple Pay Top-Up by *6660,200,0,EUR,COMPLETED,437.05
TRANSFER,Current,2024-01-08 09:04:05,2024-01-08 09:04:05,To EUR Savings,-20,0,EUR,COMPLETED,417.05
CARD_PAYMENT,Current,2024-01-07 08:40:06,2024-01-08 11:20:57,Carnaxide Wtc,-1.9,0,EUR,COMPLETED,415.15
CARD_PAYMENT,Current,2024-01-07 08:58:07,2024-01-08 11:20:57,Carnaxide Wtc,-3.48,0,EUR,COMPLETED,411.67
CARD_PAYMENT,Current,2024-01-07 14:43:20,2024-01-08 11:21:27,Gpab Posto De Comb,-39,0,EUR,COMPLETED,372.67
TRANSFER,Current,2024-01-10 07:46:45,2024-01-10 07:46:45,To EUR Savings,-0.01,0,EUR,COMPLETED,372.66
TRANSFER,Current,2024-01-10 09:48:46,2024-01-10 09:48:46,To EUR Savings,-1,0,EUR,COMPLETED,371.66
CARD_PAYMENT,Current,2024-01-10 07:46:45,2024-01-11 11:54:28,A Padaria Portuguesa,-2.99,0,EUR,COMPLETED,368.67
TRANSFER,Current,2024-01-11 12:52:43,2024-01-11 12:52:43,To EUR Savings,-0.2,0,EUR,COMPLETED,368.47
CARD_PAYMENT,Current,2024-01-10 09:48:46,2024-01-11 16:20:19,Clinica Medica E,-70,0,EUR,COMPLETED,298.47
CARD_PAYMENT,Current,2024-01-11 12:52:42,2024-01-12 17:46:51,Uber Eats,-29.8,0,EUR,COMPLETED,268.67
TRANSFER,Current,2024-01-13 10:06:07,2024-01-13 10:06:07,To EUR Savings,-1,0,EUR,COMPLETED,267.67
TRANSFER,Current,2024-01-13 10:08:36,2024-01-13 10:08:36,To EUR Savings,-0.3,0,EUR,COMPLETED,267.37
TRANSFER,Current,2024-01-13 11:09:29,2024-01-13 11:09:29,To EUR Savings,-0.2,0,EUR,COMPLETED,267.17
TRANSFER,Current,2024-01-14 12:05:22,2024-01-14 12:05:22,To EUR Savings,-1,0,EUR,COMPLETED,266.17
TRANSFER,Current,2024-01-14 12:15:15,2024-01-14 12:15:15,To EUR Savings,-0.9,0,EUR,COMPLETED,265.27
TRANSFER,Current,2024-01-14 14:04:03,2024-01-14 14:04:03,To EUR Savings,-0.46,0,EUR,COMPLETED,264.81
TRANSFER,Current,2024-01-14 18:37:16,2024-01-14 18:37:16,To EUR Savings,-0.8,0,EUR,COMPLETED,264.01
TOPUP,Current,2024-01-14 22:03:13,2024-01-14 22:03:16,Apple Pay Top-Up by *6660,200,0,EUR,COMPLETED,464.01
TRANSFER,Current,2024-01-15 09:08:40,2024-01-15 09:08:40,To EUR Savings,-20,0,EUR,COMPLETED,444.01
CARD_PAYMENT,Current,2024-01-15 09:40:40,,RapidAPI,-0.46,0,EUR,REVERTED,
TRANSFER,Current,2024-01-15 09:40:40,2024-01-15 09:40:40,To EUR Savings,-0.54,0,EUR,COMPLETED,443.47
CARD_PAYMENT,Current,2024-01-13 10:08:36,2024-01-15 16:45:59,Brisa,-9.7,0,EUR,COMPLETED,433.77
TRANSFER,Current,2024-01-15 17:26:37,2024-01-15 17:26:37,To EUR Savings,-0.32,0,EUR,COMPLETED,433.45
CARD_PAYMENT,Current,2024-01-13 10:06:07,2024-01-15 17:29:38,Miió,-50,0,EUR,COMPLETED,383.45
CARD_PAYMENT,Current,2024-01-13 11:09:28,2024-01-15 17:46:09,Burguezia Do Leitao,-7.8,0,EUR,COMPLETED,375.65
CARD_PAYMENT,Current,2024-01-14 12:05:22,2024-01-16 01:41:33,Miió,-50,0,EUR,COMPLETED,325.65
CARD_PAYMENT,Current,2024-01-14 18:37:16,2024-01-16 01:54:51,Burguezia Do Leitao,-16.2,0,EUR,COMPLETED,309.45
CARD_PAYMENT,Current,2024-01-14 12:15:15,2024-01-16 01:56:25,Confeitaria Lailai,-7.1,0,EUR,COMPLETED,302.35
CARD_PAYMENT,Current,2024-01-14 14:04:03,2024-01-16 03:50:31,OpenAI,-22.54,0.23,EUR,COMPLETED,279.58
CARD_PAYMENT,Current,2024-01-15 17:26:36,2024-01-16 10:20:42,Minipreço,-6.68,0,EUR,COMPLETED,272.9
TRANSFER,Current,2024-01-17 21:40:58,2024-01-17 21:40:58,To EUR Savings,-0.51,0,EUR,COMPLETED,272.39
CARD_PAYMENT,Current,2024-01-17 21:40:58,2024-01-19 13:52:38,YouTube,-8.49,0,EUR,COMPLETED,263.9
TRANSFER,Current,2024-01-20 08:43:23,2024-01-20 08:43:23,To EUR Savings,-0.01,0,EUR,COMPLETED,263.89
TRANSFER,Current,2024-01-20 10:27:33,2024-01-20 10:27:33,To EUR Savings,-0.79,0,EUR,COMPLETED,263.1
TRANSFER,Current,2024-01-20 12:15:57,2024-01-20 12:15:57,To EUR Savings,-0.01,0,EUR,COMPLETED,263.09
CARD_PAYMENT,Current,2024-01-20 10:27:32,2024-01-20 15:47:20,GitHub,-9.21,0.09,EUR,COMPLETED,253.79
TRANSFER,Current,2024-01-21 08:29:09,2024-01-21 08:29:09,To EUR Savings,-0.25,0,EUR,COMPLETED,253.54
CARD_PAYMENT,Current,2024-01-20 12:15:57,2024-01-21 09:43:14,Uber,-4.99,0,EUR,COMPLETED,248.55
TRANSFER,Current,2024-01-21 10:00:47,2024-01-21 10:00:47,To EUR Savings,-1,0,EUR,COMPLETED,247.55
TRANSFER,Current,2024-01-21 10:03:53,2024-01-21 10:03:53,To EUR Subscriptions,-100,0,EUR,COMPLETED,147.55
CARD_PAYMENT,Current,2024-01-20 08:43:23,2024-01-21 11:53:58,A Padaria Portuguesa,-2.99,0,EUR,COMPLETED,144.56
TRANSFER,Current,2024-01-21 12:24:33,2024-01-21 12:24:33,To EUR Savings,-0.2,0,EUR,COMPLETED,144.36
TOPUP,Current,2024-01-21 12:55:39,2024-01-21 12:55:41,Apple Pay Top-Up by *6660,200,0,EUR,COMPLETED,344.36
TRANSFER,Current,2024-01-21 13:01:35,2024-01-21 13:01:35,To EUR Savings,-0.47,0,EUR,COMPLETED,343.89
TRANSFER,Current,2024-01-22 09:01:54,2024-01-22 09:01:54,To EUR Savings,-20,0,EUR,COMPLETED,323.89
CARD_PAYMENT,Current,2024-01-21 12:24:32,2024-01-22 09:40:31,Uber Eats,-29.8,0,EUR,COMPLETED,294.09
CARD_PAYMENT,Current,2024-01-21 08:29:08,2024-01-22 14:17:12,A Padaria Portuguesa,-3.75,0,EUR,COMPLETED,290.34
CARD_PAYMENT,Current,2024-01-21 10:00:47,2024-01-22 14:17:28,Decathlon,-21,0,EUR,COMPLETED,269.34
CARD_PAYMENT,Current,2024-01-21 13:01:35,2024-01-22 15:10:22,TuneCore,-21.53,0.22,EUR,COMPLETED,247.59
TRANSFER,Current,2024-01-25 12:42:06,2024-01-25 12:42:06,To EUR Savings,-0.3,0,EUR,COMPLETED,247.29
TOPUP,Current,2024-01-25 23:13:14,2024-01-25 23:13:15,Apple Pay Top-Up by *6660,200,0,EUR,COMPLETED,447.29
TRANSFER,Current,2024-01-26 10:08:21,2024-01-26 10:08:21,Revolut Bank UAB,70,0,EUR,COMPLETED,517.29
CARD_PAYMENT,Current,2024-01-25 12:42:06,2024-01-26 11:37:12,Uber Eats,-39.7,0,EUR,COMPLETED,477.59
TRANSFER,Current,2024-01-27 08:45:59,2024-01-27 08:45:59,To EUR Savings,-0.5,0,EUR,COMPLETED,477.09
TRANSFER,Current,2024-01-27 10:11:01,2024-01-27 10:11:01,To EUR Savings,-0.16,0,EUR,COMPLETED,476.93
TRANSFER,Current,2024-01-27 15:17:01,2024-01-27 15:17:01,To EUR Savings,-0.03,0,EUR,COMPLETED,476.9
TRANSFER,Current,2024-01-28 08:46:11,2024-01-28 08:46:11,To EUR Savings,-0.5,0,EUR,COMPLETED,476.4
CARD_PAYMENT,Current,2024-01-27 08:45:59,2024-01-28 09:34:02,A Padaria Portuguesa,-2.5,0,EUR,COMPLETED,473.9
CARD_PAYMENT,Current,2024-01-27 15:17:01,2024-01-28 09:34:16,Leroy Merlin,-20.97,0,EUR,COMPLETED,452.93
CARD_PAYMENT,Current,2024-01-27 10:11:00,2024-01-28 09:34:30,Pingo Doce,-20.84,0,EUR,COMPLETED,432.09
TRANSFER,Current,2024-01-28 11:15:52,2024-01-28 11:15:52,To EUR Savings,-0.01,0,EUR,COMPLETED,432.08
TRANSFER,Current,2024-01-28 13:03:45,2024-01-28 13:03:45,To EUR Savings,-0.01,0,EUR,COMPLETED,432.07
TRANSFER,Current,2024-01-28 14:23:41,2024-01-28 14:23:41,To EUR Savings,-0.75,0,EUR,COMPLETED,431.32
TRANSFER,Current,2024-01-28 18:02:43,2024-01-28 18:02:43,To EUR Savings,-0.7,0,EUR,COMPLETED,430.62
TRANSFER,Current,2024-01-28 21:05:16,2024-01-28 21:05:16,To EUR Savings,-0.1,0,EUR,COMPLETED,430.52
TRANSFER,Current,2024-01-29 09:03:36,2024-01-29 09:03:36,To EUR Savings,-20,0,EUR,COMPLETED,410.52
CARD_PAYMENT,Current,2024-01-28 08:46:11,2024-01-29 10:05:12,A Padaria Portuguesa,-2.5,0,EUR,COMPLETED,408.02
CARD_PAYMENT,Current,2024-01-28 18:02:43,2024-01-29 11:34:49,Saudade,-23.3,0,EUR,COMPLETED,384.72
CARD_PAYMENT,Current,2024-01-28 13:03:45,2024-01-29 11:40:45,Google,-2.99,0,EUR,COMPLETED,381.73
CARD_PAYMENT,Current,2024-01-28 11:15:52,2024-01-29 11:40:48,PlayStation,-8.99,0,EUR,COMPLETED,372.74
TRANSFER,Current,2024-01-30 02:54:03,2024-01-30 02:54:03,To EUR Savings,-0.05,0,EUR,COMPLETED,372.69
CARD_PAYMENT,Current,2024-01-28 21:05:16,2024-01-30 11:55:22,Sabores Descobertas,-10.9,0,EUR,COMPLETED,361.79
CARD_PAYMENT,Current,2024-01-30 02:54:03,2024-01-31 09:40:37,Apple,-21.95,0,EUR,COMPLETED,339.84
CARD_PAYMENT,Current,2024-01-28 14:23:41,2024-01-31 09:41:23,Nos Cinemas,-22.25,0,EUR,COMPLETED,317.59
TRANSFER,Current,2024-01-31 13:21:35,2024-01-31 13:21:35,To EUR Savings,-0.7,0,EUR,COMPLETED,316.89
CARD_PAYMENT,Current,2024-01-31 13:21:34,2024-02-01 11:04:50,Uber Eats,-19.3,0,EUR,COMPLETED,297.59
TRANSFER,Current,2024-02-01 12:37:45,2024-02-01 12:37:45,To EUR Savings,-0.2,0,EUR,COMPLETED,297.39
CARD_PAYMENT,Current,2024-02-01 12:37:45,2024-02-02 10:14:47,Uber Eats,-29.8,0,EUR,COMPLETED,267.59
TRANSFER,Current,2024-02-02 10:28:19,2024-02-02 10:28:19,To EUR Savings,-0.11,0,EUR,COMPLETED,267.48
TRANSFER,Current,2024-02-03 08:40:31,2024-02-03 08:40:31,To EUR Savings,-0.05,0,EUR,COMPLETED,267.43
TRANSFER,Current,2024-02-03 09:57:59,2024-02-03 09:57:59,To EUR Savings,-0.15,0,EUR,COMPLETED,267.28
CARD_PAYMENT,Current,2024-02-02 10:28:19,2024-02-03 10:17:21,Amazon,-8.89,0,EUR,COMPLETED,258.39
TRANSFER,Current,2024-02-04 08:41:22,2024-02-04 08:41:22,To EUR Savings,-0.5,0,EUR,COMPLETED,257.89
TRANSFER,Current,2024-02-04 09:54:22,2024-02-04 09:54:22,To EUR Savings,-0.53,0,EUR,COMPLETED,257.36
CARD_PAYMENT,Current,2024-02-03 09:57:59,2024-02-04 10:31:56,Pingo Doce,-24.85,0,EUR,COMPLETED,232.51
CARD_PAYMENT,Current,2024-02-03 08:40:31,2024-02-04 10:33:15,A Padaria Portuguesa,-4.95,0,EUR,COMPLETED,227.56
TRANSFER,Current,2024-02-04 11:22:03,2024-02-04 11:22:04,Revolut Bank UAB,-12,0,EUR,COMPLETED,215.56
TOPUP,Current,2024-02-04 18:33:50,2024-02-04 18:33:53,Apple Pay Top-Up by *6660,200,0,EUR,COMPLETED,415.56
TRANSFER,Current,2024-02-05 09:08:27,2024-02-05 09:08:27,To EUR Savings,-20,0,EUR,COMPLETED,395.56
CARD_PAYMENT,Current,2024-02-04 08:41:22,2024-02-05 10:42:54,A Padaria Portuguesa,-2.5,0,EUR,COMPLETED,393.06
CARD_PAYMENT,Current,2024-02-04 09:54:21,2024-02-05 10:43:00,Auchan,-42.47,0,EUR,COMPLETED,350.59
TRANSFER,Current,2024-02-06 15:59:33,2024-02-06 15:59:33,To EUR Savings,-0.62,0,EUR,COMPLETED,349.97
CARD_PAYMENT,Current,2024-02-06 15:59:33,2024-02-07 10:25:42,Amazon,-48.38,0,EUR,COMPLETED,301.59
TRANSFER,Current,2024-02-08 12:26:19,2024-02-08 12:26:19,To EUR Savings,-0.2,0,EUR,COMPLETED,301.39
TRANSFER,Current,2024-02-08 17:39:05,2024-02-08 17:39:05,To EUR Savings,-0.84,0,EUR,COMPLETED,300.55
CARD_PAYMENT,Current,2024-02-08 17:39:05,2024-02-09 10:34:47,Amazon,-10.16,0,EUR,COMPLETED,290.39
CARD_PAYMENT,Current,2024-02-08 12:26:19,2024-02-09 11:32:07,Uber Eats,-29.8,0,EUR,COMPLETED,260.59
TRANSFER,Current,2024-02-09 17:32:27,2024-02-09 17:32:27,To EUR Savings,-1,0,EUR,COMPLETED,259.59
TRANSFER,Current,2024-02-10 08:42:23,2024-02-10 08:42:23,To EUR Savings,-0.5,0,EUR,COMPLETED,259.09
TRANSFER,Current,2024-02-10 09:24:39,2024-02-10 09:24:39,To EUR Savings,-0.93,0,EUR,COMPLETED,258.16
TRANSFER,Current,2024-02-10 10:42:55,2024-02-10 10:42:55,To EUR Savings,-0.1,0,EUR,COMPLETED,258.06
CARD_PAYMENT,Current,2024-02-11 09:25:37,,OpenAI,-4.65,0.05,EUR,REVERTED,
TRANSFER,Current,2024-02-11 09:25:37,2024-02-11 09:25:37,To EUR Savings,-0.35,0,EUR,COMPLETED,257.71
CARD_PAYMENT,Current,2024-02-09 17:32:27,2024-02-11 10:13:42,PayPal,-17,0,EUR,COMPLETED,240.71
TRANSFER,Current,2024-02-11 10:28:57,2024-02-11 10:28:57,To EUR Savings,-0.52,0,EUR,COMPLETED,240.19
CARD_PAYMENT,Current,2024-02-10 08:42:23,2024-02-11 10:42:52,A Padaria Portuguesa,-2.5,0,EUR,COMPLETED,237.69
CARD_PAYMENT,Current,2024-02-10 09:24:39,2024-02-11 10:46:47,Pingo Doce,-14.07,0,EUR,COMPLETED,223.62
CARD_PAYMENT,Current,2024-02-10 10:42:55,2024-02-11 10:46:54,Decathlon,-9.9,0,EUR,COMPLETED,213.72
TRANSFER,Current,2024-02-11 12:43:11,2024-02-11 12:43:11,To EUR Savings,-0.4,0,EUR,COMPLETED,213.32
TRANSFER,Current,2024-02-12 09:03:09,2024-02-12 09:03:09,To EUR Savings,-20,0,EUR,COMPLETED,193.32
CARD_PAYMENT,Current,2024-02-11 12:43:11,2024-02-12 09:18:18,Uber Eats,-15.6,0,EUR,COMPLETED,177.72
TOPUP,Current,2024-02-12 10:43:39,2024-02-12 10:43:40,Apple Pay Top-Up by *6660,400,0,EUR,COMPLETED,577.72
TRANSFER,Current,2024-02-12 11:01:45,2024-02-12 11:01:45,To EUR Savings,-0.01,0,EUR,COMPLETED,577.71
CARD_PAYMENT,Current,2024-02-11 10:28:56,2024-02-12 11:42:44,Leroy Merlin,-13.48,0,EUR,COMPLETED,564.23
TRANSFER,Current,2024-02-12 21:00:14,2024-02-12 21:00:14,To EUR Savings,-0.65,0,EUR,COMPLETED,563.58
CARD_PAYMENT,Current,2024-02-12 11:01:45,2024-02-13 10:52:02,Leroy Merlin,-22.99,0,EUR,COMPLETED,540.59
TRANSFER,Current,2024-02-14 14:04:01,2024-02-14 14:04:01,To EUR Savings,-0.98,0,EUR,COMPLETED,539.61
TRANSFER,Current,2024-02-15 12:46:07,2024-02-15 12:46:07,To EUR Savings,-0.1,0,EUR,COMPLETED,539.51
CARD_PAYMENT,Current,2024-02-14 14:04:01,2024-02-15 13:38:30,OpenAI,-23.02,0,EUR,COMPLETED,516.49
TRANSFER,Current,2024-02-15 14:46:29,2024-02-15 14:46:29,To EUR Savings,-0.12,0,EUR,COMPLETED,516.37
CARD_PAYMENT,Current,2024-02-12 21:00:14,2024-02-15 14:58:42,Amazon,-9.35,0,EUR,COMPLETED,507.02
CARD_PAYMENT,Current,2024-02-15 12:46:07,2024-02-16 12:40:44,Uber Eats,-19.9,0,EUR,COMPLETED,487.12
CARD_PAYMENT,Current,2024-02-15 14:46:28,2024-02-16 14:14:13,OpenAI,-22.88,0,EUR,COMPLETED,464.24
TRANSFER,Current,2024-02-17 08:34:51,2024-02-17 08:34:51,To EUR Savings,-0.5,0,EUR,COMPLETED,463.74
TRANSFER,Current,2024-02-17 13:02:01,2024-02-17 13:02:01,To EUR Savings,-0.5,0,EUR,COMPLETED,463.24
TRANSFER,Current,2024-02-17 13:13:11,2024-02-17 13:13:11,To EUR Savings,-1,0,EUR,COMPLETED,462.24
TRANSFER,Current,2024-02-17 21:40:58,2024-02-17 21:40:58,To EUR Savings,-0.51,0,EUR,COMPLETED,461.73
TRANSFER,Current,2024-02-18 08:22:33,2024-02-18 08:22:33,To EUR Savings,-0.5,0,EUR,COMPLETED,461.23
TRANSFER,Current,2024-02-18 09:21:58,2024-02-18 09:21:58,To EUR Savings,-0.71,0,EUR,COMPLETED,460.52
TRANSFER,Current,2024-02-18 09:36:58,2024-02-18 09:36:58,To EUR Savings,-0.4,0,EUR,COMPLETED,460.12
CARD_PAYMENT,Current,2024-02-17 13:02:01,2024-02-18 12:31:38,Saisish,-12.5,0,EUR,COMPLETED,447.62
CARD_PAYMENT,Current,2024-02-17 13:13:11,2024-02-18 12:31:40,Mercado De Alges,-5,0,EUR,COMPLETED,442.62
TRANSFER,Current,2024-02-19 09:00:21,2024-02-19 09:00:21,To EUR Savings,-20,0,EUR,COMPLETED,422.62
CARD_PAYMENT,Current,2024-02-17 08:34:50,2024-02-19 10:54:52,A Padaria Portuguesa,-2.5,0,EUR,COMPLETED,420.12
CARD_PAYMENT,Current,2024-02-18 08:22:32,2024-02-19 10:59:34,A Padaria Portuguesa,-2.5,0,EUR,COMPLETED,417.62
CARD_PAYMENT,Current,2024-02-18 09:21:58,2024-02-19 10:59:47,Leroy Merlin,-41.29,0,EUR,COMPLETED,376.33
CARD_PAYMENT,Current,2024-02-18 09:36:58,2024-02-19 10:59:47,Pingo Doce,-16.6,0,EUR,COMPLETED,359.73
TRANSFER,Current,2024-02-19 12:45:38,2024-02-19 12:45:38,To EUR Savings,-0.8,0,EUR,COMPLETED,358.93
CARD_PAYMENT,Current,2024-02-17 21:40:58,2024-02-19 15:25:21,YouTube,-8.49,0,EUR,COMPLETED,350.44
TRANSFER,Current,2024-02-19 18:28:31,2024-02-19 18:28:31,To EUR Savings,-0.56,0,EUR,COMPLETED,349.88
TRANSFER,Current,2024-02-20 12:10:03,2024-02-20 12:10:03,To EUR Savings,-0.01,0,EUR,COMPLETED,349.87
CARD_PAYMENT,Current,2024-02-19 12:45:38,2024-02-20 12:16:45,Uber Eats,-17.2,0,EUR,COMPLETED,332.67
CARD_PAYMENT,Current,2024-02-19 18:28:31,2024-02-20 14:56:04,OpenAI,-11.44,0,EUR,COMPLETED,321.23
TRANSFER,Current,2024-02-21 10:04:52,2024-02-21 10:04:52,To EUR Subscriptions,-100,0,EUR,COMPLETED,221.23
CARD_PAYMENT,Current,2024-02-20 12:10:03,2024-02-21 10:55:49,Uber,-4.99,0,EUR,COMPLETED,216.24
TRANSFER,Current,2024-02-22 11:27:57,2024-02-22 11:27:57,To EUR Savings,-0.31,0,EUR,COMPLETED,215.93
TRANSFER,Current,2024-02-22 13:01:47,2024-02-22 13:01:47,To EUR Savings,-0.2,0,EUR,COMPLETED,215.73
CARD_PAYMENT,Current,2024-02-22 13:01:47,2024-02-23 11:23:09,Uber Eats,-29.8,0,EUR,COMPLETED,185.93
TRANSFER,Current,2024-02-23 11:41:30,2024-02-23 11:41:30,To EUR Savings,-1,0,EUR,COMPLETED,184.93
TOPUP,Current,2024-02-23 11:45:08,2024-02-23 11:45:12,Apple Pay Top-Up by *6660,400,0,EUR,COMPLETED,584.93
TRANSFER,Current,2024-02-23 12:51:35,2024-02-23 12:51:35,To EUR Savings,-0.87,0,EUR,COMPLETED,584.06
TRANSFER,Current,2024-02-23 13:09:07,2024-02-23 13:09:07,To EUR Savings,-0.5,0,EUR,COMPLETED,583.56
TRANSFER,Current,2024-02-23 15:06:38,2024-02-23 15:06:38,To EUR Savings,-0.45,0,EUR,COMPLETED,583.11
CARD_PAYMENT,Current,2024-02-22 11:27:57,2024-02-23 16:28:40,OpenAI,-5.69,0,EUR,COMPLETED,577.42
TRANSFER,Current,2024-02-23 16:34:26,2024-02-23 16:34:26,To EUR Savings,-1,0,EUR,COMPLETED,576.42
TOPUP,Current,2024-02-23 16:41:25,2024-02-23 16:41:28,Apple Pay Top-Up by *6660,200,0,EUR,COMPLETED,776.42
TRANSFER,Current,2024-02-24 08:27:26,2024-02-24 08:27:26,To EUR Savings,-0.5,0,EUR,COMPLETED,775.92
CARD_PAYMENT,Current,2024-02-23 11:41:30,2024-02-24 11:24:19,Hospital Luz Oeiras,-17,0,EUR,COMPLETED,758.92
CARD_PAYMENT,Current,2024-02-23 12:51:34,2024-02-24 11:24:24,Hospital da Luz Oeiras,-17.13,0,EUR,COMPLETED,741.79
CARD_PAYMENT,Current,2024-02-23 13:09:06,2024-02-24 11:24:31,Hospital Luz Oeiras,-7.5,0,EUR,COMPLETED,734.29
CARD_PAYMENT,Current,2024-02-23 15:06:38,2024-02-24 12:03:40,Farmacia Santa Rita,-5.55,0,EUR,COMPLETED,728.74
TRANSFER,Current,2024-02-24 13:36:25,2024-02-24 13:36:25,To EUR Savings,-0.5,0,EUR,COMPLETED,728.24
TRANSFER,Current,2024-02-24 13:43:19,2024-02-24 13:43:19,To EUR Savings,-1,0,EUR,COMPLETED,727.24
TRANSFER,Current,2024-02-24 14:35:04,2024-02-24 14:35:04,To EUR Savings,-0.5,0,EUR,COMPLETED,726.74
TRANSFER,Current,2024-02-25 08:27:04,2024-02-25 08:27:04,To EUR Savings,-0.5,0,EUR,COMPLETED,726.24
TRANSFER,Current,2024-02-25 09:09:32,2024-02-25 09:09:32,To EUR Savings,-0.31,0,EUR,COMPLETED,725.93
TRANSFER,Current,2024-02-25 09:22:06,2024-02-25 09:22:06,To EUR Savings,-0.58,0,EUR,COMPLETED,725.35
CARD_PAYMENT,Current,2024-02-24 14:35:04,2024-02-25 09:51:47,Mercado de Algés,-3.5,0,EUR,COMPLETED,721.85
CARD_PAYMENT,Current,2024-02-24 08:27:26,2024-02-25 09:52:22,A Padaria Portuguesa,-2.5,0,EUR,COMPLETED,719.35
TRANSFER,Current,2024-02-25 11:04:48,2024-02-25 11:04:48,To EUR Savings,-0.2,0,EUR,COMPLETED,719.15
CARD_PAYMENT,Current,2024-02-24 13:36:24,2024-02-25 11:22:03,Saisish,-21.5,0,EUR,COMPLETED,697.65
CARD_PAYMENT,Current,2024-02-24 13:43:18,2024-02-25 11:22:03,Mercado De Alges,-9,0,EUR,COMPLETED,688.65
TRANSFER,Current,2024-02-25 16:27:39,2024-02-25 16:27:39,To EUR Savings,-0.9,0,EUR,COMPLETED,687.75
TRANSFER,Current,2024-02-26 09:04:09,2024-02-26 09:04:09,To EUR Savings,-20,0,EUR,COMPLETED,667.75
CARD_PAYMENT,Current,2024-02-25 08:27:04,2024-02-26 10:29:50,A Padaria Portuguesa,-2.5,0,EUR,COMPLETED,665.25
CARD_PAYMENT,Current,2024-02-25 09:09:31,2024-02-26 10:29:52,Leroy Merlin,-4.69,0,EUR,COMPLETED,660.56
CARD_PAYMENT,Current,2024-02-25 09:22:06,2024-02-26 10:29:53,Pingo Doce,-12.42,0,EUR,COMPLETED,648.14
CARD_PAYMENT,Current,2024-02-25 11:04:48,2024-02-26 10:30:00,Padaria Lisboa,-7.8,0,EUR,COMPLETED,640.34
CARD_PAYMENT,Current,2024-02-23 16:34:25,2024-02-26 11:04:58,Ikeaportuga 14,-318,0,EUR,COMPLETED,322.34
CARD_PAYMENT,Current,2024-02-25 16:27:39,2024-02-26 11:36:55,Fabrica,-5.1,0,EUR,COMPLETED,317.24
TRANSFER,Current,2024-02-26 13:26:15,2024-02-26 13:26:15,To EUR Savings,-0.28,0,EUR,COMPLETED,316.96
CARD_PAYMENT,Current,2024-02-26 13:26:15,2024-02-27 12:39:25,Uber Eats,-16.72,0,EUR,COMPLETED,300.24
TRANSFER,Current,2024-02-28 11:13:19,2024-02-28 11:13:19,To EUR Savings,-0.35,0,EUR,COMPLETED,299.89
TRANSFER,Current,2024-02-28 11:15:55,2024-02-28 11:15:55,To EUR Savings,-0.01,0,EUR,COMPLETED,299.88
TRANSFER,Current,2024-02-28 13:03:44,2024-02-28 13:03:44,To EUR Savings,-0.01,0,EUR,COMPLETED,299.87
TRANSFER,Current,2024-02-28 14:29:16,2024-02-28 14:29:16,To EUR Savings,-1,0,EUR,COMPLETED,298.87
TRANSFER,Current,2024-02-28 20:20:27,2024-02-28 20:20:27,To EUR Savings,-0.4,0,EUR,COMPLETED,298.47
TRANSFER,Current,2024-02-29 05:53:31,2024-02-29 05:53:31,To EUR Savings,-0.51,0,EUR,COMPLETED,297.96
TRANSFER,Current,2024-02-29 09:36:07,2024-02-29 09:36:07,To EUR Savings,-0.5,0,EUR,COMPLETED,297.46
CARD_PAYMENT,Current,2024-02-28 11:13:18,2024-02-29 10:40:23,Brisa,-5.65,0,EUR,COMPLETED,291.81
CARD_PAYMENT,Current,2024-02-28 11:15:55,2024-02-29 11:40:45,PlayStation,-8.99,0,EUR,COMPLETED,282.82
CARD_PAYMENT,Current,2024-02-28 13:03:43,2024-02-29 11:40:54,Google,-2.99,0,EUR,COMPLETED,279.83
CARD_PAYMENT,Current,2024-02-28 14:29:15,2024-02-29 12:03:39,Alvaros Cafe Unipess,-42,0,EUR,COMPLETED,237.83
CARD_PAYMENT,Current,2024-02-28 20:20:27,2024-03-01 11:37:29,Cafe Rest Beira Rio,-36.6,0,EUR,COMPLETED,201.23
CARD_PAYMENT,Current,2024-02-29 09:36:06,2024-03-01 11:37:43,Irmaos Figueiredos,-37.5,0,EUR,COMPLETED,163.73
TOPUP,Current,2024-03-01 11:49:55,2024-03-01 11:49:58,Apple Pay Top-Up by *6660,200,0,EUR,COMPLETED,363.73
TRANSFER,Current,2024-03-01 12:48:19,2024-03-01 12:48:19,To EUR Savings,-0.2,0,EUR,COMPLETED,363.53
CARD_PAYMENT,Current,2024-02-29 05:53:31,2024-03-01 12:55:55,Apple,-5.49,0,EUR,COMPLETED,358.04
TRANSFER,Current,2024-03-02 08:42:53,2024-03-02 08:42:53,To EUR Savings,-0.5,0,EUR,COMPLETED,357.54
CARD_PAYMENT,Current,2024-03-01 12:48:19,2024-03-02 09:41:01,Uber Eats,-29.8,0,EUR,COMPLETED,327.74
TRANSFER,Current,2024-03-03 08:56:52,2024-03-03 08:56:52,To EUR Savings,-0.23,0,EUR,COMPLETED,327.51
CARD_PAYMENT,Current,2024-03-02 08:42:52,2024-03-03 10:29:16,A Padaria Portuguesa,-2.5,0,EUR,COMPLETED,325.01
TRANSFER,Current,2024-03-03 16:27:45,2024-03-03 16:27:45,To EUR Savings,-0.6,0,EUR,COMPLETED,324.41
TOPUP,Current,2024-03-03 18:33:47,2024-03-03 18:33:48,Apple Pay Top-Up by *6660,200,0,EUR,COMPLETED,524.41
TRANSFER,Current,2024-03-04 09:02:38,2024-03-04 09:02:38,To EUR Savings,-20,0,EUR,COMPLETED,504.41
CARD_PAYMENT,Current,2024-03-03 16:27:44,2024-03-04 11:34:55,O Batel,-180.4,0,EUR,COMPLETED,324.01
CARD_PAYMENT,Current,2024-03-03 08:56:51,2024-03-04 11:35:51,Pingo Doce,-26.77,0,EUR,COMPLETED,297.24
TRANSFER,Current,2024-03-05 00:00:38,2024-03-05 00:00:38,To EUR Savings,-0.02,0,EUR,COMPLETED,297.22
TRANSFER,Current,2024-03-05 15:44:48,2024-03-05 15:44:48,To EUR Savings,-0.01,0,EUR,COMPLETED,297.21
TRANSFER,Current,2024-03-05 16:13:56,2024-03-05 16:13:56,To EUR Savings,-0.01,0,EUR,COMPLETED,297.2
TRANSFER,Current,2024-03-06 08:11:40,2024-03-06 08:11:40,To EUR Savings,-0.77,0,EUR,COMPLETED,296.43
CARD_PAYMENT,Current,2024-03-05 00:00:38,2024-03-06 11:46:05,Amazon,-54.98,0,EUR,COMPLETED,241.45
CARD_PAYMENT,Current,2024-03-05 15:44:48,2024-03-06 12:05:40,gog.com,-9.99,0,EUR,COMPLETED,231.46
TRANSFER,Current,2024-03-07 04:40:02,2024-03-07 04:40:02,To EUR Savings,-0.18,0,EUR,COMPLETED,231.28
TRANSFER,Current,2024-03-07 12:43:03,2024-03-07 12:43:03,To EUR Savings,-0.1,0,EUR,COMPLETED,231.18
CARD_REFUND,Current,2024-03-06 09:03:30,2024-03-07 14:12:23,gog.com,9.99,0,EUR,COMPLETED,241.17
CARD_PAYMENT,Current,2024-03-06 08:11:39,2024-03-07 15:04:39,GitHub,-9.23,0,EUR,COMPLETED,231.94
CARD_PAYMENT,Current,2024-03-07 04:40:02,2024-03-07 15:11:15,OpenAI,-0.82,0,EUR,COMPLETED,231.12
CARD_PAYMENT,Current,2024-03-07 12:43:03,2024-03-08 12:19:23,Uber Eats,-19.9,0,EUR,COMPLETED,211.22
TRANSFER,Current,2024-03-08 12:52:46,2024-03-08 12:52:46,To EUR Savings,-0.8,0,EUR,COMPLETED,210.42
CARD_PAYMENT,Current,2024-03-05 16:13:56,2024-03-08 14:48:03,Steam,-9.99,0,EUR,COMPLETED,200.43
TRANSFER,Current,2024-03-09 09:01:45,2024-03-09 09:01:45,To EUR Savings,-0.8,0,EUR,COMPLETED,199.63
TRANSFER,Current,2024-03-09 14:47:09,2024-03-09 14:47:09,To EUR Savings,-0.8,0,EUR,COMPLETED,198.83
CARD_PAYMENT,Current,2024-03-08 12:52:46,2024-03-09 17:34:20,Uber Eats,-17.2,0,EUR,COMPLETED,181.63
TRANSFER,Current,2024-03-10 08:21:09,2024-03-10 08:21:09,To EUR Savings,-0.5,0,EUR,COMPLETED,181.13
CARD_PAYMENT,Current,2024-03-09 14:47:09,2024-03-10 10:46:19,Taberna 22,-50.2,0,EUR,COMPLETED,130.93
CARD_PAYMENT,Current,2024-03-09 09:01:45,2024-03-10 10:47:16,Cafe Da Esquina,-3.2,0,EUR,COMPLETED,127.73
TRANSFER,Current,2024-03-10 12:40:44,2024-03-10 12:40:44,To EUR Savings,-0.9,0,EUR,COMPLETED,126.83
TRANSFER,Current,2024-03-10 14:05:42,2024-03-10 14:05:42,To EUR Savings,-0.9,0,EUR,COMPLETED,125.93
TRANSFER,Current,2024-03-10 15:33:07,2024-03-10 15:33:07,To EUR Savings,-0.2,0,EUR,COMPLETED,125.73
TRANSFER,Current,2024-03-10 15:38:12,2024-03-10 15:38:12,To EUR Savings,-0.1,0,EUR,COMPLETED,125.63
TRANSFER,Current,2024-03-10 16:15:24,2024-03-10 16:15:24,To EUR Savings,-0.5,0,EUR,COMPLETED,125.13
TRANSFER,Current,2024-03-10 16:22:37,2024-03-10 16:22:37,To EUR Savings,-0.2,0,EUR,COMPLETED,124.93
TOPUP,Current,2024-03-10 18:59:33,2024-03-10 18:59:34,Apple Pay Top-Up by *6660,400,0,EUR,COMPLETED,524.93
TRANSFER,Current,2024-03-11 09:01:43,2024-03-11 09:01:43,To EUR Savings,-20,0,EUR,COMPLETED,504.93
CARD_PAYMENT,Current,2024-03-10 08:21:09,2024-03-11 18:02:50,A Padaria Portuguesa,-2.5,0,EUR,COMPLETED,502.43
CARD_PAYMENT,Current,2024-03-10 15:38:11,2024-03-11 18:56:36,Botaminuto Alfragide,-9.9,0,EUR,COMPLETED,492.53
CARD_PAYMENT,Current,2024-03-10 15:33:06,2024-03-11 18:56:36,Lavandaria 5 A Sec A,-9.8,0,EUR,COMPLETED,482.73
CARD_PAYMENT,Current,2024-03-10 16:22:36,2024-03-11 20:08:49,IKEA,-1.8,0,EUR,COMPLETED,480.93
TRANSFER,Current,2024-03-12 11:16:25,2024-03-12 11:16:25,To EUR Savings,-0.15,0,EUR,COMPLETED,480.78
CARD_PAYMENT,Current,2024-03-10 14:05:42,2024-03-12 16:58:09,Uber Eats,-23.1,0,EUR,COMPLETED,457.68
CARD_PAYMENT,Current,2024-03-10 12:40:44,2024-03-12 17:03:00,Uber Eats,-36.1,0,EUR,COMPLETED,421.58
CARD_PAYMENT,Current,2024-03-10 16:15:23,2024-03-12 17:03:52,IKEA,-7.5,0,EUR,COMPLETED,414.08
TRANSFER,Current,2024-03-12 18:09:36,2024-03-12 18:09:36,To EUR Savings,-0.1,0,EUR,COMPLETED,413.98
TRANSFER,Current,2024-03-12 20:55:15,2024-03-12 20:55:15,To EUR Savings,-0.4,0,EUR,COMPLETED,413.58
CARD_PAYMENT,Current,2024-03-12 18:09:36,2024-03-13 11:44:55,Cinemas NOS,-18.9,0,EUR,COMPLETED,394.68
TRANSFER,Current,2024-03-14 13:02:57,2024-03-14 13:02:57,To EUR Savings,-0.1,0,EUR,COMPLETED,394.58
TRANSFER,Current,2024-03-14 14:04:05,2024-03-14 14:04:05,To EUR Savings,-0.4,0,EUR,COMPLETED,394.18
CARD_PAYMENT,Current,2024-03-12 20:55:15,2024-03-14 16:41:19,Cantinho Estrela,-18.6,0,EUR,COMPLETED,375.58
CARD_PAYMENT,Current,2024-03-12 11:16:25,2024-03-15 12:20:40,Nos Cinemas,-23.85,0,EUR,COMPLETED,351.73
CARD_PAYMENT,Current,2024-03-14 14:04:05,2024-03-15 17:02:31,OpenAI,-22.6,0,EUR,COMPLETED,329.13
TRANSFER,Current,2024-03-16 08:24:24,2024-03-16 08:24:24,To EUR Savings,-0.5,0,EUR,COMPLETED,328.63
TRANSFER,Current,2024-03-16 08:31:45,2024-03-16 08:31:45,To EUR Savings,-1,0,EUR,COMPLETED,327.63
CARD_PAYMENT,Current,2024-03-14 13:02:57,2024-03-16 08:42:39,Uber Eats,-19.9,0,EUR,COMPLETED,307.73
TRANSFER,Current,2024-03-16 09:23:05,2024-03-16 09:23:05,To EUR Savings,-0.33,0,EUR,COMPLETED,307.4
TRANSFER,Current,2024-03-16 10:44:36,2024-03-16 10:44:36,To EUR Savings,-0.11,0,EUR,COMPLETED,307.29
TRANSFER,Current,2024-03-16 11:29:06,2024-03-16 11:29:06,To EUR Savings,-0.32,0,EUR,COMPLETED,306.97
TRANSFER,Current,2024-03-16 12:52:21,2024-03-16 12:52:21,To EUR Savings,-0.32,0,EUR,COMPLETED,306.65
TOPUP,Current,2024-03-16 12:54:12,2024-03-16 12:54:14,Apple Pay Top-Up by *6660,200,0,EUR,COMPLETED,506.65
TRANSFER,Current,2024-03-17 08:29:19,2024-03-17 08:29:19,To EUR Savings,-0.52,0,EUR,COMPLETED,506.13
TRANSFER,Current,2024-03-17 08:46:03,2024-03-17 08:46:03,To EUR Savings,-0.5,0,EUR,COMPLETED,505.63
CARD_PAYMENT,Current,2024-03-16 09:23:04,2024-03-17 10:23:51,Pingo Doce,-35.67,0,EUR,COMPLETED,469.96
CARD_PAYMENT,Current,2024-03-16 10:44:35,2024-03-17 10:23:55,Controlauto Miraflores,-35.89,0,EUR,COMPLETED,434.07
CARD_PAYMENT,Current,2024-03-16 08:24:24,2024-03-17 10:25:18,A Padaria Portuguesa,-2.5,0,EUR,COMPLETED,431.57
CARD_PAYMENT,Current,2024-03-16 12:52:21,2024-03-17 15:36:30,Glovo,-30.78,0,EUR,COMPLETED,400.79
CARD_PAYMENT,Current,2024-03-16 11:29:06,2024-03-17 16:07:21,Repsol,-25.68,0,EUR,COMPLETED,375.11
TRANSFER,Current,2024-03-17 21:40:58,2024-03-17 21:40:58,To EUR Savings,-0.51,0,EUR,COMPLETED,374.6
TRANSFER,Current,2024-03-18 09:00:13,2024-03-18 09:00:13,To EUR Savings,-20,0,EUR,COMPLETED,354.6
CARD_PAYMENT,Current,2024-03-16 08:31:45,2024-03-18 09:00:51,PayPal,-60,0,EUR,COMPLETED,294.6
CARD_PAYMENT,Current,2024-03-17 08:29:19,2024-03-18 11:06:22,Carnaxide Wtc,-3.48,0,EUR,COMPLETED,291.12
CARD_PAYMENT,Current,2024-03-17 08:46:03,2024-03-18 11:06:23,A Padaria Portuguesa,-2.5,0,EUR,COMPLETED,288.62
TRANSFER,Current,2024-03-18 14:05:46,2024-03-18 14:05:46,To EUR Savings,-1,0,EUR,COMPLETED,287.62
TRANSFER,Current,2024-03-18 14:07:54,2024-03-18 14:07:54,To EUR Savings,-1,0,EUR,COMPLETED,286.62
CARD_PAYMENT,Current,2024-03-18 14:07:54,2024-03-19 09:45:43,Parques Tejo,-12,0,EUR,COMPLETED,274.62
CARD_PAYMENT,Current,2024-03-18 14:05:46,2024-03-19 09:45:47,Parques Tejo,-12,0,EUR,COMPLETED,262.62
TRANSFER,Current,2024-03-19 10:46:16,2024-03-19 10:46:16,To EUR Savings,-0.26,0,EUR,COMPLETED,262.36
CARD_PAYMENT,Current,2024-03-17 21:40:57,2024-03-19 13:08:17,YouTube,-8.49,0,EUR,COMPLETED,253.87
TRANSFER,Current,2024-03-20 12:10:03,2024-03-20 12:10:03,To EUR Savings,-0.01,0,EUR,COMPLETED,253.86
CARD_PAYMENT,Current,2024-03-19 10:46:16,2024-03-20 12:34:12,OpenAI,-22.74,0,EUR,COMPLETED,231.12
TRANSFER,Current,2024-03-21 10:08:45,2024-03-21 10:08:45,To EUR Subscriptions,-100,0,EUR,COMPLETED,131.12
TRANSFER,Current,2024-03-21 12:43:36,2024-03-21 12:43:36,To EUR Savings,-0.3,0,EUR,COMPLETED,130.82
TRANSFER,Current,2024-03-21 23:20:39,2024-03-21 23:20:39,To EUR Savings,-0.01,0,EUR,COMPLETED,130.81
CARD_PAYMENT,Current,2024-03-21 23:20:39,2024-03-22 08:43:41,F1,-59.99,0,EUR,COMPLETED,70.82
CARD_PAYMENT,Current,2024-03-20 12:10:03,2024-03-22 13:15:47,Uber,-4.99,0,EUR,COMPLETED,65.83
TRANSFER,Current,2024-03-22 19:01:05,2024-03-22 19:01:05,To EUR Savings,-0.2,0,EUR,COMPLETED,65.63
TRANSFER,Current,2024-03-22 20:20:50,2024-03-22 20:20:50,To EUR Savings,-0.99,0,EUR,COMPLETED,64.64
TRANSFER,Current,2024-03-23 08:09:09,2024-03-23 08:09:09,To EUR Savings,-0.5,0,EUR,COMPLETED,64.14
TOPUP,Current,2024-03-23 09:58:22,2024-03-23 09:58:26,Apple Pay Top-Up by *6660,400,0,EUR,COMPLETED,464.14
CARD_PAYMENT,Current,2024-03-21 12:43:36,2024-03-23 10:12:39,Uber Eats,-39.7,0,EUR,COMPLETED,424.44
CARD_PAYMENT,Current,2024-03-22 19:01:05,2024-03-23 10:30:08,Hosp. Vivemos Gato,-4.8,0,EUR,COMPLETED,419.64
TRANSFER,Current,2024-03-23 18:00:38,2024-03-23 18:00:38,To EUR Savings,-0.53,0,EUR,COMPLETED,419.11
TRANSFER,Current,2024-03-24 08:13:12,2024-03-24 08:13:12,To EUR Savings,-0.1,0,EUR,COMPLETED,419.01
CARD_PAYMENT,Current,2024-03-23 08:09:08,2024-03-24 09:31:16,A Padaria Portuguesa,-2.5,0,EUR,COMPLETED,416.51
CARD_PAYMENT,Current,2024-03-22 20:20:50,2024-03-24 10:37:12,Minipreço,-11.01,0,EUR,COMPLETED,405.5
TRANSFER,Current,2024-03-24 13:15:38,2024-03-24 13:15:38,To EUR Savings,-0.82,0,EUR,COMPLETED,404.68
TRANSFER,Current,2024-03-24 17:09:01,2024-03-24 17:09:01,To EUR Savings,-0.66,0,EUR,COMPLETED,404.02
TRANSFER,Current,2024-03-25 09:03:14,2024-03-25 09:03:14,To EUR Savings,-20,0,EUR,COMPLETED,384.02
CARD_PAYMENT,Current,2024-03-24 08:13:12,2024-03-25 09:45:19,Carnaxide Wtc,-1.9,0,EUR,COMPLETED,382.12
CARD_PAYMENT,Current,2024-03-24 13:15:38,2024-03-25 09:46:23,Sabores Ponte Rest,-60.18,0,EUR,COMPLETED,321.94
CARD_PAYMENT,Current,2024-03-24 17:09:00,2024-03-25 09:46:38,Pingo Doce,-11.34,0,EUR,COMPLETED,310.6
TOPUP,Current,2024-03-25 11:41:52,2024-03-25 11:41:57,Apple Pay Top-Up by *6660,3000,0,EUR,COMPLETED,3310.6
TRANSFER,Current,2024-03-25 11:42:20,2024-03-25 11:42:20,To EUR Savings,-0.95,0,EUR,COMPLETED,3309.65
CARD_PAYMENT,Current,2024-03-23 18:00:38,2024-03-25 12:48:54,zooplus,-75.47,0,EUR,COMPLETED,3234.18
TRANSFER,Current,2024-03-25 13:53:00,2024-03-25 13:53:00,To EUR Savings,-0.23,0,EUR,COMPLETED,3233.95
TOPUP,Current,2024-03-25 18:44:31,2024-03-25 18:44:32,Apple Pay Top-Up by *6660,400,0,EUR,COMPLETED,3633.95
CARD_PAYMENT,Current,2024-03-25 13:53:00,2024-03-26 09:46:41,Mforce,-192.77,0,EUR,COMPLETED,3441.18
TRANSFER,Current,2024-03-26 16:24:12,2024-03-26 16:24:12,To EUR Savings,-0.48,0,EUR,COMPLETED,3440.7
TRANSFER,Current,2024-03-27 12:14:11,2024-03-27 12:14:11,To EUR Savings,-1,0,EUR,COMPLETED,3439.7
CARD_PAYMENT,Current,2024-03-26 16:24:12,2024-03-27 14:56:59,Cursor,-18.52,0,EUR,COMPLETED,3421.18
TRANSFER,Current,2024-03-27 19:36:37,2024-03-27 19:36:37,To EUR Savings,-0.37,0,EUR,COMPLETED,3420.81
TRANSFER,Current,2024-03-27 19:52:29,2024-03-27 19:52:29,To EUR Savings,-1,0,EUR,COMPLETED,3419.81
TRANSFER,Current,2024-03-27 22:44:58,2024-03-27 22:44:58,To EUR Savings,-1,0,EUR,COMPLETED,3418.81
TRANSFER,Current,2024-03-27 23:29:08,2024-03-27 23:29:08,To EUR Savings,-0.5,0,EUR,COMPLETED,3418.31
TRANSFER,Current,2024-03-27 23:44:37,2024-03-27 23:44:37,To EUR Savings,-1,0,EUR,COMPLETED,3417.31
TRANSFER,Current,2024-03-28 11:15:44,2024-03-28 11:15:44,To EUR Savings,-0.01,0,EUR,COMPLETED,3417.3
CARD_PAYMENT,Current,2024-03-25 11:42:20,2024-03-28 11:19:24,Leroy Merlin,-709.38,0,EUR,COMPLETED,2707.92
CARD_PAYMENT,Current,2024-03-25 00:00:00,2024-03-28 11:19:40,Leroy Merlin,-2250.67,0,EUR,COMPLETED,457.25
TRANSFER,Current,2024-03-28 11:19:40,2024-03-28 11:19:40,To EUR Savings,-0.33,0,EUR,COMPLETED,456.92
TRANSFER,Current,2024-03-28 13:03:44,2024-03-28 13:03:44,To EUR Savings,-0.01,0,EUR,COMPLETED,456.91
TRANSFER,Current,2024-03-29 04:56:03,2024-03-29 04:56:03,To EUR Savings,-0.51,0,EUR,COMPLETED,456.4
TRANSFER,Current,2024-03-29 08:02:14,2024-03-29 08:02:14,To EUR Savings,-0.5,0,EUR,COMPLETED,455.9
CARD_PAYMENT,Current,2024-03-27 19:36:37,2024-03-29 10:36:29,Uber,-3.63,0,EUR,COMPLETED,452.27
CARD_PAYMENT,Current,2024-03-27 19:52:29,2024-03-29 10:41:28,Uber,-2,0,EUR,COMPLETED,450.27
CARD_PAYMENT,Current,2024-03-27 12:14:11,2024-03-29 10:42:40,Fever,-44,0,EUR,COMPLETED,406.27
CARD_PAYMENT,Current,2024-03-27 22:44:58,2024-03-29 11:00:15,Monsantos Open Air,-63,0,EUR,COMPLETED,343.27
TRANSFER,Current,2024-03-29 12:35:42,2024-03-29 12:35:42,To EUR Savings,-0.32,0,EUR,COMPLETED,342.95
CARD_PAYMENT,Current,2024-03-27 23:29:08,2024-03-29 16:42:10,Uber,-2.5,0,EUR,COMPLETED,340.45
CARD_PAYMENT,Current,2024-03-27 23:44:37,2024-03-29 16:44:58,Uber,-2,0,EUR,COMPLETED,338.45
TRANSFER,Current,2024-03-30 08:50:56,2024-03-30 08:50:56,To EUR Savings,-0.5,0,EUR,COMPLETED,337.95
TRANSFER,Current,2024-03-30 09:53:12,2024-03-30 09:53:12,To EUR Savings,-0.01,0,EUR,COMPLETED,337.94
CARD_PAYMENT,Current,2024-03-29 08:02:14,2024-03-30 11:27:35,A Padaria Portuguesa,-2.5,0,EUR,COMPLETED,335.44
TRANSFER,Current,2024-03-30 14:29:10,2024-03-30 14:29:10,To EUR Savings,-0.01,0,EUR,COMPLETED,335.43
CARD_PAYMENT,Current,2024-03-29 04:56:02,2024-03-30 16:35:31,Apple,-5.49,0,EUR,COMPLETED,329.94
CARD_PAYMENT,Current,2024-03-28 13:03:44,2024-03-30 16:40:00,Google,-2.99,0,EUR,COMPLETED,326.95
TRANSFER,Current,2024-03-30 17:28:17,2024-03-30 17:28:17,To EUR Savings,-0.33,0,EUR,COMPLETED,326.62
TRANSFER,Current,2024-03-30 17:34:40,2024-03-30 17:34:40,To EUR Savings,-0.52,0,EUR,COMPLETED,326.1
TRANSFER,Current,2024-03-31 08:43:22,2024-03-31 08:43:22,To EUR Savings,-0.5,0,EUR,COMPLETED,325.6
TRANSFER,Current,2024-03-31 09:25:54,2024-03-31 09:25:54,To EUR Savings,-0.54,0,EUR,COMPLETED,325.06
CARD_PAYMENT,Current,2024-03-30 09:53:12,2024-03-31 09:45:21,Controlauto Miraflores,-8.99,0,EUR,COMPLETED,316.07
CARD_PAYMENT,Current,2024-03-30 14:29:10,2024-03-31 09:45:59,Leroy Merlin,-9.99,0,EUR,COMPLETED,306.08
CARD_PAYMENT,Current,2024-03-30 08:50:56,2024-03-31 09:46:01,A Padaria Portuguesa,-2.5,0,EUR,COMPLETED,303.58
CARD_PAYMENT,Current,2024-03-29 12:35:42,2024-03-31 11:07:33,Uber Eats,-29.68,0,EUR,COMPLETED,273.9
CARD_PAYMENT,Current,2024-03-28 11:15:44,2024-03-31 11:08:45,PlayStation,-8.99,0,EUR,COMPLETED,264.91
TRANSFER,Current,2024-03-31 12:32:48,2024-03-31 12:32:48,To EUR Savings,-0.4,0,EUR,COMPLETED,264.51
CARD_PAYMENT,Current,2024-03-31 08:43:21,2024-04-01 08:45:47,A Padaria Portuguesa,-2.5,0,EUR,COMPLETED,262.01
CARD_PAYMENT,Current,2024-03-31 09:25:54,2024-04-01 08:45:47,Pingo Doce,-17.46,0,EUR,COMPLETED,244.55
TRANSFER,Current,2024-04-01 10:41:55,2024-04-01 10:41:55,To EUR Savings,-20,0,EUR,COMPLETED,224.55
CARD_PAYMENT,Current,2024-03-31 12:32:48,2024-04-02 09:11:59,Uber Eats,-15.6,0,EUR,COMPLETED,208.95
CARD_PAYMENT,Current,2024-03-30 17:34:40,2024-04-02 09:12:24,Temu,-18.48,0,EUR,COMPLETED,190.47
CARD_PAYMENT,Current,2024-03-30 17:28:17,2024-04-02 09:12:27,Temu,-72.67,0,EUR,COMPLETED,117.8
TRANSFER,Current,2024-04-02 12:45:22,2024-04-02 12:45:22,To EUR Savings,-0.8,0,EUR,COMPLETED,117
CARD_PAYMENT,Current,2024-04-02 12:45:21,2024-04-04 11:29:31,Uber Eats,-33.2,0,EUR,COMPLETED,83.8
TRANSFER,Current,2024-04-04 12:44:16,2024-04-04 12:44:16,To EUR Savings,-0.2,0,EUR,COMPLETED,83.6
TRANSFER,Current,2024-04-06 08:30:11,2024-04-06 08:30:11,To EUR Savings,-0.5,0,EUR,COMPLETED,83.1
CARD_PAYMENT,Current,2024-04-04 12:44:16,2024-04-06 10:36:56,Uber Eats,-29.8,0,EUR,COMPLETED,53.3
TOPUP,Current,2024-04-06 11:19:32,2024-04-06 11:19:33,Apple Pay Top-Up by *6660,400,0,EUR,COMPLETED,453.3
TRANSFER,Current,2024-04-06 11:23:00,2024-04-06 11:23:00,To EUR Savings,-0.27,0,EUR,COMPLETED,453.03
TRANSFER,Current,2024-04-06 18:12:15,2024-04-06 18:12:15,To EUR Savings,-0.74,0,EUR,COMPLETED,452.29
TRANSFER,Current,2024-04-07 08:44:01,2024-04-07 08:44:01,To EUR Savings,-0.5,0,EUR,COMPLETED,451.79
TRANSFER,Current,2024-04-07 09:23:48,2024-04-07 09:23:48,To EUR Savings,-0.52,0,EUR,COMPLETED,451.27
CARD_PAYMENT,Current,2024-04-06 08:30:11,2024-04-07 09:41:50,A Padaria Portuguesa,-2.5,0,EUR,COMPLETED,448.77
CARD_PAYMENT,Current,2024-04-06 11:23:00,2024-04-07 10:52:16,Minipreço,-0.73,0,EUR,COMPLETED,448.04
TRANSFER,Current,2024-04-07 12:44:28,2024-04-07 12:44:28,To EUR Savings,-0.4,0,EUR,COMPLETED,447.64
CARD_PAYMENT,Current,2024-04-06 18:12:15,2024-04-07 14:34:57,GitHub,-9.26,0.09,EUR,COMPLETED,438.29
TRANSFER,Current,2024-04-07 15:24:48,2024-04-07 15:24:48,To EUR Savings,-0.03,0,EUR,COMPLETED,438.26
TRANSFER,Current,2024-04-08 10:01:20,2024-04-08 10:01:20,To EUR Savings,-20,0,EUR,COMPLETED,418.26
CARD_PAYMENT,Current,2024-04-07 08:44:01,2024-04-08 10:07:22,A Padaria Portuguesa,-2.5,0,EUR,COMPLETED,415.76
CARD_PAYMENT,Current,2024-04-07 09:23:48,2024-04-08 10:07:26,Pingo Doce,-17.48,0,EUR,COMPLETED,398.28
CARD_PAYMENT,Current,2024-04-07 15:24:48,2024-04-08 10:07:42,Zu Colombo,-60.97,0,EUR,COMPLETED,337.31
TRANSFER,Current,2024-04-08 15:36:45,2024-04-08 15:36:45,To EUR Savings,-0.01,0,EUR,COMPLETED,337.3
CARD_PAYMENT,Current,2024-04-07 12:44:28,2024-04-09 10:53:28,Uber Eats,-15.6,0,EUR,COMPLETED,321.7
CARD_PAYMENT,Current,2024-04-08 15:36:45,2024-04-10 11:56:18,Google,-19.99,0,EUR,COMPLETED,301.71
TRANSFER,Current,2024-04-10 12:03:23,2024-04-10 12:03:23,To EUR Savings,-0.2,0,EUR,COMPLETED,301.51
TRANSFER,Current,2024-04-11 20:25:33,2024-04-11 20:25:33,To EUR Savings,-0.6,0,EUR,COMPLETED,300.91
CARD_PAYMENT,Current,2024-04-10 12:03:23,2024-04-12 11:04:44,Uber Eats,-29.8,0,EUR,COMPLETED,271.11
TRANSFER,Current,2024-04-12 16:12:45,2024-04-12 16:12:45,To EUR Savings,-0.01,0,EUR,COMPLETED,271.1
TRANSFER,Current,2024-04-13 08:28:57,2024-04-13 08:28:57,To EUR Savings,-0.5,0,EUR,COMPLETED,270.6
TRANSFER,Current,2024-04-13 09:55:39,2024-04-13 09:55:39,To EUR Savings,-0.82,0,EUR,COMPLETED,269.78
CARD_PAYMENT,Current,2024-04-11 20:25:33,2024-04-13 11:27:30,Uber Eats,-23.4,0,EUR,COMPLETED,246.38
TOPUP,Current,2024-04-13 12:24:28,2024-04-13 12:24:30,Apple Pay Top-Up by *6660,200,0,EUR,COMPLETED,446.38
TRANSFER,Current,2024-04-14 08:40:39,2024-04-14 08:40:39,To EUR Savings,-0.5,0,EUR,COMPLETED,445.88
CARD_PAYMENT,Current,2024-04-13 09:55:39,2024-04-14 10:05:35,Pingo Doce,-53.18,0,EUR,COMPLETED,392.7
CARD_PAYMENT,Current,2024-04-13 08:28:56,2024-04-14 10:06:01,A Padaria Portuguesa,-2.5,0,EUR,COMPLETED,390.2
CARD_PAYMENT,Current,2024-04-12 16:12:45,2024-04-14 10:51:37,PlayStation,-39.99,0,EUR,COMPLETED,350.21
TRANSFER,Current,2024-04-15 10:05:19,2024-04-15 10:05:19,To EUR Savings,-20,0,EUR,COMPLETED,330.21
CARD_PAYMENT,Current,2024-04-14 08:40:38,2024-04-15 10:11:18,A Padaria Portuguesa,-2.5,0,EUR,COMPLETED,327.71
TRANSFER,Current,2024-04-17 21:40:58,2024-04-17 21:40:58,To EUR Savings,-0.51,0,EUR,COMPLETED,327.2
TRANSFER,Current,2024-04-18 12:47:59,2024-04-18 12:47:59,To EUR Savings,-0.2,0,EUR,COMPLETED,327
TRANSFER,Current,2024-04-19 12:45:15,2024-04-19 12:45:15,To EUR Savings,-0.85,0,EUR,COMPLETED,326.15
TRANSFER,Current,2024-04-20 07:42:33,2024-04-20 07:42:33,To EUR Savings,-0.5,0,EUR,COMPLETED,325.65
CARD_PAYMENT,Current,2024-04-18 12:47:58,2024-04-20 11:02:57,Uber Eats,-29.8,0,EUR,COMPLETED,295.85
TRANSFER,Current,2024-04-20 13:10:03,2024-04-20 13:10:03,To EUR Savings,-0.01,0,EUR,COMPLETED,295.84
TRANSFER,Current,2024-04-21 08:35:03,2024-04-21 08:35:03,To EUR Savings,-0.5,0,EUR,COMPLETED,295.34
TRANSFER,Current,2024-04-21 09:48:36,2024-04-21 09:48:36,To EUR Savings,-0.1,0,EUR,COMPLETED,295.24
TRANSFER,Current,2024-04-21 11:04:21,2024-04-21 11:04:21,To EUR Subscriptions,-100,0,EUR,COMPLETED,195.24
TRANSFER,Current,2024-04-21 12:34:23,2024-04-21 12:34:23,To EUR Savings,-0.85,0,EUR,COMPLETED,194.39
TRANSFER,Current,2024-04-22 09:57:49,2024-04-22 09:57:49,To EUR Savings,-20,0,EUR,COMPLETED,174.39
CARD_PAYMENT,Current,2024-04-19 12:45:15,2024-04-22 16:32:44,OpenAI,-23.15,0,EUR,COMPLETED,151.24
CARD_PAYMENT,Current,2024-04-17 21:40:58,2024-04-22 18:15:53,YouTube,-8.49,0,EUR,COMPLETED,142.75
CARD_PAYMENT,Current,2024-04-20 07:42:33,2024-04-22 21:08:12,A Padaria Portuguesa,-2.5,0,EUR,COMPLETED,140.25
TRANSFER,Current,2024-04-22 22:01:43,2024-04-22 22:01:43,To EUR Savings,-0.01,0,EUR,COMPLETED,140.24
CARD_PAYMENT,Current,2024-04-20 13:10:02,2024-04-23 00:57:02,Uber,-4.99,0,EUR,COMPLETED,135.25
CARD_PAYMENT,Current,2024-04-21 08:35:03,2024-04-23 01:18:42,A Padaria Portuguesa,-2.5,0,EUR,COMPLETED,132.75
CARD_PAYMENT,Current,2024-04-21 09:48:36,2024-04-23 01:18:42,Pingo Doce,-31.9,0,EUR,COMPLETED,100.85
CARD_PAYMENT,Current,2024-04-21 12:34:23,2024-04-23 01:33:48,Minipreço,-5.15,0,EUR,COMPLETED,95.7
TRANSFER,Current,2024-04-24 07:35:39,2024-04-24 07:35:39,To EUR Savings,-1,0,EUR,COMPLETED,94.7
TRANSFER,Current,2024-04-25 08:54:43,2024-04-25 08:54:43,To EUR Savings,-0.5,0,EUR,COMPLETED,94.2
CARD_PAYMENT,Current,2024-04-24 07:35:39,2024-04-25 11:02:22,Uber,-7,0,EUR,COMPLETED,87.2
TOPUP,Current,2024-04-25 12:52:21,2024-04-25 12:52:22,Apple Pay Top-Up by *6660,400,0,EUR,COMPLETED,487.2
TRANSFER,Current,2024-04-25 12:53:12,2024-04-25 12:53:12,To EUR Savings,-0.8,0,EUR,COMPLETED,486.4
TRANSFER,Current,2024-04-25 13:43:57,2024-04-25 13:43:57,To EUR Savings,-0.33,0,EUR,COMPLETED,486.07
CARD_PAYMENT,Current,2024-04-22 22:01:43,2024-04-25 13:48:15,PayPal,-64.99,0,EUR,COMPLETED,421.08
TRANSFER,Current,2024-04-25 14:38:58,2024-04-25 14:38:58,To EUR Savings,-0.64,0,EUR,COMPLETED,420.44
TRANSFER,Current,2024-04-25 15:27:14,2024-04-25 15:27:14,To EUR Savings,-1,0,EUR,COMPLETED,419.44
TRANSFER,Current,2024-04-25 18:33:33,2024-04-25 18:33:33,To EUR Savings,-0.81,0,EUR,COMPLETED,418.63
CARD_PAYMENT,Current,2024-04-25 08:54:43,2024-04-26 09:21:08,A Padaria Portuguesa,-2.5,0,EUR,COMPLETED,416.13
CARD_PAYMENT,Current,2024-04-25 14:38:58,2024-04-26 11:48:45,Uber,-8.36,0,EUR,COMPLETED,407.77
TRANSFER,Current,2024-04-26 12:40:54,2024-04-26 12:40:54,To EUR Savings,-0.5,0,EUR,COMPLETED,407.27
TRANSFER,Current,2024-04-26 18:24:57,2024-04-26 18:24:57,To EUR Savings,-0.26,0,EUR,COMPLETED,407.01
CARD_PAYMENT,Current,2024-04-25 13:43:57,2024-04-27 09:17:29,Uber,-0.67,0,EUR,COMPLETED,406.34
CARD_PAYMENT,Current,2024-04-25 15:27:14,2024-04-27 10:09:40,Uber,-5,0,EUR,COMPLETED,401.34
CARD_PAYMENT,Current,2024-04-25 18:33:33,2024-04-27 11:00:53,Uber,-8.19,0,EUR,COMPLETED,393.15
CARD_PAYMENT,Current,2024-04-25 12:53:11,2024-04-27 11:01:47,Uber Eats,-33.2,0,EUR,COMPLETED,359.95
TRANSFER,Current,2024-04-27 12:42:39,2024-04-27 12:42:39,To EUR Savings,-0.8,0,EUR,COMPLETED,359.15
CARD_PAYMENT,Current,2024-04-26 18:24:56,2024-04-27 13:51:52,Cursor,-18.74,0,EUR,COMPLETED,340.41
CARD_PAYMENT,Current,2024-04-26 12:40:54,2024-04-28 10:25:45,Uber Eats,-19.5,0,EUR,COMPLETED,320.91
TRANSFER,Current,2024-04-28 12:15:52,2024-04-28 12:15:52,To EUR Savings,-0.01,0,EUR,COMPLETED,320.9
TRANSFER,Current,2024-04-28 13:16:07,2024-04-28 13:16:07,To EUR Savings,-0.01,0,EUR,COMPLETED,320.89
TRANSFER,Current,2024-04-28 14:03:47,2024-04-28 14:03:47,To EUR Savings,-0.01,0,EUR,COMPLETED,320.88
CARD_PAYMENT,Current,2024-04-27 12:42:39,2024-04-29 09:36:15,Uber Eats,-17.2,0,EUR,COMPLETED,303.68
TRANSFER,Current,2024-04-29 09:59:53,2024-04-29 09:59:53,To EUR Savings,-20,0,EUR,COMPLETED,283.68
TOPUP,Current,2024-04-29 16:37:30,2024-04-29 16:37:32,Apple Pay Top-Up by *6660,200,0,EUR,COMPLETED,483.68
TRANSFER,Current,2024-04-29 19:04:46,2024-04-29 19:04:46,To EUR Savings,-1,0,EUR,COMPLETED,482.68
TRANSFER,Current,2024-04-29 20:19:15,2024-04-29 20:19:15,To EUR Savings,-0.21,0,EUR,COMPLETED,482.47
TRANSFER,Current,2024-04-29 23:23:53,2024-04-29 23:23:53,To EUR Savings,-0.16,0,EUR,COMPLETED,482.31
CARD_PAYMENT,Current,2024-04-28 12:15:52,2024-04-30 11:08:06,PlayStation,-8.99,0,EUR,COMPLETED,473.32
CARD_PAYMENT,Current,2024-04-28 13:16:06,2024-04-30 11:13:59,PlayStation,-3.99,0,EUR,COMPLETED,469.33
CARD_PAYMENT,Current,2024-04-28 14:03:47,2024-04-30 11:28:15,Google,-2.99,0,EUR,COMPLETED,466.34
TRANSFER,Current,2024-04-30 17:18:38,2024-04-30 17:18:38,To EUR Savings,-0.13,0,EUR,COMPLETED,466.21
TRANSFER,Current,2024-05-01 10:25:22,2024-05-01 10:25:22,To EUR Savings,-0.3,0,EUR,COMPLETED,465.91
CARD_PAYMENT,Current,2024-04-30 17:18:38,2024-05-01 10:49:15,Pingo Doce,-18.87,0,EUR,COMPLETED,447.04
CARD_PAYMENT,Current,2024-04-29 19:04:45,2024-05-01 10:52:25,Uber Eats,-13,0,EUR,COMPLETED,434.04
CARD_PAYMENT,Current,2024-04-29 20:19:15,2024-05-01 11:03:40,Uber,-10.79,0,EUR,COMPLETED,423.25
CARD_PAYMENT,Current,2024-04-29 23:23:52,2024-05-01 11:04:16,Uber,-5.84,0,EUR,COMPLETED,417.41
TRANSFER,Current,2024-05-01 22:19:04,2024-05-01 22:19:04,To EUR Savings,-0.01,0,EUR,COMPLETED,417.4
TRANSFER,Current,2024-05-02 12:49:24,2024-05-02 12:49:24,To EUR Savings,-0.39,0,EUR,COMPLETED,417.01
CARD_PAYMENT,Current,2024-05-01 10:25:22,2024-05-02 14:14:06,Denhub2710,-4.7,0,EUR,COMPLETED,412.31
TRANSFER,Current,2024-05-03 12:23:37,2024-05-03 12:23:37,To EUR Savings,-0.01,0,EUR,COMPLETED,412.3
TRANSFER,Current,2024-05-04 07:54:20,2024-05-04 07:54:20,To EUR Savings,-0.5,0,EUR,COMPLETED,411.8
CARD_PAYMENT,Current,2024-05-01 22:19:04,2024-05-04 10:56:19,Apple,-3.99,0,EUR,COMPLETED,407.81
CARD_PAYMENT,Current,2024-05-02 12:49:23,2024-05-04 10:56:20,Uber Eats,-19.61,0,EUR,COMPLETED,388.2
TRANSFER,Current,2024-05-04 12:36:58,2024-05-04 12:36:58,To EUR Savings,-0.9,0,EUR,COMPLETED,387.3
CARD_PAYMENT,Current,2024-05-03 12:23:37,2024-05-04 14:41:27,Andor,-4.99,0,EUR,COMPLETED,382.31
TRANSFER,Current,2024-05-04 20:59:12,2024-05-04 20:59:13,Revolut Bank UAB,-10,0,EUR,COMPLETED,372.31
TRANSFER,Current,2024-05-05 08:25:36,2024-05-05 08:25:36,To EUR Savings,-0.5,0,EUR,COMPLETED,371.81
CARD_PAYMENT,Current,2024-05-04 07:54:20,2024-05-05 09:43:50,A Padaria Portuguesa,-2.5,0,EUR,COMPLETED,369.31
TRANSFER,Current,2024-05-05 09:59:14,2024-05-05 09:59:14,To EUR Savings,-0.06,0,EUR,COMPLETED,369.25
TRANSFER,Current,2024-05-06 09:58:27,2024-05-06 09:58:27,To EUR Savings,-20,0,EUR,COMPLETED,349.25
CARD_PAYMENT,Current,2024-05-04 12:36:58,2024-05-06 10:07:16,Uber Eats,-32.1,0,EUR,COMPLETED,317.15
CARD_PAYMENT,Current,2024-05-05 08:25:36,2024-05-06 10:21:50,A Padaria Portuguesa,-2.5,0,EUR,COMPLETED,314.65
CARD_PAYMENT,Current,2024-05-05 09:59:14,2024-05-06 10:21:51,Pingo Doce,-75.94,0,EUR,COMPLETED,238.71
TOPUP,Current,2024-05-06 11:20:47,2024-05-06 11:20:48,Apple Pay Top-Up by *6660,200,0,EUR,COMPLETED,438.71
TRANSFER,Current,2024-05-06 11:24:39,2024-05-06 11:24:39,To EUR Savings,-0.32,0,EUR,COMPLETED,438.39
TRANSFER,Current,2024-05-06 18:06:00,2024-05-06 18:06:00,To EUR Savings,-0.7,0,EUR,COMPLETED,437.69
CARD_PAYMENT,Current,2024-05-06 11:24:39,2024-05-07 15:08:46,CodiumAI,-17.68,0,EUR,COMPLETED,420.01
CARD_PAYMENT,Current,2024-05-06 18:06:00,2024-05-07 15:15:58,GitHub,-9.3,0,EUR,COMPLETED,410.71
TRANSFER,Current,2024-05-08 22:36:14,2024-05-08 22:36:14,To EUR Savings,-0.77,0,EUR,COMPLETED,409.94
TOPUP,Current,2024-05-08 22:37:08,2024-05-08 22:37:09,Apple Pay Top-Up by *6660,200,0,EUR,COMPLETED,609.94
TOPUP,Current,2024-05-09 09:15:22,2024-05-09 09:15:24,Apple Pay Top-Up by *6660,200,0,EUR,COMPLETED,809.94
TRANSFER,Current,2024-05-09 09:15:51,2024-05-09 09:15:51,To EUR Savings,-0.4,0,EUR,COMPLETED,809.54
TRANSFER,Current,2024-05-09 12:40:39,2024-05-09 12:40:39,To EUR Savings,-0.2,0,EUR,COMPLETED,809.34
CARD_PAYMENT,Current,2024-05-09 09:15:51,2024-05-10 10:26:14,EasyJet,-284.6,0,EUR,COMPLETED,524.74
CARD_PAYMENT,Current,2024-05-08 22:36:14,2024-05-10 14:04:18,Ticketmaster,-270.23,0,EUR,COMPLETED,254.51
TRANSFER,Current,2024-05-11 07:29:44,2024-05-11 07:29:44,To EUR Savings,-0.5,0,EUR,COMPLETED,254.01
CARD_PAYMENT,Current,2024-05-09 12:40:39,2024-05-11 11:54:00,Uber Eats,-29.8,0,EUR,COMPLETED,224.21
TRANSFER,Current,2024-05-11 12:40:29,2024-05-11 12:40:29,To EUR Savings,-0.8,0,EUR,COMPLETED,223.41
TOPUP,Current,2024-05-12 07:50:34,2024-05-12 07:50:35,Apple Pay Top-Up by *6660,200,0,EUR,COMPLETED,423.41
TRANSFER,Current,2024-05-12 08:09:47,2024-05-12 08:09:47,To EUR Savings,-0.5,0,EUR,COMPLETED,422.91
TRANSFER,Current,2024-05-12 09:01:31,2024-05-12 09:01:31,To EUR Savings,-0.13,0,EUR,COMPLETED,422.78
TRANSFER,Current,2024-05-12 14:52:06,2024-05-12 14:52:06,To EUR Savings,-1,0,EUR,COMPLETED,421.78
TRANSFER,Current,2024-05-13 09:55:57,2024-05-13 09:55:57,To EUR Savings,-20,0,EUR,COMPLETED,401.78
CARD_PAYMENT,Current,2024-05-11 07:29:44,2024-05-13 10:59:05,A Padaria Portuguesa,-2.5,0,EUR,COMPLETED,399.28
CARD_PAYMENT,Current,2024-05-11 12:40:28,2024-05-13 11:34:26,Uber Eats,-17.2,0,EUR,COMPLETED,382.08
CARD_PAYMENT,Current,2024-05-12 08:09:47,2024-05-13 11:42:25,A Padaria Portuguesa,-2.5,0,EUR,COMPLETED,379.58
CARD_PAYMENT,Current,2024-05-12 09:01:31,2024-05-13 11:42:26,Pingo Doce,-47.87,0,EUR,COMPLETED,331.71
CARD_PAYMENT,Current,2024-05-12 14:52:06,2024-05-13 11:43:09,Stoc Casa,-18,0,EUR,COMPLETED,313.71
TRANSFER,Current,2024-05-14 14:00:11,2024-05-14 14:00:11,To EUR Savings,-0.05,0,EUR,COMPLETED,313.66
CARD_PAYMENT,Current,2024-05-14 14:00:11,2024-05-16 11:12:08,Puro Mobile,-59.95,0,EUR,COMPLETED,253.71
TRANSFER,Current,2024-05-16 12:48:29,2024-05-16 12:48:29,To EUR Savings,-0.3,0,EUR,COMPLETED,253.41
TOPUP,Current,2024-05-17 10:10:57,2024-05-17 10:10:58,Apple Pay Top-Up by *6660,200,0,EUR,COMPLETED,453.41
TRANSFER,Current,2024-05-17 21:40:58,2024-05-17 21:40:58,To EUR Savings,-0.51,0,EUR,COMPLETED,452.9
TRANSFER,Current,2024-05-18 07:43:03,2024-05-18 07:43:03,To EUR Savings,-0.5,0,EUR,COMPLETED,452.4
TRANSFER,Current,2024-05-18 10:35:39,2024-05-18 10:35:40,Revolut Bank UAB,18,0,EUR,COMPLETED,470.4
CARD_PAYMENT,Current,2024-05-16 12:48:29,2024-05-18 10:57:53,Uber Eats,-39.7,0,EUR,COMPLETED,430.7
TOPUP,Current,2024-05-18 11:50:09,2024-05-18 11:50:10,Apple Pay Top-Up by *6660,200,0,EUR,COMPLETED,630.7
TRANSFER,Current,2024-05-18 12:07:27,2024-05-18 12:07:27,To EUR Savings,-0.74,0,EUR,COMPLETED,629.96
TRANSFER,Current,2024-05-19 08:32:31,2024-05-19 08:32:31,To EUR Savings,-0.5,0,EUR,COMPLETED,629.46
TRANSFER,Current,2024-05-19 09:32:07,2024-05-19 09:32:07,To EUR Savings,-0.17,0,EUR,COMPLETED,629.29
CARD_PAYMENT,Current,2024-05-18 12:07:27,2024-05-19 09:38:15,Mforce,-235.26,0,EUR,COMPLETED,394.03
CARD_PAYMENT,Current,2024-05-18 07:43:03,2024-05-19 09:38:15,A Padaria Portuguesa,-2.5,0,EUR,COMPLETED,391.53
TRANSFER,Current,2024-05-19 12:45:56,2024-05-19 12:45:56,To EUR Savings,-0.28,0,EUR,COMPLETED,391.25
CARD_PAYMENT,Current,2024-05-17 21:40:58,2024-05-19 14:12:51,YouTube,-8.49,0,EUR,COMPLETED,382.76
TRANSFER,Current,2024-05-19 15:48:04,2024-05-19 15:48:04,To EUR Savings,-1,0,EUR,COMPLETED,381.76
CARD_PAYMENT,Current,2024-05-19 08:32:30,2024-05-20 09:53:50,A Padaria Portuguesa,-2.5,0,EUR,COMPLETED,379.26
CARD_PAYMENT,Current,2024-05-19 09:32:07,2024-05-20 09:53:57,Pingo Doce,-62.83,0,EUR,COMPLETED,316.43
TRANSFER,Current,2024-05-20 09:57:02,2024-05-20 09:57:02,To EUR Savings,-20,0,EUR,COMPLETED,296.43
TRANSFER,Current,2024-05-20 13:10:03,2024-05-20 13:10:03,To EUR Savings,-0.01,0,EUR,COMPLETED,296.42
CARD_PAYMENT,Current,2024-05-19 12:45:55,2024-05-20 14:39:37,OpenAI,-22.72,0.23,EUR,COMPLETED,273.47
TRANSFER,Current,2024-05-20 17:52:22,2024-05-20 17:52:22,To EUR Savings,-0.1,0,EUR,COMPLETED,273.37
TRANSFER,Current,2024-05-21 11:05:25,2024-05-21 11:05:25,To EUR Subscriptions,-100,0,EUR,COMPLETED,173.37
CARD_PAYMENT,Current,2024-05-20 17:52:21,2024-05-21 11:35:54,Padaria Lisboa,-7.9,0,EUR,COMPLETED,165.47
TRANSFER,Current,2024-05-21 14:31:28,2024-05-21 14:31:28,To EUR Savings,-0.64,0,EUR,COMPLETED,164.83
CARD_PAYMENT,Current,2024-05-20 13:10:03,2024-05-22 10:18:53,Uber,-4.99,0,EUR,COMPLETED,159.84
CARD_PAYMENT,Current,2024-05-19 15:48:03,2024-05-22 10:48:49,PayPal,-16,0,EUR,COMPLETED,143.84
TRANSFER,Current,2024-05-22 13:02:54,2024-05-22 13:02:54,To EUR Savings,-0.2,0,EUR,COMPLETED,143.64
CARD_PAYMENT,Current,2024-05-21 14:31:28,2024-05-22 14:33:34,OpenAI,-11.36,0,EUR,COMPLETED,132.28
TRANSFER,Current,2024-05-22 19:52:50,2024-05-22 19:52:50,To EUR Savings,-0.05,0,EUR,COMPLETED,132.23
CARD_PAYMENT,Current,2024-05-22 13:02:54,2024-05-23 11:32:19,CinemaCity,-21.8,0,EUR,COMPLETED,110.43
TRANSFER,Current,2024-05-23 12:40:07,2024-05-23 12:40:07,To EUR Savings,-0.1,0,EUR,COMPLETED,110.33
CARD_PAYMENT,Current,2024-05-22 19:52:50,2024-05-24 10:56:39,Cinemacity Alfragide,-15.95,0,EUR,COMPLETED,94.38
TOPUP,Current,2024-05-24 11:27:13,2024-05-24 11:27:15,Apple Pay Top-Up by *6660,200,0,EUR,COMPLETED,294.38
TRANSFER,Current,2024-05-25 08:27:32,2024-05-25 08:27:32,To EUR Savings,-0.5,0,EUR,COMPLETED,293.88
TRANSFER,Current,2024-05-25 09:19:23,2024-05-25 09:19:23,To EUR Savings,-0.91,0,EUR,COMPLETED,292.97
CARD_PAYMENT,Current,2024-05-23 12:40:07,2024-05-25 10:49:07,Uber Eats,-19.9,0,EUR,COMPLETED,273.07
TRANSFER,Current,2024-05-25 16:19:29,2024-05-25 16:19:29,To EUR Savings,-0.01,0,EUR,COMPLETED,273.06
TRANSFER,Current,2024-05-26 07:57:32,2024-05-26 07:57:32,To EUR Savings,-0.5,0,EUR,COMPLETED,272.56
CARD_PAYMENT,Current,2024-05-25 09:19:23,2024-05-26 10:48:10,Pingo Doce,-28.09,0,EUR,COMPLETED,244.47
CARD_PAYMENT,Current,2024-05-25 08:27:32,2024-05-26 10:48:21,A Padaria Portuguesa,-2.5,0,EUR,COMPLETED,241.97
TRANSFER,Current,2024-05-26 13:24:03,2024-05-26 13:24:03,To EUR Savings,-0.8,0,EUR,COMPLETED,241.17
TOPUP,Current,2024-05-26 17:02:28,2024-05-26 17:02:29,Apple Pay Top-Up by *6660,200,0,EUR,COMPLETED,441.17
TRANSFER,Current,2024-05-27 09:56:40,2024-05-27 09:56:40,To EUR Savings,-20,0,EUR,COMPLETED,421.17
CARD_PAYMENT,Current,2024-05-25 16:19:29,2024-05-27 10:12:44,PlayStation,-49.99,0,EUR,COMPLETED,371.18
CARD_PAYMENT,Current,2024-05-26 07:57:32,2024-05-27 10:57:29,A Padaria Portuguesa,-2.5,0,EUR,COMPLETED,368.68
TRANSFER,Current,2024-05-27 12:23:35,2024-05-27 12:23:35,To EUR Savings,-0.53,0,EUR,COMPLETED,368.15
TRANSFER,Current,2024-05-27 17:30:48,2024-05-27 17:30:48,To EUR Savings,-0.51,0,EUR,COMPLETED,367.64
CARD_PAYMENT,Current,2024-05-26 13:24:02,2024-05-28 10:11:16,Uber Eats,-34.2,0,EUR,COMPLETED,333.44
TRANSFER,Current,2024-05-28 12:15:53,2024-05-28 12:15:53,To EUR Savings,-0.01,0,EUR,COMPLETED,333.43
TRANSFER,Current,2024-05-28 14:03:44,2024-05-28 14:03:44,To EUR Savings,-0.01,0,EUR,COMPLETED,333.42
CARD_PAYMENT,Current,2024-05-27 12:23:34,2024-05-28 14:59:45,Cursor,-18.47,0,EUR,COMPLETED,314.95
TRANSFER,Current,2024-05-29 05:52:12,2024-05-29 05:52:12,To EUR Savings,-0.51,0,EUR,COMPLETED,314.44
TRANSFER,Current,2024-05-29 12:45:55,2024-05-29 12:45:55,To EUR Savings,-0.2,0,EUR,COMPLETED,314.24
TOPUP,Current,2024-05-29 13:26:36,2024-05-29 13:26:37,Apple Pay Top-Up by *6660,200,0,EUR,COMPLETED,514.24
TRANSFER,Current,2024-05-30 08:18:21,2024-05-30 08:18:21,To EUR Savings,-0.5,0,EUR,COMPLETED,513.74
CARD_PAYMENT,Current,2024-05-28 14:03:43,2024-05-30 08:46:43,Google,-2.99,0,EUR,COMPLETED,510.75
CARD_PAYMENT,Current,2024-05-29 05:52:12,2024-05-30 08:53:53,Apple,-5.49,0,EUR,COMPLETED,505.26
TRANSFER,Current,2024-05-30 09:01:21,2024-05-30 09:01:21,To EUR Savings,-0.01,0,EUR,COMPLETED,505.25
CARD_PAYMENT,Current,2024-05-28 12:15:53,2024-05-30 09:19:15,PlayStation,-8.99,0,EUR,COMPLETED,496.26
CARD_PAYMENT,Current,2024-05-27 17:30:48,2024-05-30 09:21:10,Inf Company Ab,-12.49,0,EUR,COMPLETED,483.77
TRANSFER,Current,2024-05-30 16:29:17,2024-05-30 16:29:17,To EUR Savings,-0.5,0,EUR,COMPLETED,483.27
CARD_PAYMENT,Current,2024-05-29 12:45:55,2024-05-31 11:07:34,Uber Eats,-29.8,0,EUR,COMPLETED,453.47
CARD_PAYMENT,Current,2024-05-30 16:29:17,2024-05-31 12:00:29,Vira Lata,-3.5,0,EUR,COMPLETED,449.97
TRANSFER,Current,2024-05-31 13:18:46,2024-05-31 13:18:46,To EUR Savings,-0.95,0,EUR,COMPLETED,449.02
TRANSFER,Current,2024-05-31 16:15:03,2024-05-31 16:15:04,Revolut Bank UAB,-47.99,0,EUR,COMPLETED,401.03
TRANSFER,Current,2024-06-01 07:45:09,2024-06-01 07:45:09,To EUR Savings,-0.5,0,EUR,COMPLETED,400.53
TRANSFER,Current,2024-06-01 08:28:12,2024-06-01 08:28:12,To EUR Rainy day,-50,0,EUR,COMPLETED,350.53
CARD_PAYMENT,Current,2024-05-30 08:18:20,2024-06-01 09:39:08,A Padaria Portuguesa,-2.5,0,EUR,COMPLETED,348.03
CARD_PAYMENT,Current,2024-05-30 09:01:21,2024-06-01 09:39:16,Leroy Merlin,-9.99,0,EUR,COMPLETED,338.04
TRANSFER,Current,2024-06-01 10:06:14,2024-06-01 10:06:14,To EUR Savings,-0.7,0,EUR,COMPLETED,337.34
TRANSFER,Current,2024-06-01 10:16:09,2024-06-01 10:16:09,To EUR Savings,-0.52,0,EUR,COMPLETED,336.82
CARD_PAYMENT,Current,2024-05-31 13:18:46,2024-06-01 10:58:06,Minipreço,-1.05,0,EUR,COMPLETED,335.77
TRANSFER,Current,2024-06-01 12:03:13,2024-06-01 12:03:13,To EUR Savings,-0.3,0,EUR,COMPLETED,335.47
TRANSFER,Current,2024-06-01 14:19:43,2024-06-01 14:19:43,To EUR Savings,-0.11,0,EUR,COMPLETED,335.36
TRANSFER,Current,2024-06-02 08:02:36,2024-06-02 08:02:36,To EUR Savings,-0.5,0,EUR,COMPLETED,334.86
TRANSFER,Current,2024-06-02 09:02:52,2024-06-02 09:02:52,To EUR Savings,-0.6,0,EUR,COMPLETED,334.26
CARD_PAYMENT,Current,2024-06-01 10:06:13,2024-06-02 09:43:20,Sara Ines Activ,-2.3,0,EUR,COMPLETED,331.96
CARD_PAYMENT,Current,2024-06-01 07:45:09,2024-06-02 10:56:46,A Padaria Portuguesa,-2.5,0,EUR,COMPLETED,329.46
CARD_PAYMENT,Current,2024-06-01 10:16:09,2024-06-02 10:56:51,Mforce,-9.48,0,EUR,COMPLETED,319.98
CARD_PAYMENT,Current,2024-06-01 12:03:13,2024-06-02 12:18:42,Minipreço,-13.7,0,EUR,COMPLETED,306.28
CARD_PAYMENT,Current,2024-06-01 14:19:43,2024-06-02 12:49:18,Taming The Saxophone,-5.89,0.06,EUR,COMPLETED,300.33
TRANSFER,Current,2024-06-03 09:58:24,2024-06-03 09:58:24,To EUR Savings,-20,0,EUR,COMPLETED,280.33
CARD_PAYMENT,Current,2024-06-02 08:02:36,2024-06-03 19:06:11,A Padaria Portuguesa,-2.5,0,EUR,COMPLETED,277.83
CARD_PAYMENT,Current,2024-06-02 09:02:51,2024-06-03 19:06:20,Pingo Doce,-32.4,0,EUR,COMPLETED,245.43
TOPUP,Current,2024-06-04 08:20:26,2024-06-04 08:20:28,Apple Pay Top-Up by *6660,200,0,EUR,COMPLETED,445.43
TRANSFER,Current,2024-06-04 09:23:08,2024-06-04 09:23:08,To EUR Savings,-0.89,0,EUR,COMPLETED,444.54
CARD_PAYMENT,Current,2024-06-04 09:23:08,2024-06-05 12:31:47,Gdi Hub,-46.11,0,EUR,COMPLETED,398.43
TRANSFER,Current,2024-06-05 18:41:23,2024-06-05 18:41:23,To EUR Savings,-0.35,0,EUR,COMPLETED,398.08
TRANSFER,Current,2024-06-05 18:53:45,2024-06-05 18:53:45,To EUR Savings,-0.77,0,EUR,COMPLETED,397.31
TRANSFER,Current,2024-06-05 23:55:06,2024-06-05 23:55:06,To EUR Savings,-0.41,0,EUR,COMPLETED,396.9
TRANSFER,Current,2024-06-06 12:25:44,2024-06-06 12:25:44,To EUR Savings,-0.47,0,EUR,COMPLETED,396.43
TRANSFER,Current,2024-06-06 12:46:08,2024-06-06 12:46:08,To EUR Savings,-0.65,0,EUR,COMPLETED,395.78
TRANSFER,Current,2024-06-06 14:27:58,2024-06-06 14:27:58,Revolut Bank UAB,-36,0,EUR,COMPLETED,359.78
TOPUP,Current,2024-06-06 15:38:12,2024-06-06 15:38:14,Apple Pay Top-Up by *6660,200,0,EUR,COMPLETED,559.78
CARD_PAYMENT,Current,2024-06-05 18:53:45,2024-06-06 15:53:43,Supermaven,-9.23,0,EUR,COMPLETED,550.55
TRANSFER,Current,2024-06-06 22:39:02,2024-06-06 22:39:02,To EUR Savings,-0.65,0,EUR,COMPLETED,549.9
CARD_PAYMENT,Current,2024-06-05 23:55:05,2024-06-07 10:46:45,Uber,-9.59,0,EUR,COMPLETED,540.31
CARD_PAYMENT,Current,2024-06-05 18:41:23,2024-06-07 11:11:02,Uber,-14.65,0,EUR,COMPLETED,525.66
CARD_PAYMENT,Current,2024-06-06 12:25:44,2024-06-07 15:50:28,CodiumAI,-17.53,0,EUR,COMPLETED,508.13
TRANSFER,Current,2024-06-07 19:06:23,2024-06-07 19:06:23,To EUR Savings,-0.2,0,EUR,COMPLETED,507.93
TRANSFER,Current,2024-06-07 21:59:21,2024-06-07 21:59:21,To EUR Savings,-1,0,EUR,COMPLETED,506.93
TRANSFER,Current,2024-06-08 08:25:07,2024-06-08 08:25:07,To EUR Savings,-0.5,0,EUR,COMPLETED,506.43
CARD_PAYMENT,Current,2024-06-06 12:46:07,2024-06-08 09:47:13,Uber Eats,-29.35,0,EUR,COMPLETED,477.08
CARD_PAYMENT,Current,2024-06-07 19:06:23,2024-06-08 12:17:18,Panda Cantina,-52.8,0,EUR,COMPLETED,424.28
TRANSFER,Current,2024-06-08 13:05:19,2024-06-08 13:05:19,To EUR Savings,-0.8,0,EUR,COMPLETED,423.48
CARD_PAYMENT,Current,2024-06-06 22:39:02,2024-06-08 15:22:34,Wikipedia,-2.35,0,EUR,COMPLETED,421.13
TRANSFER,Current,2024-06-09 08:34:41,2024-06-09 08:34:41,To EUR Savings,-0.5,0,EUR,COMPLETED,420.63
CARD_PAYMENT,Current,2024-06-07 21:59:21,2024-06-09 09:36:21,Procopio,-37,0,EUR,COMPLETED,383.63
CARD_PAYMENT,Current,2024-06-08 08:25:07,2024-06-09 10:52:41,A Padaria Portuguesa,-2.5,0,EUR,COMPLETED,381.13
TRANSFER,Current,2024-06-10 08:30:49,2024-06-10 08:30:49,To EUR Savings,-0.5,0,EUR,COMPLETED,380.63
TRANSFER,Current,2024-06-10 09:36:55,2024-06-10 09:36:55,To EUR Savings,-0.14,0,EUR,COMPLETED,380.49
TRANSFER,Current,2024-06-10 09:59:37,2024-06-10 09:59:37,To EUR Savings,-20,0,EUR,COMPLETED,360.49
CARD_PAYMENT,Current,2024-06-08 13:05:19,2024-06-10 11:00:14,Uber Eats,-17.2,0,EUR,COMPLETED,343.29
CARD_PAYMENT,Current,2024-06-09 08:34:41,2024-06-10 12:28:47,A Padaria Portuguesa,-2.5,0,EUR,COMPLETED,340.79
TOPUP,Current,2024-06-10 12:29:09,2024-06-10 12:29:11,Apple Pay Top-Up by *6660,200,0,EUR,COMPLETED,540.79
TRANSFER,Current,2024-06-10 12:39:10,2024-06-10 12:39:10,To EUR Savings,-0.07,0,EUR,COMPLETED,540.72
TRANSFER,Current,2024-06-11 08:41:03,2024-06-11 08:41:03,To EUR Savings,-0.5,0,EUR,COMPLETED,540.22
CARD_PAYMENT,Current,2024-06-10 12:39:10,2024-06-11 10:07:12,Minipreço,-15.93,0,EUR,COMPLETED,524.29
CARD_PAYMENT,Current,2024-06-10 09:36:55,2024-06-11 11:37:59,Pingo Doce,-67.86,0,EUR,COMPLETED,456.43
CARD_PAYMENT,Current,2024-06-10 08:30:48,2024-06-11 11:39:13,A Padaria Portuguesa,-2.5,0,EUR,COMPLETED,453.93
TRANSFER,Current,2024-06-11 13:01:15,2024-06-11 13:01:15,To EUR Savings,-0.2,0,EUR,COMPLETED,453.73
CARD_PAYMENT,Current,2024-06-11 21:14:19,,Stasher,-7.94,0,EUR,REVERTED,
TRANSFER,Current,2024-06-11 21:14:19,2024-06-11 21:14:19,To EUR Savings,-0.06,0,EUR,COMPLETED,453.67
TRANSFER,Current,2024-06-12 07:57:24,2024-06-12 07:57:24,To EUR Savings,-0.5,0,EUR,COMPLETED,453.17
CARD_PAYMENT,Current,2024-06-11 13:01:15,2024-06-12 08:52:59,Uber Eats,-29.8,0,EUR,COMPLETED,423.37
CARD_PAYMENT,Current,2024-06-11 08:41:03,2024-06-12 11:26:52,A Padaria Portuguesa,-2.5,0,EUR,COMPLETED,420.87
TRANSFER,Current,2024-06-12 12:48:32,2024-06-12 12:48:32,To EUR Savings,-0.91,0,EUR,COMPLETED,419.96
TRANSFER,Current,2024-06-13 07:55:32,2024-06-13 07:55:32,To EUR Savings,-0.5,0,EUR,COMPLETED,419.46
CARD_PAYMENT,Current,2024-06-12 12:48:32,2024-06-13 10:12:45,Uber Eats,-47.09,0,EUR,COMPLETED,372.37
TRANSFER,Current,2024-06-13 10:57:32,2024-06-13 10:57:32,To EUR Savings,-1,0,EUR,COMPLETED,371.37
TRANSFER,Current,2024-06-13 11:01:54,2024-06-13 11:01:54,To EUR Savings,-0.5,0,EUR,COMPLETED,370.87
TRANSFER,Current,2024-06-13 11:02:28,2024-06-13 11:02:28,To EUR Savings,-0.65,0,EUR,COMPLETED,370.22
TRANSFER,Current,2024-06-13 14:03:53,2024-06-13 14:03:53,To EUR Savings,-0.4,0,EUR,COMPLETED,369.82
TRANSFER,Current,2024-06-13 18:16:18,2024-06-13 18:16:18,To EUR Savings,-0.39,0,EUR,COMPLETED,369.43
CARD_PAYMENT,Current,2024-06-13 10:57:32,2024-06-14 08:51:18,Miió,-50,0,EUR,COMPLETED,319.43
CARD_PAYMENT,Current,2024-06-12 07:57:24,2024-06-14 08:52:34,A Padaria Portuguesa,-2.5,0,EUR,COMPLETED,316.93
TRANSFER,Current,2024-06-14 11:06:12,2024-06-14 11:06:12,To EUR Savings,-1,0,EUR,COMPLETED,315.93
CARD_PAYMENT,Current,2024-06-13 14:03:53,2024-06-14 11:43:04,Cafe Rest Beira Rio,-30.6,0,EUR,COMPLETED,285.33
CARD_PAYMENT,Current,2024-06-13 18:16:17,2024-06-14 14:16:17,Waves,-33.61,0,EUR,COMPLETED,251.72
TRANSFER,Current,2024-06-14 14:42:26,2024-06-14 14:42:26,To EUR Savings,-1,0,EUR,COMPLETED,250.72
TRANSFER,Current,2024-06-14 15:01:43,2024-06-14 15:01:43,To EUR Savings,-0.5,0,EUR,COMPLETED,250.22
TRANSFER,Current,2024-06-15 07:58:17,2024-06-15 07:58:17,To EUR Savings,-0.5,0,EUR,COMPLETED,249.72
CARD_PAYMENT,Current,2024-06-13 07:55:31,2024-06-15 09:20:05,A Padaria Portuguesa,-2.5,0,EUR,COMPLETED,247.22
CARD_PAYMENT,Current,2024-06-13 11:02:28,2024-06-15 09:22:52,Brisa,-1.35,0,EUR,COMPLETED,245.87
CARD_PAYMENT,Current,2024-06-13 11:01:53,2024-06-15 09:22:52,Brisa,-7.5,0,EUR,COMPLETED,238.37
TOPUP,Current,2024-06-15 09:32:44,2024-06-15 09:32:45,Apple Pay Top-Up by *6660,400,0,EUR,COMPLETED,638.37
CARD_PAYMENT,Current,2024-06-14 14:42:26,2024-06-15 09:49:14,Miió,-20,0,EUR,COMPLETED,618.37
CARD_PAYMENT,Current,2024-06-14 15:01:43,2024-06-15 11:57:18,Alvaros,-48.5,0,EUR,COMPLETED,569.87
CARD_PAYMENT,Current,2024-06-14 11:06:12,2024-06-15 12:01:27,Irmaos Figueiredos,-70,0,EUR,COMPLETED,499.87
TRANSFER,Current,2024-06-16 08:38:02,2024-06-16 08:38:02,To EUR Savings,-0.91,0,EUR,COMPLETED,498.96
TRANSFER,Current,2024-06-16 09:57:22,2024-06-16 09:57:22,To EUR Savings,-0.6,0,EUR,COMPLETED,498.36
TRANSFER,Current,2024-06-16 10:22:55,2024-06-16 10:22:55,To EUR Savings,-0.76,0,EUR,COMPLETED,497.6
CARD_PAYMENT,Current,2024-06-15 07:58:17,2024-06-16 11:54:08,A Padaria Portuguesa,-2.5,0,EUR,COMPLETED,495.1
TRANSFER,Current,2024-06-16 14:29:52,2024-06-16 14:29:52,To EUR Savings,-0.48,0,EUR,COMPLETED,494.62
TRANSFER,Current,2024-06-16 16:18:12,2024-06-16 16:18:12,To EUR Savings,-0.68,0,EUR,COMPLETED,493.94
TRANSFER,Current,2024-06-16 16:38:12,2024-06-16 16:38:12,To EUR Savings,-0.31,0,EUR,COMPLETED,493.63
TRANSFER,Current,2024-06-16 19:54:38,2024-06-16 19:54:38,To EUR Savings,-0.13,0,EUR,COMPLETED,493.5
CARD_PAYMENT,Current,2024-06-16 19:59:10,,Uber,-1.19,0.01,EUR,REVERTED,
TRANSFER,Current,2024-06-16 19:59:10,2024-06-16 19:59:10,To EUR Savings,-0.81,0,EUR,COMPLETED,492.69
TRANSFER,Current,2024-06-16 20:22:02,2024-06-16 20:22:02,To EUR Savings,-0.78,0,EUR,COMPLETED,491.91
TRANSFER,Current,2024-06-17 02:46:20,2024-06-17 02:46:20,To EUR Savings,-0.67,0,EUR,COMPLETED,491.24
CARD_PAYMENT,Current,2024-06-16 08:38:02,2024-06-17 10:54:55,Uber,-16.09,0,EUR,COMPLETED,475.15
CARD_PAYMENT,Current,2024-06-16 09:57:22,2024-06-17 11:33:26,Feito Portugal,-21.4,0,EUR,COMPLETED,453.75
TRANSFER,Current,2024-06-17 13:00:57,2024-06-17 13:00:57,To EUR Savings,-0.62,0,EUR,COMPLETED,453.13
TRANSFER,Current,2024-06-17 15:03:00,2024-06-17 15:03:00,To EUR Savings,-20,0,EUR,COMPLETED,433.13
CARD_PAYMENT,Current,2024-06-16 16:18:12,2024-06-17 15:31:15,Bow Convenience Store,-2.32,0.02,EUR,COMPLETED,430.79
CARD_PAYMENT,Current,2024-06-16 16:38:12,2024-06-17 15:36:50,Benugo,-29.69,0.3,EUR,COMPLETED,400.8
CARD_PAYMENT,Current,2024-06-16 14:29:52,2024-06-17 15:38:05,TSGN,-42.52,0.43,EUR,COMPLETED,357.85
CARD_PAYMENT,Current,2024-06-17 02:46:19,2024-06-17 16:13:49,Transport for London,-3.33,0,EUR,COMPLETED,354.52
TRANSFER,Current,2024-06-17 19:58:18,2024-06-17 19:58:18,To EUR Savings,-0.04,0,EUR,COMPLETED,354.48
TRANSFER,Current,2024-06-17 21:40:57,2024-06-17 21:40:57,To EUR Savings,-0.51,0,EUR,COMPLETED,353.97
CARD_PAYMENT,Current,2024-06-16 10:22:55,2024-06-18 11:26:43,Uber,-0.24,0,EUR,COMPLETED,353.73
CARD_PAYMENT,Current,2024-06-16 20:22:02,2024-06-18 15:34:10,Uber,-15.22,0.15,EUR,COMPLETED,338.36
CARD_PAYMENT,Current,2024-06-16 19:54:38,2024-06-18 15:35:44,Luggagehero Lu,-23.87,0.24,EUR,COMPLETED,314.25
CARD_PAYMENT,Current,2024-06-17 13:00:56,2024-06-18 15:59:31,Tesco,-11.38,0,EUR,COMPLETED,302.87
CARD_PAYMENT,Current,2024-06-17 19:58:18,2024-06-18 15:59:36,Tesco,-8.96,0,EUR,COMPLETED,293.91
TRANSFER,Current,2024-06-18 19:22:10,2024-06-18 19:22:10,To EUR Savings,-0.32,0,EUR,COMPLETED,293.59
TRANSFER,Current,2024-06-18 21:31:31,2024-06-18 21:31:31,To EUR Savings,-0.32,0,EUR,COMPLETED,293.27
TRANSFER,Current,2024-06-19 10:16:18,2024-06-19 10:16:18,To EUR Savings,-0.78,0,EUR,COMPLETED,292.49
TOPUP,Current,2024-06-19 11:16:35,2024-06-19 11:16:36,Apple Pay Top-Up by *6660,200,0,EUR,COMPLETED,492.49
TRANSFER,Current,2024-06-19 12:45:31,2024-06-19 12:45:31,To EUR Savings,-0.05,0,EUR,COMPLETED,492.44
CARD_PAYMENT,Current,2024-06-17 21:40:57,2024-06-19 14:40:16,YouTube,-8.49,0,EUR,COMPLETED,483.95
CARD_PAYMENT,Current,2024-06-18 21:31:31,2024-06-19 15:32:33,CH&CO,-10.68,0,EUR,COMPLETED,473.27
CARD_PAYMENT,Current,2024-06-18 19:22:09,2024-06-19 15:32:33,CH&CO,-10.68,0,EUR,COMPLETED,462.59
TRANSFER,Current,2024-06-19 17:54:11,2024-06-19 17:54:11,To EUR Savings,-0.16,0,EUR,COMPLETED,462.43
TRANSFER,Current,2024-06-19 18:00:08,2024-06-19 18:00:08,To EUR Savings,-0.48,0,EUR,COMPLETED,461.95
TRANSFER,Current,2024-06-20 02:47:18,2024-06-20 02:47:18,To EUR Savings,-0.36,0,EUR,COMPLETED,461.59
TRANSFER,Current,2024-06-20 11:16:26,2024-06-20 11:16:26,To EUR Savings,-0.44,0,EUR,COMPLETED,461.15
TOPUP,Current,2024-06-20 11:26:53,2024-06-20 11:26:54,Apple Pay Top-Up by *6660,200,0,EUR,COMPLETED,661.15
TRANSFER,Current,2024-06-20 12:43:16,2024-06-20 12:43:16,To EUR Savings,-0.2,0,EUR,COMPLETED,660.95
TRANSFER,Current,2024-06-20 13:10:03,2024-06-20 13:10:03,To EUR Savings,-0.01,0,EUR,COMPLETED,660.94
CARD_PAYMENT,Current,2024-06-19 18:00:08,2024-06-20 15:21:56,WHSmith,-8.52,0,EUR,COMPLETED,652.42
CARD_PAYMENT,Current,2024-06-20 02:47:18,2024-06-20 15:34:31,Transport for London,-6.64,0,EUR,COMPLETED,645.78
CARD_PAYMENT,Current,2024-06-19 10:16:18,2024-06-20 15:36:07,TAP Air Portugal,-60.22,0,EUR,COMPLETED,585.56
CARD_PAYMENT,Current,2024-06-19 12:45:31,2024-06-20 16:07:00,OpenAI,-22.95,0,EUR,COMPLETED,562.61
CARD_PAYMENT,Current,2024-06-20 13:10:02,2024-06-21 09:20:18,Uber,-4.99,0,EUR,COMPLETED,557.62
TRANSFER,Current,2024-06-21 11:12:13,2024-06-21 11:12:13,To EUR Subscriptions,-100,0,EUR,COMPLETED,457.62
CARD_PAYMENT,Current,2024-06-19 17:54:11,2024-06-21 13:53:18,Pret,-8.84,0,EUR,COMPLETED,448.78
CARD_PAYMENT,Current,2024-06-20 11:16:26,2024-06-21 14:41:05,Nuroaudioll,-149.56,0,EUR,COMPLETED,299.22
TRANSFER,Current,2024-06-22 08:16:20,2024-06-22 08:16:20,To EUR Savings,-0.5,0,EUR,COMPLETED,298.72
TOPUP,Current,2024-06-22 09:22:29,2024-06-22 09:22:30,Apple Pay Top-Up by *6660,200,0,EUR,COMPLETED,498.72
TRANSFER,Current,2024-06-22 09:35:03,2024-06-22 09:35:03,To EUR Savings,-0.06,0,EUR,COMPLETED,498.66
CARD_PAYMENT,Current,2024-06-20 12:43:16,2024-06-22 10:30:47,Uber Eats,-29.8,0,EUR,COMPLETED,468.86
TRANSFER,Current,2024-06-22 21:03:00,2024-06-22 21:03:00,To EUR Savings,-0.14,0,EUR,COMPLETED,468.72
TRANSFER,Current,2024-06-23 08:29:11,2024-06-23 08:29:11,To EUR Savings,-0.5,0,EUR,COMPLETED,468.22
TRANSFER,Current,2024-06-23 10:18:57,2024-06-23 10:18:57,To EUR Savings,-0.02,0,EUR,COMPLETED,468.2
CARD_PAYMENT,Current,2024-06-22 09:35:03,2024-06-23 10:33:40,Pingo Doce,-31.94,0,EUR,COMPLETED,436.26
CARD_PAYMENT,Current,2024-06-22 08:16:19,2024-06-23 10:36:14,A Padaria Portuguesa,-2.5,0,EUR,COMPLETED,433.76
CARD_PAYMENT,Current,2024-06-22 21:03:00,2024-06-23 14:11:09,Tunecore,-21.86,0.22,EUR,COMPLETED,411.68
CARD_PAYMENT,Current,2024-06-23 08:29:11,2024-06-24 11:14:23,A Padaria Portuguesa,-2.5,0,EUR,COMPLETED,409.18
CARD_PAYMENT,Current,2024-06-23 10:18:57,2024-06-24 11:41:13,Continente,-17.98,0,EUR,COMPLETED,391.2
TRANSFER,Current,2024-06-24 15:33:49,2024-06-24 15:33:49,To EUR Savings,-20,0,EUR,COMPLETED,371.2
TRANSFER,Current,2024-06-24 23:58:20,2024-06-24 23:58:20,To EUR Savings,-0.6,0,EUR,COMPLETED,370.6
CARD_PAYMENT,Current,2024-06-24 23:58:20,2024-06-26 11:16:26,Padaria Lisboa,-3.4,0,EUR,COMPLETED,367.2
TRANSFER,Current,2024-06-26 14:37:40,2024-06-26 14:37:40,To EUR Savings,-0.87,0,EUR,COMPLETED,366.33
TRANSFER,Current,2024-06-26 17:52:39,2024-06-26 17:52:39,To EUR Savings,-0.85,0,EUR,COMPLETED,365.48
TRANSFER,Current,2024-06-26 17:58:11,2024-06-26 17:58:11,To EUR Savings,-0.05,0,EUR,COMPLETED,365.43
TRANSFER,Current,2024-06-26 20:09:59,2024-06-26 20:09:59,To EUR Savings,-0.2,0,EUR,COMPLETED,365.23
CARD_PAYMENT,Current,2024-06-26 17:52:39,2024-06-27 12:40:50,Auchan,-116.15,0,EUR,COMPLETED,249.08
CARD_PAYMENT,Current,2024-06-26 17:58:11,2024-06-27 12:40:53,Gleba,-4.95,0,EUR,COMPLETED,244.13
CARD_PAYMENT,Current,2024-06-26 14:37:40,2024-06-27 17:27:44,GitHub,-3.13,0,EUR,COMPLETED,241
TRANSFER,Current,2024-06-27 18:22:59,2024-06-27 18:22:59,To EUR Savings,-0.65,0,EUR,COMPLETED,240.35
CARD_PAYMENT,Current,2024-06-26 20:09:59,2024-06-28 09:32:54,Uber Eats,-19.8,0,EUR,COMPLETED,220.55
TRANSFER,Current,2024-06-28 12:15:57,2024-06-28 12:15:57,To EUR Savings,-0.01,0,EUR,COMPLETED,220.54
TRANSFER,Current,2024-06-28 12:37:10,2024-06-28 12:37:10,To EUR Savings,-0.2,0,EUR,COMPLETED,220.34
TRANSFER,Current,2024-06-28 14:03:47,2024-06-28 14:03:47,To EUR Savings,-0.01,0,EUR,COMPLETED,220.33
TOPUP,Current,2024-06-28 19:43:14,2024-06-28 19:43:15,Apple Pay Top-Up by *6964,400,0,EUR,COMPLETED,620.33
TRANSFER,Current,2024-06-29 08:16:14,2024-06-29 08:16:14,To EUR Savings,-0.5,0,EUR,COMPLETED,619.83
CARD_PAYMENT,Current,2024-06-27 18:22:59,2024-06-29 12:04:49,IKEA,-90.35,0,EUR,COMPLETED,529.48
TRANSFER,Current,2024-06-29 12:27:24,2024-06-29 12:27:24,To EUR Savings,-0.5,0,EUR,COMPLETED,528.98
TRANSFER,Current,2024-06-29 12:29:30,2024-06-29 12:29:30,Revolut Bank UAB,2,0,EUR,COMPLETED,530.98
TRANSFER,Current,2024-06-29 14:06:24,2024-06-29 14:06:24,To EUR Savings,-1,0,EUR,COMPLETED,529.98
TRANSFER,Current,2024-06-29 14:06:30,2024-06-29 14:06:30,To EUR Savings,-1,0,EUR,COMPLETED,528.98
TRANSFER,Current,2024-06-29 15:35:21,2024-06-29 15:35:21,To EUR Savings,-0.8,0,EUR,COMPLETED,528.18
TRANSFER,Current,2024-06-29 17:22:07,2024-06-29 17:22:07,To EUR Savings,-0.26,0,EUR,COMPLETED,527.92
CARD_PAYMENT,Current,2024-06-29 08:16:14,2024-06-30 09:25:01,A Padaria Portuguesa,-2.5,0,EUR,COMPLETED,525.42
CARD_PAYMENT,Current,2024-06-28 12:15:57,2024-06-30 10:22:50,PlayStation,-8.99,0,EUR,COMPLETED,516.43
CARD_PAYMENT,Current,2024-06-28 14:03:47,2024-06-30 10:48:58,Google,-2.99,0,EUR,COMPLETED,513.44
CARD_PAYMENT,Current,2024-06-29 14:06:24,2024-06-30 11:20:59,Miió,-20,0,EUR,COMPLETED,493.44
CARD_PAYMENT,Current,2024-06-29 14:06:29,2024-06-30 11:21:07,Miió,-20,0,EUR,COMPLETED,473.44
CARD_PAYMENT,Current,2024-06-28 12:37:10,2024-06-30 11:21:50,Uber Eats,-29.8,0,EUR,COMPLETED,443.64
CARD_PAYMENT,Current,2024-06-29 12:27:24,2024-06-30 12:10:43,Brisa,-17.5,0,EUR,COMPLETED,426.14
CARD_PAYMENT,Current,2024-06-29 15:35:20,2024-06-30 12:51:22,Alvaros,-65.2,0,EUR,COMPLETED,360.94
TRANSFER,Current,2024-06-30 15:04:50,2024-06-30 15:04:50,To EUR Savings,-1,0,EUR,COMPLETED,359.94
TRANSFER,Current,2024-06-30 15:36:39,2024-06-30 15:36:39,To EUR Savings,-0.52,0,EUR,COMPLETED,359.42
CARD_PAYMENT,Current,2024-06-29 17:22:06,2024-06-30 16:23:11,Cursor,-18.74,0.19,EUR,COMPLETED,340.49
CARD_PAYMENT,Current,2024-06-30 15:36:39,2024-07-01 10:04:49,Minipreço,-33.48,0,EUR,COMPLETED,307.01
CARD_PAYMENT,Current,2024-06-30 15:04:50,2024-07-01 10:05:38,Cafe Rest Beira Rio,-61,0,EUR,COMPLETED,246.01
TRANSFER,Current,2024-07-01 10:31:42,2024-07-01 10:31:42,To EUR Rainy day,-50,0,EUR,COMPLETED,196.01
TRANSFER,Current,2024-07-01 10:31:42,2024-07-01 10:31:42,To EUR Savings,-20,0,EUR,COMPLETED,176.01
TRANSFER,Current,2024-07-01 10:58:15,2024-07-01 10:58:15,To EUR Savings,-0.93,0,EUR,COMPLETED,175.08
TOPUP,Current,2024-07-01 13:01:37,2024-07-01 13:01:39,Apple Pay Top-Up by *6964,200,0,EUR,COMPLETED,375.08
TRANSFER,Current,2024-07-01 17:27:48,2024-07-01 17:27:48,To EUR Savings,-1,0,EUR,COMPLETED,374.08
CARD_PAYMENT,Current,2024-07-01 17:27:47,2024-07-02 10:44:48,Miió,-20,0,EUR,COMPLETED,354.08
CARD_PAYMENT,Current,2024-07-01 10:58:15,2024-07-02 11:13:55,Minipreço,-48.07,0,EUR,COMPLETED,306.01
TRANSFER,Current,2024-07-02 12:16:09,2024-07-02 12:16:09,Revolut Bank UAB,20,0,EUR,COMPLETED,326.01
TRANSFER,Current,2024-07-02 21:51:40,2024-07-02 21:51:40,To EUR Savings,-1,0,EUR,COMPLETED,325.01
TRANSFER,Current,2024-07-03 12:55:43,2024-07-03 12:55:43,To EUR Savings,-1,0,EUR,COMPLETED,324.01
TRANSFER,Current,2024-07-03 18:44:53,2024-07-03 18:44:53,To EUR Savings,-0.52,0,EUR,COMPLETED,323.49
TRANSFER,Current,2024-07-03 20:15:50,2024-07-03 20:15:50,To EUR Savings,-0.2,0,EUR,COMPLETED,323.29
CARD_PAYMENT,Current,2024-07-03 12:55:43,2024-07-04 09:50:42,Miió,-20,0,EUR,COMPLETED,303.29
CARD_PAYMENT,Current,2024-07-02 21:51:40,2024-07-04 12:18:37,Cafe Rest Beira Rio,-36,0,EUR,COMPLETED,267.29
TOPUP,Current,2024-07-04 21:13:06,2024-07-04 21:13:07,Apple Pay Top-Up by *6964,200,0,EUR,COMPLETED,467.29
TRANSFER,Current,2024-07-04 21:43:37,2024-07-04 21:43:37,To EUR Savings,-0.8,0,EUR,COMPLETED,466.49
CARD_PAYMENT,Current,2024-07-03 18:44:53,2024-07-05 11:40:33,FlixBus,-9.48,0,EUR,COMPLETED,457.01
CARD_PAYMENT,Current,2024-07-03 20:15:50,2024-07-05 12:24:07,Cafe Rest Beira Rio,-18.8,0,EUR,COMPLETED,438.21
TRANSFER,Current,2024-07-05 12:55:27,2024-07-05 12:55:27,To EUR Savings,-1,0,EUR,COMPLETED,437.21
TRANSFER,Current,2024-07-05 15:46:20,2024-07-05 15:46:20,To EUR Savings,-0.2,0,EUR,COMPLETED,437.01
CARD_PAYMENT,Current,2024-07-05 12:55:26,2024-07-06 10:11:39,Miió,-30,0,EUR,COMPLETED,407.01
CARD_PAYMENT,Current,2024-07-04 21:43:37,2024-07-06 10:59:03,Alvaros,-29.2,0,EUR,COMPLETED,377.81
CARD_PAYMENT,Current,2024-07-05 15:46:20,2024-07-06 11:00:26,Isabel Bandeira,-53.8,0,EUR,COMPLETED,324.01
TRANSFER,Current,2024-07-06 15:04:39,2024-07-06 15:04:39,To EUR Savings,-0.1,0,EUR,COMPLETED,323.91
TOPUP,Current,2024-07-06 15:18:27,2024-07-06 15:18:30,Apple Pay Top-Up by *6964,200,0,EUR,COMPLETED,523.91
TRANSFER,Current,2024-07-06 18:21:56,2024-07-06 18:21:56,To EUR Savings,-0.74,0,EUR,COMPLETED,523.17
CARD_PAYMENT,Current,2024-07-06 15:04:38,2024-07-07 09:57:15,Alvaros,-59.9,0,EUR,COMPLETED,463.27
TRANSFER,Current,2024-07-07 14:03:46,2024-07-07 14:03:46,To EUR Savings,-0.3,0,EUR,COMPLETED,462.97
TRANSFER,Current,2024-07-07 16:50:23,2024-07-07 16:50:23,To EUR Savings,-1,0,EUR,COMPLETED,461.97
CARD_PAYMENT,Current,2024-07-06 18:21:55,2024-07-07 16:57:28,GitHub,-9.26,0.09,EUR,COMPLETED,452.62
TRANSFER,Current,2024-07-08 08:11:07,2024-07-08 08:11:07,To EUR Savings,-0.5,0,EUR,COMPLETED,452.12
TRANSFER,Current,2024-07-08 11:07:28,2024-07-08 11:07:28,To EUR Savings,-0.01,0,EUR,COMPLETED,452.11
TOPUP,Current,2024-07-08 11:11:11,2024-07-08 11:11:12,Apple Pay Top-Up by *6964,200,0,EUR,COMPLETED,652.11
CARD_PAYMENT,Current,2024-07-07 16:50:22,2024-07-08 12:07:33,Miió,-30,0,EUR,COMPLETED,622.11
CARD_PAYMENT,Current,2024-07-07 14:03:45,2024-07-08 13:02:43,Alvaros,-58.7,0,EUR,COMPLETED,563.41
TRANSFER,Current,2024-07-08 13:42:10,2024-07-08 13:42:10,To EUR Savings,-0.01,0,EUR,COMPLETED,563.4
TRANSFER,Current,2024-07-08 15:40:50,2024-07-08 15:40:50,To EUR Savings,-0.91,0,EUR,COMPLETED,562.49
TRANSFER,Current,2024-07-08 15:52:21,2024-07-08 15:52:21,To EUR Savings,-20,0,EUR,COMPLETED,542.49
TRANSFER,Current,2024-07-08 17:52:26,2024-07-08 17:52:26,To EUR Savings,-0.5,0,EUR,COMPLETED,541.99
TRANSFER,Current,2024-07-09 08:28:28,2024-07-09 08:28:28,To EUR Savings,-0.5,0,EUR,COMPLETED,541.49
CARD_PAYMENT,Current,2024-07-08 13:42:10,2024-07-09 10:56:51,Worten Resolve,-39.99,0,EUR,COMPLETED,501.5
TRANSFER,Current,2024-07-09 11:23:29,2024-07-09 11:23:29,To EUR Savings,-0.1,0,EUR,COMPLETED,501.4
CARD_PAYMENT,Current,2024-07-08 15:40:50,2024-07-09 11:38:18,Loja das Meias – Cascais,-33.09,0,EUR,COMPLETED,468.31
CARD_PAYMENT,Current,2024-07-08 17:52:25,2024-07-09 11:39:17,Livraria Galileu,-7.5,0,EUR,COMPLETED,460.81
TOPUP,Current,2024-07-09 11:45:09,2024-07-09 11:45:10,Apple Pay Top-Up by *6964,200,0,EUR,COMPLETED,660.81
TRANSFER,Current,2024-07-09 11:46:21,2024-07-09 11:46:21,To EUR Savings,-0.93,0,EUR,COMPLETED,659.88
TRANSFER,Current,2024-07-09 12:05:46,2024-07-09 12:05:46,To EUR Savings,-0.05,0,EUR,COMPLETED,659.83
TRANSFER,Current,2024-07-09 12:23:32,2024-07-09 12:23:32,To EUR Savings,-0.11,0,EUR,COMPLETED,659.72
CARD_PAYMENT,Current,2024-07-08 08:11:07,2024-07-09 15:45:48,A Padaria Portuguesa,-2.5,0,EUR,COMPLETED,657.22
TRANSFER,Current,2024-07-09 16:28:05,2024-07-09 16:28:05,To EUR Savings,-0.56,0,EUR,COMPLETED,656.66
TOPUP,Current,2024-07-09 16:28:28,2024-07-09 16:28:29,Apple Pay Top-Up by *6964,200,0,EUR,COMPLETED,856.66
TRANSFER,Current,2024-07-09 21:35:39,2024-07-09 21:35:39,To EUR Savings,-0.81,0,EUR,COMPLETED,855.85
TRANSFER,Current,2024-07-10 08:30:53,2024-07-10 08:30:53,To EUR Savings,-0.5,0,EUR,COMPLETED,855.35
CARD_PAYMENT,Current,2024-07-09 16:28:05,2024-07-10 10:11:22,Worten Resolve,-237.44,0,EUR,COMPLETED,617.91
CARD_PAYMENT,Current,2024-07-08 11:07:27,2024-07-10 10:12:41,Google,-99.99,0,EUR,COMPLETED,517.92
TRANSFER,Current,2024-07-10 10:54:43,2024-07-10 10:54:43,To EUR Savings,-0.29,0,EUR,COMPLETED,517.63
CARD_PAYMENT,Current,2024-07-09 21:35:38,2024-07-10 11:14:54,Amazon,-12.19,0,EUR,COMPLETED,505.44
CARD_PAYMENT,Current,2024-07-09 11:46:21,2024-07-10 13:23:49,Cortefiel,-90.07,0,EUR,COMPLETED,415.37
CARD_PAYMENT,Current,2024-07-09 11:23:29,2024-07-10 13:23:49,Jld Alfragide Lj 036,-18.9,0,EUR,COMPLETED,396.47
CARD_PAYMENT,Current,2024-07-09 12:05:45,2024-07-10 13:24:00,Massimo Dutti,-36.95,0,EUR,COMPLETED,359.52
CARD_PAYMENT,Current,2024-07-09 12:23:32,2024-07-10 13:24:00,Pingo Doce,-27.89,0,EUR,COMPLETED,331.63
CARD_PAYMENT,Current,2024-07-09 08:28:28,2024-07-10 13:57:29,A Padaria Portuguesa,-2.5,0,EUR,COMPLETED,329.13
TRANSFER,Current,2024-07-10 14:26:25,2024-07-10 14:26:25,To EUR Savings,-0.76,0,EUR,COMPLETED,328.37
TRANSFER,Current,2024-07-10 19:19:37,2024-07-10 19:19:37,To EUR Savings,-0.23,0,EUR,COMPLETED,328.14
TRANSFER,Current,2024-07-10 19:47:44,2024-07-10 19:47:44,To EUR Savings,-1,0,EUR,COMPLETED,327.14
TRANSFER,Current,2024-07-10 22:56:26,2024-07-10 22:56:26,To EUR Savings,-0.77,0,EUR,COMPLETED,326.37
CARD_PAYMENT,Current,2024-07-10 22:57:55,,Uber,-5.66,0,EUR,REVERTED,
TRANSFER,Current,2024-07-10 22:57:55,2024-07-10 22:57:55,To EUR Savings,-0.34,0,EUR,COMPLETED,326.03
TRANSFER,Current,2024-07-10 23:10:12,2024-07-10 23:10:12,To EUR Savings,-0.45,0,EUR,COMPLETED,325.58
CARD_PAYMENT,Current,2024-07-10 19:47:44,2024-07-11 10:59:33,Festival Jardins Do,-42,0,EUR,COMPLETED,283.58
CARD_PAYMENT,Current,2024-07-10 23:10:12,2024-07-11 11:37:04,Bolt,-6.55,0,EUR,COMPLETED,277.03
CARD_PAYMENT,Current,2024-07-10 14:26:25,2024-07-11 11:51:23,Minipreço,-16.24,0,EUR,COMPLETED,260.79
CARD_PAYMENT,Current,2024-07-10 08:30:53,2024-07-11 12:06:02,A Padaria Portuguesa,-2.5,0,EUR,COMPLETED,258.29
TRANSFER,Current,2024-07-11 12:40:43,2024-07-11 12:40:43,To EUR Savings,-0.3,0,EUR,COMPLETED,257.99
TRANSFER,Current,2024-07-12 08:30:31,2024-07-12 08:30:31,To EUR Savings,-0.5,0,EUR,COMPLETED,257.49
CARD_PAYMENT,Current,2024-07-10 22:56:26,2024-07-12 10:40:48,Uber,-0.23,0,EUR,COMPLETED,257.26
CARD_PAYMENT,Current,2024-07-10 19:19:36,2024-07-12 10:52:27,Uber,-5.77,0,EUR,COMPLETED,251.49
TRANSFER,Current,2024-07-12 13:05:20,2024-07-12 13:05:20,To EUR Savings,-0.8,0,EUR,COMPLETED,250.69
TOPUP,Current,2024-07-12 17:34:20,2024-07-12 17:34:22,Apple Pay Top-Up by *6964,300,0,EUR,COMPLETED,550.69
TRANSFER,Current,2024-07-12 20:13:47,2024-07-12 20:13:47,To EUR Savings,-0.38,0,EUR,COMPLETED,550.31
TRANSFER,Current,2024-07-13 07:56:30,2024-07-13 07:56:30,To EUR Savings,-0.5,0,EUR,COMPLETED,549.81
TRANSFER,Current,2024-07-13 09:04:40,2024-07-13 09:04:40,To EUR Savings,-1,0,EUR,COMPLETED,548.81
TRANSFER,Current,2024-07-13 10:25:30,2024-07-13 10:25:30,To EUR Savings,-0.5,0,EUR,COMPLETED,548.31
CARD_PAYMENT,Current,2024-07-12 08:30:31,2024-07-13 10:52:11,A Padaria Portuguesa,-2.5,0,EUR,COMPLETED,545.81
TRANSFER,Current,2024-07-13 11:08:02,2024-07-13 11:08:02,To EUR Savings,-0.5,0,EUR,COMPLETED,545.31
CARD_PAYMENT,Current,2024-07-10 10:54:43,2024-07-13 11:56:37,PayPal,-5.71,0,EUR,COMPLETED,539.6
CARD_PAYMENT,Current,2024-07-11 12:40:43,2024-07-13 12:03:07,Uber Eats,-39.7,0,EUR,COMPLETED,499.9
TRANSFER,Current,2024-07-13 12:22:37,2024-07-13 12:22:37,To EUR Savings,-0.85,0,EUR,COMPLETED,499.05
TRANSFER,Current,2024-07-14 08:27:31,2024-07-14 08:27:31,To EUR Savings,-0.5,0,EUR,COMPLETED,498.55
CARD_PAYMENT,Current,2024-07-12 13:05:20,2024-07-14 09:35:32,Uber Eats,-33.2,0,EUR,COMPLETED,465.35
CARD_PAYMENT,Current,2024-07-13 11:08:02,2024-07-14 09:43:09,Terco Do Meio,-70.5,0,EUR,COMPLETED,394.85
CARD_PAYMENT,Current,2024-07-13 10:25:30,2024-07-14 09:43:18,Terco Do Meio,-34.5,0,EUR,COMPLETED,360.35
CARD_PAYMENT,Current,2024-07-13 07:56:30,2024-07-14 09:48:27,A Padaria Portuguesa,-2.5,0,EUR,COMPLETED,357.85
CARD_PAYMENT,Current,2024-07-13 12:22:36,2024-07-14 09:48:31,Vila Santn Ana Ii,-3.15,0,EUR,COMPLETED,354.7
CARD_PAYMENT,Current,2024-07-13 09:04:40,2024-07-14 12:42:56,Mercearia Da Sofia,-13,0,EUR,COMPLETED,341.7
CARD_PAYMENT,Current,2024-07-12 20:13:47,2024-07-14 12:43:19,Minipreço,-7.62,0,EUR,COMPLETED,334.08
TRANSFER,Current,2024-07-14 15:15:01,2024-07-14 15:15:01,To EUR Savings,-0.01,0,EUR,COMPLETED,334.07
TRANSFER,Current,2024-07-14 20:03:11,2024-07-14 20:03:11,To EUR Savings,-0.5,0,EUR,COMPLETED,333.57
TRANSFER,Current,2024-07-15 09:56:26,2024-07-15 09:56:26,To EUR Savings,-20,0,EUR,COMPLETED,313.57
CARD_PAYMENT,Current,2024-07-14 15:15:01,2024-07-15 12:31:23,International Flaver,-3.99,0,EUR,COMPLETED,309.58
CARD_PAYMENT,Current,2024-07-14 08:27:31,2024-07-15 12:43:40,A Padaria Portuguesa,-2.5,0,EUR,COMPLETED,307.08
TOPUP,Current,2024-07-15 21:41:50,2024-07-15 21:41:51,Apple Pay Top-Up by *6964,200,0,EUR,COMPLETED,507.08
CARD_PAYMENT,Current,2024-07-14 20:03:11,2024-07-16 10:51:49,Uber Eats,-48.5,0,EUR,COMPLETED,458.58
TRANSFER,Current,2024-07-17 11:47:43,2024-07-17 11:47:43,To EUR Savings,-0.03,0,EUR,COMPLETED,458.55
TRANSFER,Current,2024-07-17 11:49:46,2024-07-17 11:49:46,To EUR Savings,-0.84,0,EUR,COMPLETED,457.71
TRANSFER,Current,2024-07-17 11:56:03,2024-07-17 11:56:03,Revolut Bank UAB,70,0,EUR,COMPLETED,527.71
TRANSFER,Current,2024-07-17 17:25:27,2024-07-17 17:25:27,To EUR Savings,-0.95,0,EUR,COMPLETED,526.76
TRANSFER,Current,2024-07-17 17:51:28,2024-07-17 17:51:28,To EUR Savings,-0.46,0,EUR,COMPLETED,526.3
TRANSFER,Current,2024-07-17 18:16:32,2024-07-17 18:16:32,To EUR Savings,-0.56,0,EUR,COMPLETED,525.74
TRANSFER,Current,2024-07-17 21:40:57,2024-07-17 21:40:57,To EUR Savings,-0.51,0,EUR,COMPLETED,525.23
TRANSFER,Current,2024-07-18 08:08:09,2024-07-18 08:08:09,Revolut Bank UAB,233.8,0,EUR,COMPLETED,759.03
TRANSFER,Current,2024-07-18 08:14:32,2024-07-18 08:14:32,To EUR Savings,-0.21,0,EUR,COMPLETED,758.82
CARD_PAYMENT,Current,2024-07-17 17:25:27,2024-07-18 09:26:02,Massimo Dutti,-30.05,0,EUR,COMPLETED,728.77
CARD_PAYMENT,Current,2024-07-17 17:51:28,2024-07-18 09:26:12,Auchan,-25.54,0,EUR,COMPLETED,703.23
CARD_PAYMENT,Current,2024-07-17 18:16:31,2024-07-18 09:26:15,Pingo Doce,-19.44,0,EUR,COMPLETED,683.79
TRANSFER,Current,2024-07-18 10:15:28,2024-07-18 10:15:28,To EUR Savings,-0.82,0,EUR,COMPLETED,682.97
TRANSFER,Current,2024-07-18 12:47:04,2024-07-18 12:47:04,To EUR Savings,-0.2,0,EUR,COMPLETED,682.77
TOPUP,Current,2024-07-18 14:13:56,2024-07-18 14:13:58,Apple Pay Top-Up by *6964,500,0,EUR,COMPLETED,1182.77
TRANSFER,Current,2024-07-18 14:15:09,2024-07-18 14:15:09,To EUR Savings,-1,0,EUR,COMPLETED,1181.77
TRANSFER,Current,2024-07-18 20:42:12,2024-07-18 20:42:12,To EUR Savings,-0.67,0,EUR,COMPLETED,1181.1
CARD_PAYMENT,Current,2024-07-17 11:47:43,2024-07-19 10:16:36,Amazon,-59.97,0,EUR,COMPLETED,1121.13
CARD_PAYMENT,Current,2024-07-17 11:49:45,2024-07-19 10:20:08,Amazon,-10.16,0,EUR,COMPLETED,1110.97
CARD_PAYMENT,Current,2024-07-18 08:14:31,2024-07-19 10:30:17,Amazon,-233.79,0,EUR,COMPLETED,877.18
TRANSFER,Current,2024-07-19 12:46:47,2024-07-19 12:46:47,To EUR Savings,-0.34,0,EUR,COMPLETED,876.84
CARD_PAYMENT,Current,2024-07-17 21:40:57,2024-07-19 13:20:55,YouTube,-8.49,0,EUR,COMPLETED,868.35
CARD_PAYMENT,Current,2024-07-18 10:15:28,2024-07-19 15:20:56,Supermaven,-9.18,0,EUR,COMPLETED,859.17
TRANSFER,Current,2024-07-20 08:21:43,2024-07-20 08:21:43,To EUR Savings,-0.5,0,EUR,COMPLETED,858.67
CARD_PAYMENT,Current,2024-07-18 12:47:03,2024-07-20 10:01:31,Uber Eats,-29.8,0,EUR,COMPLETED,828.87
CARD_PAYMENT,Current,2024-07-18 14:15:09,2024-07-20 10:02:11,PayPal,-549,0,EUR,COMPLETED,279.87
CARD_PAYMENT,Current,2024-07-18 20:42:11,2024-07-20 10:39:01,Minipreço,-5.33,0,EUR,COMPLETED,274.54
TRANSFER,Current,2024-07-20 13:10:03,2024-07-20 13:10:03,To EUR Savings,-0.01,0,EUR,COMPLETED,274.53
TRANSFER,Current,2024-07-20 15:35:26,2024-07-20 15:35:26,To EUR Savings,-0.75,0,EUR,COMPLETED,273.78
CARD_PAYMENT,Current,2024-07-19 12:46:46,2024-07-20 16:22:18,OpenAI,-22.66,0,EUR,COMPLETED,251.12
TRANSFER,Current,2024-07-21 08:29:11,2024-07-21 08:29:11,To EUR Savings,-0.5,0,EUR,COMPLETED,250.62
CARD_PAYMENT,Current,2024-07-20 08:21:43,2024-07-21 09:25:39,A Padaria Portuguesa,-2.5,0,EUR,COMPLETED,248.12
TRANSFER,Current,2024-07-21 11:03:52,2024-07-21 11:03:52,To EUR Subscriptions,-100,0,EUR,COMPLETED,148.12
TRANSFER,Current,2024-07-21 11:31:08,2024-07-21 11:31:08,To EUR Savings,-0.2,0,EUR,COMPLETED,147.92
CARD_PAYMENT,Current,2024-07-20 15:35:25,2024-07-21 11:51:56,Espaco Acores,-72.25,0,EUR,COMPLETED,75.67
TRANSFER,Current,2024-07-21 12:47:17,2024-07-21 12:47:17,To EUR Savings,-0.25,0,EUR,COMPLETED,75.42
CARD_PAYMENT,Current,2024-07-20 13:10:03,2024-07-22 09:38:55,Uber,-4.99,0,EUR,COMPLETED,70.43
CARD_PAYMENT,Current,2024-07-21 11:31:07,2024-07-22 09:49:33,J.m.b. Cafetarias L,-6.8,0,EUR,COMPLETED,63.63
TRANSFER,Current,2024-07-22 09:49:44,2024-07-22 09:49:44,To EUR Savings,-20,0,EUR,COMPLETED,43.63
CARD_PAYMENT,Current,2024-07-21 08:29:11,2024-07-22 09:52:11,A Padaria Portuguesa,-2.5,0,EUR,COMPLETED,41.13
TOPUP,Current,2024-07-22 11:08:03,2024-07-22 11:08:04,Apple Pay Top-Up by *6964,500,0,EUR,COMPLETED,541.13
TRANSFER,Current,2024-07-22 13:02:57,2024-07-22 13:02:57,To EUR Savings,-0.8,0,EUR,COMPLETED,540.33
CARD_PAYMENT,Current,2024-07-21 12:47:16,2024-07-23 09:53:06,Uber Eats,-38.75,0,EUR,COMPLETED,501.58
TRANSFER,Current,2024-07-23 19:28:27,2024-07-23 19:28:27,To EUR Savings,-0.66,0,EUR,COMPLETED,500.92
CARD_PAYMENT,Current,2024-07-22 13:02:57,2024-07-24 10:03:56,Uber Eats,-31.2,0,EUR,COMPLETED,469.72
CARD_PAYMENT,Current,2024-07-23 19:28:27,2024-07-24 12:03:48,Pingo Doce,-10.34,0,EUR,COMPLETED,459.38
TRANSFER,Current,2024-07-24 13:08:03,2024-07-24 13:08:03,To EUR Savings,-0.95,0,EUR,COMPLETED,458.43
TRANSFER,Current,2024-07-24 14:24:40,2024-07-24 14:24:40,To EUR Savings,-0.01,0,EUR,COMPLETED,458.42
TRANSFER,Current,2024-07-24 18:59:12,2024-07-24 18:59:12,To EUR Savings,-0.64,0,EUR,COMPLETED,457.78
TRANSFER,Current,2024-07-25 08:35:18,2024-07-25 08:35:18,To EUR Savings,-0.68,0,EUR,COMPLETED,457.1
CARD_PAYMENT,Current,2024-07-24 13:08:03,2024-07-25 09:40:11,Minipreço,-1.05,0,EUR,COMPLETED,456.05
CARD_PAYMENT,Current,2024-07-24 18:59:12,2024-07-25 11:42:37,Leroy Merlin,-111.36,0,EUR,COMPLETED,344.69
TRANSFER,Current,2024-07-25 12:35:43,2024-07-25 12:35:43,To EUR Savings,-0.2,0,EUR,COMPLETED,344.49
CARD_PAYMENT,Current,2024-07-25 08:35:18,2024-07-25 14:41:49,Musixmatch,-23.32,0,EUR,COMPLETED,321.17
TRANSFER,Current,2024-07-25 15:27:48,2024-07-25 15:27:48,To EUR Savings,-0.76,0,EUR,COMPLETED,320.41
CARD_PAYMENT,Current,2024-07-24 14:24:40,2024-07-26 09:29:23,PlayStation,-11.99,0,EUR,COMPLETED,308.42
CARD_PAYMENT,Current,2024-07-25 15:27:48,2024-07-26 14:51:35,Musixmatch,-43.24,0,EUR,COMPLETED,265.18
TRANSFER,Current,2024-07-27 07:36:32,2024-07-27 07:36:32,To EUR Savings,-0.5,0,EUR,COMPLETED,264.68
CARD_PAYMENT,Current,2024-07-25 12:35:43,2024-07-27 10:49:58,Uber Eats,-29.8,0,EUR,COMPLETED,234.88
TRANSFER,Current,2024-07-27 12:07:33,2024-07-27 12:07:33,To EUR Savings,-0.2,0,EUR,COMPLETED,234.68
TRANSFER,Current,2024-07-27 12:39:35,2024-07-27 12:39:35,To EUR Savings,-1,0,EUR,COMPLETED,233.68
TRANSFER,Current,2024-07-27 13:21:50,2024-07-27 13:21:50,To EUR Savings,-0.53,0,EUR,COMPLETED,233.15
TOPUP,Current,2024-07-27 13:48:54,2024-07-27 13:48:55,Apple Pay Top-Up by *6964,400,0,EUR,COMPLETED,633.15
TRANSFER,Current,2024-07-27 14:51:01,2024-07-27 14:51:01,To EUR Savings,-0.1,0,EUR,COMPLETED,633.05
TRANSFER,Current,2024-07-27 20:12:08,2024-07-27 20:12:08,To EUR Savings,-0.3,0,EUR,COMPLETED,632.75
TRANSFER,Current,2024-07-28 09:16:09,2024-07-28 09:16:09,To EUR Savings,-0.5,0,EUR,COMPLETED,632.25
CARD_PAYMENT,Current,2024-07-27 07:36:32,2024-07-28 09:33:11,A Padaria Portuguesa,-2.5,0,EUR,COMPLETED,629.75
CARD_PAYMENT,Current,2024-07-27 12:07:33,2024-07-28 11:11:14,Brisa,-11.8,0,EUR,COMPLETED,617.95
CARD_PAYMENT,Current,2024-07-27 12:39:35,2024-07-28 11:34:37,Miió,-30,0,EUR,COMPLETED,587.95
CARD_PAYMENT,Current,2024-07-27 14:51:01,2024-07-28 11:38:46,Alvaros,-31.9,0,EUR,COMPLETED,556.05
CARD_PAYMENT,Current,2024-07-28 11:42:01,,Dashlaneusa,-39.99,0,EUR,REVERTED,
TRANSFER,Current,2024-07-28 11:42:01,2024-07-28 11:42:01,To EUR Savings,-0.01,0,EUR,COMPLETED,556.04
TRANSFER,Current,2024-07-28 12:15:51,2024-07-28 12:15:51,To EUR Savings,-0.01,0,EUR,COMPLETED,556.03
CARD_PAYMENT,Current,2024-07-27 13:21:49,2024-07-28 14:55:18,Cursor,-18.47,0.18,EUR,COMPLETED,537.38
TRANSFER,Current,2024-07-28 20:32:01,2024-07-28 20:32:01,To EUR Savings,-0.8,0,EUR,COMPLETED,536.58
TRANSFER,Current,2024-07-29 09:51:45,2024-07-29 09:51:45,To EUR Savings,-20,0,EUR,COMPLETED,516.58
CARD_PAYMENT,Current,2024-07-27 20:12:08,2024-07-29 10:14:38,Alvaros,-12.7,0,EUR,COMPLETED,503.88
CARD_PAYMENT,Current,2024-07-28 09:16:09,2024-07-29 10:16:09,Oleigois,-9.5,0,EUR,COMPLETED,494.38
TRANSFER,Current,2024-07-29 22:17:43,2024-07-29 22:17:43,To EUR Savings,-1,0,EUR,COMPLETED,493.38
CARD_PAYMENT,Current,2024-07-28 12:15:51,2024-07-30 10:02:27,PlayStation,-8.99,0,EUR,COMPLETED,484.39
CARD_PAYMENT,Current,2024-07-29 22:17:43,2024-07-30 10:15:47,Miió,-30,0,EUR,COMPLETED,454.39
CARD_PAYMENT,Current,2024-07-28 20:32:01,2024-07-30 10:17:09,Cafe Rest Beira Rio,-24.2,0,EUR,COMPLETED,430.19
TRANSFER,Current,2024-07-30 18:12:38,2024-07-30 18:12:38,To EUR Savings,-0.2,0,EUR,COMPLETED,429.99
TRANSFER,Current,2024-07-31 18:08:36,2024-07-31 18:08:36,To EUR Savings,-0.9,0,EUR,COMPLETED,429.09
TRANSFER,Current,2024-07-31 19:58:50,2024-07-31 19:58:50,To EUR Savings,-0.5,0,EUR,COMPLETED,428.59
TRANSFER,Current,2024-07-31 20:33:20,2024-07-31 20:33:20,To EUR Savings,-1,0,EUR,COMPLETED,427.59
TRANSFER,Current,2024-08-01 08:35:51,2024-08-01 08:35:51,To EUR Rainy day,-50,0,EUR,COMPLETED,377.59
CARD_PAYMENT,Current,2024-07-30 18:12:38,2024-08-01 09:43:58,Uber,-3.8,0,EUR,COMPLETED,373.79
CARD_PAYMENT,Current,2024-07-31 19:58:50,2024-08-01 11:10:08,CASA,-17.5,0,EUR,COMPLETED,356.29
CARD_PAYMENT,Current,2024-07-31 20:33:19,2024-08-01 11:10:14,Churraria Delgado,-16,0,EUR,COMPLETED,340.29
TRANSFER,Current,2024-08-01 13:00:56,2024-08-01 13:00:56,To EUR Savings,-0.38,0,EUR,COMPLETED,339.91
CARD_PAYMENT,Current,2024-07-31 18:08:36,2024-08-02 15:17:13,PayPal,-32.1,0,EUR,COMPLETED,307.81
TRANSFER,Current,2024-08-02 20:56:34,2024-08-02 20:56:34,To EUR Savings,-0.99,0,EUR,COMPLETED,306.82
TRANSFER,Current,2024-08-03 07:51:50,2024-08-03 07:51:50,To EUR Savings,-0.5,0,EUR,COMPLETED,306.32
TRANSFER,Current,2024-08-03 09:08:04,2024-08-03 09:08:04,To EUR Savings,-0.09,0,EUR,COMPLETED,306.23
TRANSFER,Current,2024-08-03 09:38:10,2024-08-03 09:38:10,To EUR Savings,-0.51,0,EUR,COMPLETED,305.72
TOPUP,Current,2024-08-03 09:38:56,2024-08-03 09:38:57,Apple Pay Top-Up by *6964,200,0,EUR,COMPLETED,505.72
CARD_PAYMENT,Current,2024-08-01 13:00:56,2024-08-03 10:06:31,Uber Eats,-29.62,0,EUR,COMPLETED,476.1
TRANSFER,Current,2024-08-03 15:11:13,2024-08-03 15:11:13,To EUR Savings,-1,0,EUR,COMPLETED,475.1
TRANSFER,Current,2024-08-04 08:32:31,2024-08-04 08:32:31,To EUR Savings,-0.5,0,EUR,COMPLETED,474.6
CARD_PAYMENT,Current,2024-08-02 20:56:34,2024-08-04 09:28:01,Minipreço,-14.01,0,EUR,COMPLETED,460.59
CARD_PAYMENT,Current,2024-08-03 07:51:50,2024-08-04 09:28:51,A Padaria Portuguesa,-2.5,0,EUR,COMPLETED,458.09
TRANSFER,Current,2024-08-04 10:03:27,2024-08-04 10:03:27,To EUR Savings,-0.86,0,EUR,COMPLETED,457.23
TRANSFER,Current,2024-08-04 10:19:59,2024-08-04 10:19:59,To EUR Savings,-0.5,0,EUR,COMPLETED,456.73
CARD_PAYMENT,Current,2024-08-03 09:08:03,2024-08-04 11:40:44,Pingo Doce,-35.91,0,EUR,COMPLETED,420.82
CARD_PAYMENT,Current,2024-08-03 15:11:13,2024-08-04 11:41:14,Gigino Gigeto,-47,0,EUR,COMPLETED,373.82
TRANSFER,Current,2024-08-04 15:58:23,2024-08-04 15:58:23,To EUR Savings,-1,0,EUR,COMPLETED,372.82
CARD_PAYMENT,Current,2024-08-03 09:38:10,2024-08-05 09:51:58,PlayStation,-25.49,0,EUR,COMPLETED,347.33
TRANSFER,Current,2024-08-05 09:56:04,2024-08-05 09:56:04,To EUR Savings,-20,0,EUR,COMPLETED,327.33
CARD_PAYMENT,Current,2024-08-04 10:03:27,2024-08-05 10:24:21,Amazon,-9.14,0,EUR,COMPLETED,318.19
CARD_PAYMENT,Current,2024-08-04 10:19:59,2024-08-05 10:24:53,Amazon,-31.5,0,EUR,COMPLETED,286.69
CARD_PAYMENT,Current,2024-08-04 15:58:23,2024-08-05 11:22:51,Pereira Canas,-70,0,EUR,COMPLETED,216.69
CARD_PAYMENT,Current,2024-08-04 08:32:31,2024-08-05 11:23:44,A Padaria Portuguesa,-2.5,0,EUR,COMPLETED,214.19
TRANSFER,Current,2024-08-06 15:03:59,2024-08-06 15:03:59,To EUR Savings,-0.65,0,EUR,COMPLETED,213.54
TOPUP,Current,2024-08-06 15:04:08,2024-08-06 15:04:10,Apple Pay Top-Up by *6964,200,0,EUR,COMPLETED,413.54
TRANSFER,Current,2024-08-06 18:14:13,2024-08-06 18:14:13,To EUR Savings,-0.81,0,EUR,COMPLETED,412.73
CARD_PAYMENT,Current,2024-08-06 15:03:58,2024-08-07 10:36:00,Amazon,-22.35,0,EUR,COMPLETED,390.38
CARD_PAYMENT,Current,2024-08-06 18:14:13,2024-08-07 15:00:44,GitHub,-9.19,0,EUR,COMPLETED,381.19
TRANSFER,Current,2024-08-07 18:49:24,2024-08-07 18:49:24,To EUR Savings,-1,0,EUR,COMPLETED,380.19
TRANSFER,Current,2024-08-08 08:34:51,2024-08-08 08:34:51,To EUR Savings,-0.9,0,EUR,COMPLETED,379.29
TRANSFER,Current,2024-08-08 12:41:33,2024-08-08 12:41:33,To EUR Savings,-0.2,0,EUR,COMPLETED,379.09
CARD_PAYMENT,Current,2024-08-07 18:49:23,2024-08-09 08:51:18,Amazon,-13,0,EUR,COMPLETED,366.09
CARD_PAYMENT,Current,2024-08-08 08:34:50,2024-08-09 10:13:40,Soma Recheada,-3.1,0,EUR,COMPLETED,362.99
TRANSFER,Current,2024-08-09 21:24:35,2024-08-09 21:24:35,To EUR Savings,-0.9,0,EUR,COMPLETED,362.09
TRANSFER,Current,2024-08-10 08:17:46,2024-08-10 08:17:46,To EUR Savings,-0.01,0,EUR,COMPLETED,362.08
CARD_PAYMENT,Current,2024-08-08 12:41:28,2024-08-10 10:03:47,Uber Eats,-29.8,0,EUR,COMPLETED,332.28
TRANSFER,Current,2024-08-10 11:48:39,2024-08-10 11:48:39,To EUR Savings,-0.04,0,EUR,COMPLETED,332.24
TRANSFER,Current,2024-08-10 12:15:37,2024-08-10 12:15:37,To EUR Savings,-0.32,0,EUR,COMPLETED,331.92
TRANSFER,Current,2024-08-10 12:48:42,2024-08-10 12:48:42,To EUR Savings,-0.9,0,EUR,COMPLETED,331.02
TRANSFER,Current,2024-08-10 13:00:53,2024-08-10 13:00:53,To EUR Savings,-0.58,0,EUR,COMPLETED,330.44
CARD_PAYMENT,Current,2024-08-10 13:10:27,,Celavilda,-28,0,EUR,REVERTED,
TRANSFER,Current,2024-08-10 13:10:27,2024-08-10 13:10:27,To EUR Savings,-1,0,EUR,COMPLETED,329.44
TRANSFER,Current,2024-08-10 13:11:33,2024-08-10 13:11:33,To EUR Savings,-0.01,0,EUR,COMPLETED,329.43
TOPUP,Current,2024-08-10 14:17:38,2024-08-10 14:17:39,Apple Pay Top-Up by *6964,200,0,EUR,COMPLETED,529.43
TRANSFER,Current,2024-08-10 19:05:23,2024-08-10 19:05:23,To EUR Savings,-0.5,0,EUR,COMPLETED,528.93
TRANSFER,Current,2024-08-10 21:12:04,2024-08-10 21:12:04,To EUR Savings,-0.95,0,EUR,COMPLETED,527.98
TRANSFER,Current,2024-08-10 21:13:45,2024-08-10 21:13:45,To EUR Savings,-0.95,0,EUR,COMPLETED,527.03
TRANSFER,Current,2024-08-11 08:16:07,2024-08-11 08:16:07,To EUR Savings,-0.5,0,EUR,COMPLETED,526.53
TRANSFER,Current,2024-08-11 09:19:30,2024-08-11 09:19:30,To EUR Savings,-0.06,0,EUR,COMPLETED,526.47
CARD_PAYMENT,Current,2024-08-10 08:17:46,2024-08-11 09:34:18,A Padaria Portuguesa,-3.99,0,EUR,COMPLETED,522.48
CARD_PAYMENT,Current,2024-08-10 13:00:52,2024-08-11 09:36:57,Minipreço,-9.42,0,EUR,COMPLETED,513.06
CARD_PAYMENT,Current,2024-08-10 11:48:38,2024-08-11 11:16:11,Auchan,-35.96,0,EUR,COMPLETED,477.1
CARD_PAYMENT,Current,2024-08-10 12:15:36,2024-08-11 11:16:11,Leroy Merlin,-9.68,0,EUR,COMPLETED,467.42
CARD_PAYMENT,Current,2024-08-09 21:24:35,2024-08-11 11:16:29,La Siesta,-53.1,0,EUR,COMPLETED,414.32
CARD_PAYMENT,Current,2024-08-10 19:05:23,2024-08-11 11:17:10,La Fugitiva,-53.5,0,EUR,COMPLETED,360.82
CARD_PAYMENT,Current,2024-08-10 13:11:33,2024-08-12 08:56:45,Celavilda,-33.99,0,EUR,COMPLETED,326.83
CARD_PAYMENT,Current,2024-08-10 12:48:42,2024-08-12 09:01:58,Uber Eats,-17.1,0,EUR,COMPLETED,309.73
TRANSFER,Current,2024-08-12 09:49:33,2024-08-12 09:49:33,To EUR Savings,-20,0,EUR,COMPLETED,289.73
CARD_PAYMENT,Current,2024-08-10 21:13:45,2024-08-12 10:55:42,Mercado da Ribeira,-8.05,0,EUR,COMPLETED,281.68
CARD_PAYMENT,Current,2024-08-10 21:12:04,2024-08-12 10:55:45,Mercado da Ribeira,-8.05,0,EUR,COMPLETED,273.63
CARD_PAYMENT,Current,2024-08-11 08:16:06,2024-08-12 10:55:54,A Padaria Portuguesa,-2.5,0,EUR,COMPLETED,271.13
CARD_PAYMENT,Current,2024-08-11 09:19:30,2024-08-12 11:59:15,Pingo Doce,-48.94,0,EUR,COMPLETED,222.19
TOPUP,Current,2024-08-14 07:56:14,2024-08-14 07:56:16,Apple Pay Top-Up by *6964,200,0,EUR,COMPLETED,422.19
TRANSFER,Current,2024-08-15 08:10:45,2024-08-15 08:10:45,To EUR Savings,-0.5,0,EUR,COMPLETED,421.69
TRANSFER,Current,2024-08-15 12:51:48,2024-08-15 12:51:48,To EUR Savings,-0.8,0,EUR,COMPLETED,420.89
CARD_PAYMENT,Current,2024-08-15 08:10:45,2024-08-16 10:16:48,A Padaria Portuguesa,-2.5,0,EUR,COMPLETED,418.39
TRANSFER,Current,2024-08-16 12:26:26,2024-08-16 12:26:26,To EUR Savings,-0.2,0,EUR,COMPLETED,418.19
TRANSFER,Current,2024-08-17 08:19:33,2024-08-17 08:19:33,To EUR Savings,-0.5,0,EUR,COMPLETED,417.69
CARD_PAYMENT,Current,2024-08-15 12:51:48,2024-08-17 09:40:37,Uber Eats,-17.2,0,EUR,COMPLETED,400.49
TRANSFER,Current,2024-08-17 12:17:19,2024-08-17 12:17:19,To EUR Savings,-0.68,0,EUR,COMPLETED,399.81
TRANSFER,Current,2024-08-17 15:42:11,2024-08-17 15:42:11,To EUR Savings,-0.87,0,EUR,COMPLETED,398.94
TRANSFER,Current,2024-08-17 21:40:57,2024-08-17 21:40:57,To EUR Savings,-0.51,0,EUR,COMPLETED,398.43
TRANSFER,Current,2024-08-18 08:19:09,2024-08-18 08:19:09,To EUR Savings,-0.5,0,EUR,COMPLETED,397.93
CARD_PAYMENT,Current,2024-08-16 12:26:26,2024-08-18 08:46:29,Uber Eats,-29.8,0,EUR,COMPLETED,368.13
CARD_PAYMENT,Current,2024-08-17 12:17:19,2024-08-18 09:10:42,Minipreço,-24.32,0,EUR,COMPLETED,343.81
CARD_PAYMENT,Current,2024-08-17 08:19:32,2024-08-18 09:11:58,A Padaria Portuguesa,-2.5,0,EUR,COMPLETED,341.31
CARD_PAYMENT,Current,2024-08-17 15:42:10,2024-08-18 09:12:07,Continente,-26.13,0,EUR,COMPLETED,315.18
TRANSFER,Current,2024-08-18 11:23:18,2024-08-18 11:23:18,To EUR Savings,-0.9,0,EUR,COMPLETED,314.28
TRANSFER,Current,2024-08-18 15:41:12,2024-08-18 15:41:12,To EUR Savings,-0.1,0,EUR,COMPLETED,314.18
CARD_PAYMENT,Current,2024-08-18 15:41:12,2024-08-19 09:17:47,Atrio,-124.9,0,EUR,COMPLETED,189.28
CARD_PAYMENT,Current,2024-08-18 08:19:09,2024-08-19 09:18:04,A Padaria Portuguesa,-2.5,0,EUR,COMPLETED,186.78
TRANSFER,Current,2024-08-19 09:47:06,2024-08-19 09:47:06,To EUR Savings,-20,0,EUR,COMPLETED,166.78
TRANSFER,Current,2024-08-19 12:51:24,2024-08-19 12:51:24,To EUR Savings,-0.65,0,EUR,COMPLETED,166.13
CARD_PAYMENT,Current,2024-08-17 21:40:57,2024-08-19 13:44:12,YouTube,-8.49,0,EUR,COMPLETED,157.64
CARD_PAYMENT,Current,2024-08-18 11:23:18,2024-08-19 14:58:13,Supermaven,-9.1,0.09,EUR,COMPLETED,148.45
TRANSFER,Current,2024-08-20 13:10:03,2024-08-20 13:10:03,To EUR Savings,-0.01,0,EUR,COMPLETED,148.44
CARD_PAYMENT,Current,2024-08-19 12:51:24,2024-08-20 15:03:04,OpenAI,-22.35,0,EUR,COMPLETED,126.09
CARD_PAYMENT,Current,2024-08-20 13:10:03,2024-08-21 10:24:35,Uber,-4.99,0,EUR,COMPLETED,121.1
TRANSFER,Current,2024-08-21 11:04:54,2024-08-21 11:04:54,To EUR Subscriptions,-100,0,EUR,COMPLETED,21.1
TOPUP,Current,2024-08-22 13:05:40,2024-08-22 13:05:42,Apple Pay Top-Up by *6964,400,0,EUR,COMPLETED,421.1
TRANSFER,Current,2024-08-22 13:06:01,2024-08-22 13:06:01,To EUR Savings,-0.2,0,EUR,COMPLETED,420.9
TRANSFER,Current,2024-08-24 08:16:06,2024-08-24 08:16:06,To EUR Savings,-0.5,0,EUR,COMPLETED,420.4
TRANSFER,Current,2024-08-24 09:08:01,2024-08-24 09:08:01,To EUR Savings,-0.42,0,EUR,COMPLETED,419.98
TRANSFER,Current,2024-08-24 09:48:23,2024-08-24 09:48:23,To EUR Savings,-0.27,0,EUR,COMPLETED,419.71
TRANSFER,Current,2024-08-24 09:57:17,2024-08-24 09:57:17,To EUR Savings,-0.41,0,EUR,COMPLETED,419.3
CARD_PAYMENT,Current,2024-08-22 13:06:01,2024-08-24 10:18:35,Uber Eats,-29.8,0,EUR,COMPLETED,389.5
TRANSFER,Current,2024-08-24 12:36:40,2024-08-24 12:36:40,To EUR Savings,-0.6,0,EUR,COMPLETED,388.9
TOPUP,Current,2024-08-24 13:57:52,2024-08-24 13:57:53,Apple Pay Top-Up by *6964,200,0,EUR,COMPLETED,588.9
TRANSFER,Current,2024-08-25 08:18:57,2024-08-25 08:18:57,To EUR Savings,-0.5,0,EUR,COMPLETED,588.4
CARD_PAYMENT,Current,2024-08-24 08:16:06,2024-08-25 09:02:24,A Padaria Portuguesa,-2.5,0,EUR,COMPLETED,585.9
CARD_PAYMENT,Current,2024-08-24 09:57:17,2024-08-25 10:08:13,Amazon,-38.59,0,EUR,COMPLETED,547.31
CARD_PAYMENT,Current,2024-08-24 09:08:01,2024-08-25 10:10:47,Pingo Doce,-39.58,0,EUR,COMPLETED,507.73
TRANSFER,Current,2024-08-25 13:58:40,2024-08-25 13:58:40,To EUR Savings,-1,0,EUR,COMPLETED,506.73
TRANSFER,Current,2024-08-25 14:06:23,2024-08-25 14:06:23,To EUR Savings,-0.4,0,EUR,COMPLETED,506.33
TRANSFER,Current,2024-08-25 14:34:58,2024-08-25 14:34:58,To EUR Savings,-1,0,EUR,COMPLETED,505.33
TRANSFER,Current,2024-08-25 15:45:19,2024-08-25 15:45:19,To EUR Savings,-1,0,EUR,COMPLETED,504.33
TRANSFER,Current,2024-08-25 23:01:32,2024-08-25 23:01:32,To EUR Savings,-0.01,0,EUR,COMPLETED,504.32
TRANSFER,Current,2024-08-26 09:51:48,2024-08-26 09:51:48,To EUR Savings,-20,0,EUR,COMPLETED,484.32
CARD_PAYMENT,Current,2024-08-24 12:36:40,2024-08-26 09:59:59,Uber Eats,-33.4,0,EUR,COMPLETED,450.92
CARD_PAYMENT,Current,2024-08-25 15:45:19,2024-08-26 10:17:50,Scut,-25,0,EUR,COMPLETED,425.92
CARD_PAYMENT,Current,2024-08-25 14:34:58,2024-08-26 10:18:51,Mercado De Alges,-5,0,EUR,COMPLETED,420.92
CARD_PAYMENT,Current,2024-08-25 14:06:22,2024-08-26 10:18:57,Mercado De Alges,-7.6,0,EUR,COMPLETED,413.32
CARD_PAYMENT,Current,2024-08-25 13:58:40,2024-08-26 10:19:00,Saisish,-27,0,EUR,COMPLETED,386.32
CARD_PAYMENT,Current,2024-08-25 08:18:57,2024-08-26 10:19:01,A Padaria Portuguesa,-2.5,0,EUR,COMPLETED,383.82
CARD_PAYMENT,Current,2024-08-24 09:48:23,2024-08-26 15:53:01,Tunecore,-15.73,0.16,EUR,COMPLETED,367.93
CARD_PAYMENT,Current,2024-08-25 23:01:32,2024-08-27 11:03:59,Pedrohierro 02,-39.99,0,EUR,COMPLETED,327.94
TRANSFER,Current,2024-08-27 12:37:47,2024-08-27 12:37:47,To EUR Savings,-0.1,0,EUR,COMPLETED,327.84
TRANSFER,Current,2024-08-27 17:11:34,2024-08-27 17:11:34,To EUR Savings,-0.11,0,EUR,COMPLETED,327.73
TOPUP,Current,2024-08-28 08:36:26,2024-08-28 08:36:28,Apple Pay Top-Up by *6964,200,0,EUR,COMPLETED,527.73
TRANSFER,Current,2024-08-28 12:15:52,2024-08-28 12:15:52,To EUR Savings,-0.01,0,EUR,COMPLETED,527.72
TRANSFER,Current,2024-08-28 17:56:54,2024-08-28 17:56:54,To EUR Savings,-0.78,0,EUR,COMPLETED,526.94
TRANSFER,Current,2024-08-28 18:51:21,2024-08-28 18:51:21,To EUR Savings,-0.01,0,EUR,COMPLETED,526.93
CARD_PAYMENT,Current,2024-08-27 12:37:47,2024-08-29 09:38:20,Uber Eats,-19.9,0,EUR,COMPLETED,507.03
CARD_PAYMENT,Current,2024-08-28 18:51:20,2024-08-29 10:12:49,Cortefiel,-14.99,0,EUR,COMPLETED,492.04
TRANSFER,Current,2024-08-29 12:49:29,2024-08-29 12:49:29,To EUR Savings,-0.2,0,EUR,COMPLETED,491.84
CARD_PAYMENT,Current,2024-08-27 17:11:34,2024-08-29 15:24:47,Waves,-53.89,0,EUR,COMPLETED,437.95
TRANSFER,Current,2024-08-29 16:50:33,2024-08-29 16:50:33,To EUR Savings,-0.39,0,EUR,COMPLETED,437.56
TRANSFER,Current,2024-08-29 18:21:13,2024-08-29 18:21:13,To EUR Savings,-0.94,0,EUR,COMPLETED,436.62
CARD_PAYMENT,Current,2024-08-28 12:15:52,2024-08-30 10:08:58,PlayStation,-8.99,0,EUR,COMPLETED,427.63
TRANSFER,Current,2024-08-30 12:44:43,2024-08-30 12:44:43,To EUR Savings,-0.4,0,EUR,COMPLETED,427.23
CARD_PAYMENT,Current,2024-08-28 17:56:54,2024-08-30 14:31:52,Mikepachell,-7.22,0,EUR,COMPLETED,420.01
CARD_PAYMENT,Current,2024-08-29 16:50:33,2024-08-30 16:02:00,Amazon,-24.61,0,EUR,COMPLETED,395.4
TRANSFER,Current,2024-08-30 16:50:18,2024-08-30 16:50:18,To EUR Savings,-0.04,0,EUR,COMPLETED,395.36
TRANSFER,Current,2024-08-31 08:21:42,2024-08-31 08:21:42,To EUR Savings,-0.5,0,EUR,COMPLETED,394.86
CARD_PAYMENT,Current,2024-08-29 12:49:29,2024-08-31 09:30:45,Uber Eats,-29.8,0,EUR,COMPLETED,365.06
TOPUP,Current,2024-08-31 11:10:30,2024-08-31 11:10:32,Apple Pay Top-Up by *6964,200,0,EUR,COMPLETED,565.06
CARD_PAYMENT,Current,2024-08-29 18:21:12,2024-08-31 12:35:18,Ip Developm,-12.06,0,EUR,COMPLETED,553
TRANSFER,Current,2024-09-01 08:15:30,2024-09-01 08:15:30,To EUR Savings,-0.5,0,EUR,COMPLETED,552.5
TRANSFER,Current,2024-09-01 08:28:08,2024-09-01 08:28:08,To EUR Rainy day,-50,0,EUR,COMPLETED,502.5
CARD_PAYMENT,Current,2024-08-30 12:44:43,2024-09-01 09:08:46,Uber Eats,-12.6,0,EUR,COMPLETED,489.9
CARD_PAYMENT,Current,2024-08-30 16:50:18,2024-09-01 09:14:41,Benetton,-49.96,0,EUR,COMPLETED,439.94
TRANSFER,Current,2024-09-01 09:30:48,2024-09-01 09:30:48,To EUR Savings,-0.92,0,EUR,COMPLETED,439.02
CARD_PAYMENT,Current,2024-08-31 08:21:42,2024-09-01 10:07:50,A Padaria Portuguesa,-2.5,0,EUR,COMPLETED,436.52
TRANSFER,Current,2024-09-01 16:50:47,2024-09-01 16:50:47,To EUR Savings,-0.9,0,EUR,COMPLETED,435.62
TRANSFER,Current,2024-09-01 20:16:13,2024-09-01 20:16:13,To EUR Savings,-0.9,0,EUR,COMPLETED,434.72
TRANSFER,Current,2024-09-02 08:28:56,2024-09-02 08:28:56,To EUR Savings,-0.86,0,EUR,COMPLETED,433.86
TRANSFER,Current,2024-09-02 09:53:54,2024-09-02 09:53:54,To EUR Savings,-20,0,EUR,COMPLETED,413.86
CARD_PAYMENT,Current,2024-09-01 08:15:29,2024-09-02 09:58:05,A Padaria Portuguesa,-2.5,0,EUR,COMPLETED,411.36
CARD_PAYMENT,Current,2024-09-01 16:50:47,2024-09-02 10:24:28,Santini,-14.1,0,EUR,COMPLETED,397.26
CARD_PAYMENT,Current,2024-09-01 09:30:48,2024-09-02 10:27:45,Pingo Doce,-22.08,0,EUR,COMPLETED,375.18
TRANSFER,Current,2024-09-03 08:43:48,2024-09-03 08:43:48,To EUR Savings,-0.1,0,EUR,COMPLETED,375.08
TRANSFER,Current,2024-09-03 08:45:07,2024-09-03 08:45:07,To EUR Savings,-0.77,0,EUR,COMPLETED,374.31
CARD_PAYMENT,Current,2024-09-02 08:28:56,2024-09-03 10:52:24,Amazon,-9.14,0,EUR,COMPLETED,365.17
CARD_PAYMENT,Current,2024-09-01 20:16:13,2024-09-03 11:32:46,Cinemas NOS,-17.1,0,EUR,COMPLETED,348.07
CARD_PAYMENT,Current,2024-09-03 08:45:07,2024-09-04 09:22:23,Amazon,-17.23,0,EUR,COMPLETED,330.84
TRANSFER,Current,2024-09-05 13:01:22,2024-09-05 13:01:22,To EUR Savings,-0.3,0,EUR,COMPLETED,330.54
TOPUP,Current,2024-09-05 21:47:16,2024-09-05 21:47:17,Apple Pay Top-Up by *6964,200,0,EUR,COMPLETED,530.54
CARD_PAYMENT,Current,2024-09-03 08:43:48,2024-09-06 10:39:11,El Corte Inglés,-26.9,0,EUR,COMPLETED,503.64
TRANSFER,Current,2024-09-07 07:45:54,2024-09-07 07:45:54,To EUR Savings,-0.5,0,EUR,COMPLETED,503.14
CARD_PAYMENT,Current,2024-09-05 13:01:22,2024-09-07 09:48:03,Uber Eats,-39.7,0,EUR,COMPLETED,463.44
TRANSFER,Current,2024-09-07 11:58:24,2024-09-07 11:58:24,To EUR Savings,-0.5,0,EUR,COMPLETED,462.94
TRANSFER,Current,2024-09-07 20:50:08,2024-09-07 20:50:08,To EUR Savings,-0.1,0,EUR,COMPLETED,462.84
TRANSFER,Current,2024-09-08 09:26:33,2024-09-08 09:26:33,To EUR Savings,-1,0,EUR,COMPLETED,461.84
CARD_PAYMENT,Current,2024-09-07 07:45:53,2024-09-08 10:41:12,A Padaria Portuguesa,-2.5,0,EUR,COMPLETED,459.34
CARD_PAYMENT,Current,2024-09-07 11:58:23,2024-09-08 10:41:31,Brisa,-10.5,0,EUR,COMPLETED,448.84
TRANSFER,Current,2024-09-09 04:19:52,2024-09-09 04:19:52,To EUR Savings,-1,0,EUR,COMPLETED,447.84
CARD_PAYMENT,Current,2024-09-09 04:19:51,2024-09-09 09:03:46,Miió,-30,0,EUR,COMPLETED,417.84
TRANSFER,Current,2024-09-09 09:34:14,2024-09-09 09:34:14,To EUR Savings,-0.8,0,EUR,COMPLETED,417.04
TRANSFER,Current,2024-09-09 09:47:19,2024-09-09 09:47:19,To EUR Savings,-20,0,EUR,COMPLETED,397.04
CARD_PAYMENT,Current,2024-09-07 20:50:08,2024-09-09 11:00:17,Alvaros,-28.9,0,EUR,COMPLETED,368.14
CARD_PAYMENT,Current,2024-09-08 09:26:33,2024-09-09 11:06:54,Oleigois,-14,0,EUR,COMPLETED,354.14
TRANSFER,Current,2024-09-09 14:59:11,2024-09-09 14:59:11,To EUR Savings,-1,0,EUR,COMPLETED,353.14
CARD_PAYMENT,Current,2024-09-09 09:34:14,2024-09-10 10:58:01,C C Pombalinho,-16.2,0,EUR,COMPLETED,336.94
CARD_PAYMENT,Current,2024-09-09 14:59:11,2024-09-10 11:03:24,Casa Ti Maria,-73,0,EUR,COMPLETED,263.94
TOPUP,Current,2024-09-10 12:01:43,2024-09-10 12:01:44,Apple Pay Top-Up by *6964,200,0,EUR,COMPLETED,463.94
TRANSFER,Current,2024-09-10 12:08:59,2024-09-10 12:08:59,To EUR Savings,-0.86,0,EUR,COMPLETED,463.08
TRANSFER,Current,2024-09-10 12:32:25,2024-09-10 12:32:25,To EUR Savings,-0.9,0,EUR,COMPLETED,462.18
TRANSFER,Current,2024-09-10 20:29:43,2024-09-10 20:29:43,To EUR Savings,-0.6,0,EUR,COMPLETED,461.58
CARD_PAYMENT,Current,2024-09-10 12:08:59,2024-09-11 09:14:23,Amazon,-9.14,0,EUR,COMPLETED,452.44
TRANSFER,Current,2024-09-11 20:17:44,2024-09-11 20:17:44,To EUR Savings,-0.59,0,EUR,COMPLETED,451.85
TRANSFER,Current,2024-09-12 08:29:32,2024-09-12 08:29:32,To EUR Savings,-0.42,0,EUR,COMPLETED,451.43
TOPUP,Current,2024-09-12 08:30:02,2024-09-12 08:30:04,Apple Pay Top-Up by *6964,200,0,EUR,COMPLETED,651.43
TRANSFER,Current,2024-09-12 08:36:20,2024-09-12 08:36:20,To EUR Savings,-0.55,0,EUR,COMPLETED,650.88
CARD_PAYMENT,Current,2024-09-10 12:32:24,2024-09-12 08:41:15,Uber Eats,-16.1,0,EUR,COMPLETED,634.78
CARD_PAYMENT,Current,2024-09-10 20:29:42,2024-09-12 09:11:15,Opíparo,-115.4,0,EUR,COMPLETED,519.38
TRANSFER,Current,2024-09-12 12:46:40,2024-09-12 12:46:40,To EUR Savings,-0.3,0,EUR,COMPLETED,519.08
CARD_PAYMENT,Current,2024-09-12 08:29:31,2024-09-13 08:57:56,Ticketline,-66.58,0,EUR,COMPLETED,452.5
CARD_PAYMENT,Current,2024-09-11 20:17:44,2024-09-13 09:16:17,Minipreço,-13.41,0,EUR,COMPLETED,439.09
CARD_PAYMENT,Current,2024-09-12 08:36:20,2024-09-13 09:38:06,Amazon,-6.45,0,EUR,COMPLETED,432.64
TRANSFER,Current,2024-09-14 08:15:27,2024-09-14 08:15:27,To EUR Savings,-0.5,0,EUR,COMPLETED,432.14
TRANSFER,Current,2024-09-14 09:25:10,2024-09-14 09:25:10,To EUR Savings,-0.01,0,EUR,COMPLETED,432.13
CARD_PAYMENT,Current,2024-09-12 12:46:40,2024-09-14 10:13:44,Uber Eats,-39.7,0,EUR,COMPLETED,392.43
TRANSFER,Current,2024-09-15 08:26:47,2024-09-15 08:26:47,To EUR Savings,-0.5,0,EUR,COMPLETED,391.93
CARD_PAYMENT,Current,2024-09-14 08:15:27,2024-09-15 09:35:49,A Padaria Portuguesa,-2.5,0,EUR,COMPLETED,389.43
CARD_PAYMENT,Current,2024-09-14 09:25:10,2024-09-15 11:26:37,Pingo Doce,-51.99,0,EUR,COMPLETED,337.44
TRANSFER,Current,2024-09-15 14:13:54,2024-09-15 14:13:54,To EUR Savings,-0.5,0,EUR,COMPLETED,336.94
CARD_PAYMENT,Current,2024-09-15 08:26:47,2024-09-16 09:33:42,A Padaria Portuguesa,-2.5,0,EUR,COMPLETED,334.44
TRANSFER,Current,2024-09-16 09:48:18,2024-09-16 09:48:18,To EUR Savings,-20,0,EUR,COMPLETED,314.44
CARD_PAYMENT,Current,2024-09-15 14:13:53,2024-09-17 09:17:32,Uber Eats,-13.5,0,EUR,COMPLETED,300.94
TRANSFER,Current,2024-09-17 21:40:58,2024-09-17 21:40:58,To EUR Savings,-0.51,0,EUR,COMPLETED,300.43
TRANSFER,Current,2024-09-18 11:16:58,2024-09-18 11:16:58,To EUR Savings,-0.99,0,EUR,COMPLETED,299.44
TRANSFER,Current,2024-09-19 09:04:29,2024-09-19 09:04:29,To EUR,435.12,0,EUR,COMPLETED,734.56
CARD_PAYMENT,Current,2024-09-17 21:40:57,2024-09-19 12:44:05,YouTube,-8.49,0,EUR,COMPLETED,726.07
TRANSFER,Current,2024-09-19 12:48:05,2024-09-19 12:48:05,To EUR Savings,-0.87,0,EUR,COMPLETED,725.2
TRANSFER,Current,2024-09-19 13:05:26,2024-09-19 13:05:26,To EUR Savings,-0.8,0,EUR,COMPLETED,724.4
CARD_PAYMENT,Current,2024-09-18 11:16:58,2024-09-19 14:56:41,Supermaven,-9.01,0,EUR,COMPLETED,715.39
CARD_REFUND,Current,2024-09-19 08:35:15,2024-09-20 10:38:06,Benetton,24.98,0,EUR,COMPLETED,740.37
TRANSFER,Current,2024-09-20 13:07:34,2024-09-20 13:07:34,To EUR Savings,-0.1,0,EUR,COMPLETED,740.27
TRANSFER,Current,2024-09-20 13:10:03,2024-09-20 13:10:03,To EUR Savings,-0.01,0,EUR,COMPLETED,740.26
CARD_PAYMENT,Current,2024-09-19 12:48:05,2024-09-20 14:54:00,OpenAI,-22.13,0,EUR,COMPLETED,718.13
TRANSFER,Current,2024-09-20 21:01:04,2024-09-20 21:01:04,To EUR Savings,-0.01,0,EUR,COMPLETED,718.12
TRANSFER,Current,2024-09-21 08:16:23,2024-09-21 08:16:23,To EUR Savings,-0.5,0,EUR,COMPLETED,717.62
CARD_PAYMENT,Current,2024-09-19 13:05:26,2024-09-21 09:12:51,Uber Eats,-17.2,0,EUR,COMPLETED,700.42
CARD_PAYMENT,Current,2024-09-20 13:10:03,2024-09-21 09:18:18,Uber,-4.99,0,EUR,COMPLETED,695.43
TRANSFER,Current,2024-09-21 20:29:33,2024-09-21 20:29:33,To EUR Savings,-0.5,0,EUR,COMPLETED,694.93
TRANSFER,Current,2024-09-22 08:09:01,2024-09-22 08:09:01,To EUR Savings,-0.5,0,EUR,COMPLETED,694.43
TRANSFER,Current,2024-09-22 08:38:38,2024-09-22 08:38:38,To EUR Savings,-0.41,0,EUR,COMPLETED,694.02
CARD_PAYMENT,Current,2024-09-20 13:07:34,2024-09-22 10:19:36,Uber Eats,-19.9,0,EUR,COMPLETED,674.12
CARD_PAYMENT,Current,2024-09-21 08:16:23,2024-09-22 11:04:14,A Padaria Portuguesa,-2.5,0,EUR,COMPLETED,671.62
TRANSFER,Current,2024-09-22 12:43:47,2024-09-22 12:43:47,To EUR Savings,-0.8,0,EUR,COMPLETED,670.82
TRANSFER,Current,2024-09-23 08:18:00,2024-09-23 08:18:00,To EUR Savings,-0.96,0,EUR,COMPLETED,669.86
CARD_PAYMENT,Current,2024-09-20 21:01:03,2024-09-23 09:13:25,Apple,-8.99,0,EUR,COMPLETED,660.87
CARD_PAYMENT,Current,2024-09-22 08:09:01,2024-09-23 09:36:11,A Padaria Portuguesa,-2.5,0,EUR,COMPLETED,658.37
TRANSFER,Current,2024-09-23 09:55:10,2024-09-23 09:55:10,To EUR Savings,-20,0,EUR,COMPLETED,638.37
CARD_PAYMENT,Current,2024-09-21 20:29:32,2024-09-23 10:14:33,Siesta Campers Campervan Rental,-88.5,0,EUR,COMPLETED,549.87
CARD_PAYMENT,Current,2024-09-22 08:38:38,2024-09-23 10:14:37,Pingo Doce,-17.59,0,EUR,COMPLETED,532.28
CARD_PAYMENT,Current,2024-09-22 12:43:46,2024-09-24 10:08:17,Uber Eats,-25.2,0,EUR,COMPLETED,507.08
CARD_PAYMENT,Current,2024-09-23 08:18:00,2024-09-25 13:27:25,YouTube,-6.04,0,EUR,COMPLETED,501.04
TRANSFER,Current,2024-09-26 09:28:20,2024-09-26 09:28:20,To EUR Savings,-0.99,0,EUR,COMPLETED,500.05
TRANSFER,Current,2024-09-26 13:05:37,2024-09-26 13:05:37,To EUR Savings,-0.2,0,EUR,COMPLETED,499.85
TRANSFER,Current,2024-09-27 13:48:38,2024-09-27 13:48:38,To EUR Savings,-0.25,0,EUR,COMPLETED,499.6
CARD_PAYMENT,Current,2024-09-26 09:28:20,2024-09-27 15:18:07,GitHub,-3.01,0,EUR,COMPLETED,496.59
TRANSFER,Current,2024-09-28 08:19:20,2024-09-28 08:19:20,To EUR Savings,-0.5,0,EUR,COMPLETED,496.09
CARD_PAYMENT,Current,2024-09-27 13:48:38,2024-09-28 10:29:41,Dote,-44.75,0,EUR,COMPLETED,451.34
TRANSFER,Current,2024-09-28 10:41:03,2024-09-28 10:41:03,To EUR Savings,-0.02,0,EUR,COMPLETED,451.32
CARD_PAYMENT,Current,2024-09-26 13:05:37,2024-09-28 11:43:39,Uber Eats,-29.8,0,EUR,COMPLETED,421.52
TRANSFER,Current,2024-09-28 12:15:48,2024-09-28 12:15:48,To EUR Savings,-0.01,0,EUR,COMPLETED,421.51
TRANSFER,Current,2024-09-28 12:31:28,2024-09-28 12:31:29,Revolut Bank UAB,-30,0,EUR,COMPLETED,391.51
TRANSFER,Current,2024-09-28 20:47:47,2024-09-28 20:47:47,To EUR Savings,-0.15,0,EUR,COMPLETED,391.36
TRANSFER,Current,2024-09-29 05:53:02,2024-09-29 05:53:02,To EUR Savings,-0.51,0,EUR,COMPLETED,390.85
TRANSFER,Current,2024-09-29 08:35:42,2024-09-29 08:35:42,To EUR Savings,-0.5,0,EUR,COMPLETED,390.35
TRANSFER,Current,2024-09-29 09:43:27,2024-09-29 09:43:27,To EUR Savings,-0.27,0,EUR,COMPLETED,390.08
CARD_PAYMENT,Current,2024-09-28 08:19:19,2024-09-29 11:51:02,A Padaria Portuguesa,-2.5,0,EUR,COMPLETED,387.58
TRANSFER,Current,2024-09-29 13:08:35,2024-09-29 13:08:35,To EUR Savings,-0.41,0,EUR,COMPLETED,387.17
TRANSFER,Current,2024-09-30 02:53:46,2024-09-30 02:53:46,To EUR Savings,-0.05,0,EUR,COMPLETED,387.12
TRANSFER,Current,2024-09-30 03:58:44,2024-09-30 03:58:44,To EUR Savings,-20,0,EUR,COMPLETED,367.12
CARD_PAYMENT,Current,2024-09-28 12:15:48,2024-09-30 09:23:58,PlayStation,-8.99,0,EUR,COMPLETED,358.13
CARD_PAYMENT,Current,2024-09-29 08:35:42,2024-09-30 09:50:41,A Padaria Portuguesa,-2.5,0,EUR,COMPLETED,355.63
CARD_PAYMENT,Current,2024-09-28 20:47:46,2024-09-30 10:13:52,Fio De Azeite,-74.85,0,EUR,COMPLETED,280.78
CARD_PAYMENT,Current,2024-09-29 09:43:27,2024-09-30 10:14:08,Pingo Doce,-15.73,0,EUR,COMPLETED,265.05
TRANSFER,Current,2024-10-01 02:25:25,2024-10-01 02:25:25,To EUR Rainy day,-50,0,EUR,COMPLETED,215.05
CARD_PAYMENT,Current,2024-09-28 10:41:03,2024-10-01 09:32:28,Calzedonia,-15.98,0,EUR,COMPLETED,199.07
CARD_PAYMENT,Current,2024-09-29 13:08:35,2024-10-01 10:19:15,Uber Eats,-34.59,0,EUR,COMPLETED,164.48
TRANSFER,Current,2024-10-01 12:52:07,2024-10-01 12:52:07,To EUR Savings,-0.29,0,EUR,COMPLETED,164.19
CARD_PAYMENT,Current,2024-09-30 02:53:46,2024-10-02 09:15:17,Apple,-21.95,0,EUR,COMPLETED,142.24
CARD_PAYMENT,Current,2024-09-29 05:53:02,2024-10-02 09:34:47,Apple,-5.49,0,EUR,COMPLETED,136.75
CARD_PAYMENT,Current,2024-10-01 12:47:13,2024-10-03 09:48:01,Uber Eats,-17.71,0,EUR,COMPLETED,119.04
TRANSFER,Current,2024-10-03 12:20:54,2024-10-03 12:20:54,To EUR Savings,-0.23,0,EUR,COMPLETED,118.81
TRANSFER,Current,2024-10-03 15:28:37,2024-10-03 15:28:37,To EUR Savings,-0.03,0,EUR,COMPLETED,118.78
TOPUP,Current,2024-10-04 16:58:15,2024-10-04 16:58:17,Apple Pay Top-Up by *6964,400,0,EUR,COMPLETED,518.78
TRANSFER,Current,2024-10-04 16:58:33,2024-10-04 16:58:33,To EUR Savings,-0.45,0,EUR,COMPLETED,518.33
TRANSFER,Current,2024-10-04 21:43:43,2024-10-04 21:43:43,To EUR Savings,-0.6,0,EUR,COMPLETED,517.73
TRANSFER,Current,2024-10-05 00:03:02,2024-10-05 00:03:02,To EUR Savings,-0.4,0,EUR,COMPLETED,517.33
TRANSFER,Current,2024-10-05 08:16:52,2024-10-05 08:16:52,To EUR Savings,-0.5,0,EUR,COMPLETED,516.83
CARD_PAYMENT,Current,2024-10-03 12:20:53,2024-10-05 09:23:12,Uber Eats,-30.77,0,EUR,COMPLETED,486.06
CARD_PAYMENT,Current,2024-10-03 15:28:26,2024-10-05 09:44:20,Fiverr,-32.97,0,EUR,COMPLETED,453.09
TRANSFER,Current,2024-10-05 12:32:11,2024-10-05 12:32:11,To EUR Savings,-0.35,0,EUR,COMPLETED,452.74
TRANSFER,Current,2024-10-05 18:46:45,2024-10-05 18:46:45,To EUR Savings,-0.48,0,EUR,COMPLETED,452.26
TRANSFER,Current,2024-10-06 08:18:49,2024-10-06 08:18:49,To EUR Savings,-0.5,0,EUR,COMPLETED,451.76
TRANSFER,Current,2024-10-06 09:06:37,2024-10-06 09:06:37,To EUR Savings,-0.93,0,EUR,COMPLETED,450.83
CARD_PAYMENT,Current,2024-10-05 00:03:01,2024-10-06 09:27:31,Pq D Casino Estoril,-3.6,0,EUR,COMPLETED,447.23
CARD_PAYMENT,Current,2024-10-05 08:16:52,2024-10-06 09:32:59,A Padaria Portuguesa,-2.5,0,EUR,COMPLETED,444.73
CARD_PAYMENT,Current,2024-10-04 16:58:32,2024-10-06 10:29:59,Fiverr,-125.55,0,EUR,COMPLETED,319.18
CARD_PAYMENT,Current,2024-10-05 18:46:45,2024-10-06 11:33:18,Pingo Doce,-63.52,0,EUR,COMPLETED,255.66
CARD_PAYMENT,Current,2024-10-04 21:43:43,2024-10-06 11:34:16,Lounged Casino Est,-9.4,0,EUR,COMPLETED,246.26
TRANSFER,Current,2024-10-06 17:49:27,2024-10-06 17:49:27,To EUR Savings,-0.85,0,EUR,COMPLETED,245.41
TRANSFER,Current,2024-10-07 07:20:42,2024-10-07 07:20:42,To EUR Savings,-20,0,EUR,COMPLETED,225.41
CARD_PAYMENT,Current,2024-10-05 12:32:09,2024-10-07 10:52:56,Uber Eats,-15.65,0,EUR,COMPLETED,209.76
CARD_PAYMENT,Current,2024-10-06 08:18:49,2024-10-07 11:06:13,A Padaria Portuguesa,-2.5,0,EUR,COMPLETED,207.26
CARD_PAYMENT,Current,2024-10-06 09:06:37,2024-10-07 11:29:01,Pingo Doce,-34.07,0,EUR,COMPLETED,173.19
CARD_PAYMENT,Current,2024-10-06 17:49:27,2024-10-07 13:40:58,GitHub,-9.15,0.09,EUR,COMPLETED,163.95
TOPUP,Current,2024-10-08 12:50:29,2024-10-08 12:50:30,Apple Pay Top-Up by *6964,200,0,EUR,COMPLETED,363.95
TRANSFER,Current,2024-10-08 21:05:36,2024-10-08 21:05:36,To EUR Savings,-0.63,0,EUR,COMPLETED,363.32
CARD_PAYMENT,Current,2024-10-08 21:05:36,2024-10-10 11:42:34,Mezze,-114.37,0,EUR,COMPLETED,248.95
TRANSFER,Current,2024-10-10 12:38:04,2024-10-10 12:38:04,To EUR Savings,-0.23,0,EUR,COMPLETED,248.72
TRANSFER,Current,2024-10-10 18:12:36,2024-10-10 18:12:36,To EUR Savings,-0.03,0,EUR,COMPLETED,248.69
TRANSFER,Current,2024-10-11 09:20:36,2024-10-11 09:20:36,To EUR Savings,-1,0,EUR,COMPLETED,247.69
CARD_PAYMENT,Current,2024-10-10 18:12:36,2024-10-11 09:25:06,Minipreço,-8.97,0,EUR,COMPLETED,238.72
TRANSFER,Current,2024-10-11 09:29:23,2024-10-11 09:29:23,To EUR Savings,-0.6,0,EUR,COMPLETED,238.12
TRANSFER,Current,2024-10-12 08:28:53,2024-10-12 08:28:53,To EUR Savings,-0.5,0,EUR,COMPLETED,237.62
CARD_PAYMENT,Current,2024-10-11 09:20:36,2024-10-12 09:22:16,Clinica Medis Alges,-10,0,EUR,COMPLETED,227.62
CARD_PAYMENT,Current,2024-10-11 09:29:22,2024-10-12 09:22:18,Rest Boltica Do Cafe,-2.4,0,EUR,COMPLETED,225.22
CARD_PAYMENT,Current,2024-10-10 12:38:04,2024-10-12 10:29:47,Uber Eats,-30.77,0,EUR,COMPLETED,194.45
TOPUP,Current,2024-10-12 11:32:31,2024-10-12 11:32:32,Apple Pay Top-Up by *6964,200,0,EUR,COMPLETED,394.45
EXCHANGE,Current,2024-10-12 11:35:01,2024-10-12 11:35:01,Exchange to EUR,2.48,0.02,EUR,COMPLETED,396.91
TRANSFER,Current,2024-10-12 12:37:25,2024-10-12 12:37:25,To EUR Savings,-0.13,0,EUR,COMPLETED,396.78
TRANSFER,Current,2024-10-13 08:18:11,2024-10-13 08:18:11,To EUR Savings,-0.5,0,EUR,COMPLETED,396.28
TRANSFER,Current,2024-10-13 09:22:54,2024-10-13 09:22:54,To EUR Savings,-0.96,0,EUR,COMPLETED,395.32
TRANSFER,Current,2024-10-13 09:27:25,2024-10-13 09:27:25,To EUR Savings,-0.11,0,EUR,COMPLETED,395.21
CARD_PAYMENT,Current,2024-10-12 08:28:53,2024-10-13 09:57:59,A Padaria Portuguesa,-2.5,0,EUR,COMPLETED,392.71
TRANSFER,Current,2024-10-13 12:33:51,2024-10-13 12:33:51,To EUR Savings,-0.93,0,EUR,COMPLETED,391.78
TRANSFER,Current,2024-10-13 16:33:12,2024-10-13 16:33:12,To EUR Savings,-0.1,0,EUR,COMPLETED,391.68
CARD_PAYMENT,Current,2024-10-13 12:33:51,2024-10-14 10:17:14,Minipreço,-6.07,0,EUR,COMPLETED,385.61
CARD_PAYMENT,Current,2024-10-13 08:18:11,2024-10-14 10:25:29,A Padaria Portuguesa,-2.5,0,EUR,COMPLETED,383.11
TRANSFER,Current,2024-10-14 11:30:36,2024-10-14 11:30:36,To EUR Savings,-20,0,EUR,COMPLETED,363.11
CARD_PAYMENT,Current,2024-10-13 16:33:12,2024-10-14 11:30:40,Pastelaria Garrett,-11.9,0,EUR,COMPLETED,351.21
CARD_PAYMENT,Current,2024-10-13 09:27:25,2024-10-14 11:31:45,Pingo Doce,-0.89,0,EUR,COMPLETED,350.32
CARD_PAYMENT,Current,2024-10-13 09:22:53,2024-10-14 11:31:48,Pingo Doce,-45.04,0,EUR,COMPLETED,305.28
CARD_PAYMENT,Current,2024-10-12 12:37:17,2024-10-15 09:57:52,Uber Eats,-39.87,0,EUR,COMPLETED,265.41
TOPUP,Current,2024-10-15 16:40:16,2024-10-15 16:40:17,Apple Pay Top-Up by *6964,200,0,EUR,COMPLETED,465.41
TRANSFER,Current,2024-10-15 16:48:22,2024-10-15 16:48:22,To EUR Savings,-0.5,0,EUR,COMPLETED,464.91
CARD_PAYMENT,Current,2024-10-15 16:48:22,2024-10-16 09:43:40,Qwertee,-38.5,0,EUR,COMPLETED,426.41
TRANSFER,Current,2024-10-17 08:15:21,2024-10-17 08:15:21,To EUR Savings,-0.12,0,EUR,COMPLETED,426.29
TRANSFER,Current,2024-10-17 12:52:00,2024-10-17 12:52:00,To EUR Savings,-0.23,0,EUR,COMPLETED,426.06
CARD_PAYMENT,Current,2024-10-17 08:15:21,2024-10-18 09:22:44,Minipreço,-5.88,0,EUR,COMPLETED,420.18
TRANSFER,Current,2024-10-18 11:16:00,2024-10-18 11:16:00,To EUR Savings,-0.74,0,EUR,COMPLETED,419.44
TRANSFER,Current,2024-10-18 12:46:58,2024-10-18 12:46:58,To EUR Savings,-0.29,0,EUR,COMPLETED,419.15
TRANSFER,Current,2024-10-18 17:44:55,2024-10-18 17:44:55,To EUR Savings,-1,0,EUR,COMPLETED,418.15
TRANSFER,Current,2024-10-18 20:00:43,2024-10-18 20:00:43,To EUR Savings,-0.49,0,EUR,COMPLETED,417.66
TRANSFER,Current,2024-10-18 21:34:42,2024-10-18 21:34:42,To EUR Savings,-0.02,0,EUR,COMPLETED,417.64
TRANSFER,Current,2024-10-19 08:34:16,2024-10-19 08:34:16,To EUR Savings,-0.5,0,EUR,COMPLETED,417.14
TRANSFER,Current,2024-10-19 09:44:42,2024-10-19 09:44:42,To EUR Savings,-0.66,0,EUR,COMPLETED,416.48
CARD_PAYMENT,Current,2024-10-17 12:52:00,2024-10-19 09:46:36,Uber Eats,-30.77,0,EUR,COMPLETED,385.71
TRANSFER,Current,2024-10-19 12:46:03,2024-10-19 12:46:03,To EUR Savings,-0.29,0,EUR,COMPLETED,385.42
TRANSFER,Current,2024-10-19 12:59:02,2024-10-19 12:59:02,To EUR Savings,-0.44,0,EUR,COMPLETED,384.98
CARD_PAYMENT,Current,2024-10-18 11:16:00,2024-10-19 14:55:20,Supermaven,-9.26,0,EUR,COMPLETED,375.72
TRANSFER,Current,2024-10-19 20:07:21,2024-10-19 20:07:21,To EUR Savings,-0.68,0,EUR,COMPLETED,375.04
TRANSFER,Current,2024-10-19 20:20:20,2024-10-19 20:20:20,To EUR Savings,-0.54,0,EUR,COMPLETED,374.5
TRANSFER,Current,2024-10-20 08:16:36,2024-10-20 08:16:36,To EUR Savings,-0.5,0,EUR,COMPLETED,374
CARD_PAYMENT,Current,2024-10-19 09:44:41,2024-10-20 08:30:27,Pingo Doce,-25.34,0,EUR,COMPLETED,348.66
CARD_PAYMENT,Current,2024-10-18 17:44:55,2024-10-20 09:22:56,Clinica Medis Alges,-30,0,EUR,COMPLETED,318.66
CARD_PAYMENT,Current,2024-10-18 21:34:41,2024-10-20 09:31:53,Uber Eats,-2.98,0,EUR,COMPLETED,315.68
CARD_PAYMENT,Current,2024-10-18 12:46:57,2024-10-20 09:48:16,Uber Eats,-17.71,0,EUR,COMPLETED,297.97
CARD_PAYMENT,Current,2024-10-18 20:00:43,2024-10-20 09:49:19,Uber Eats,-28.51,0,EUR,COMPLETED,269.46
CARD_PAYMENT,Current,2024-10-19 08:34:15,2024-10-20 10:35:14,A Padaria Portuguesa,-2.5,0,EUR,COMPLETED,266.96
TRANSFER,Current,2024-10-20 12:25:47,2024-10-20 12:25:47,To EUR Savings,-0.1,0,EUR,COMPLETED,266.86
TRANSFER,Current,2024-10-20 12:45:21,2024-10-20 12:45:21,To EUR Savings,-0.77,0,EUR,COMPLETED,266.09
TRANSFER,Current,2024-10-20 13:10:03,2024-10-20 13:10:03,To EUR Savings,-0.01,0,EUR,COMPLETED,266.08
TRANSFER,Current,2024-10-20 13:10:35,2024-10-20 13:10:35,To EUR Savings,-0.22,0,EUR,COMPLETED,265.86
CARD_PAYMENT,Current,2024-10-19 12:46:03,2024-10-20 14:05:57,OpenAI,-22.71,0.23,EUR,COMPLETED,242.92
TRANSFER,Current,2024-10-21 07:16:07,2024-10-21 07:16:07,To EUR Savings,-20,0,EUR,COMPLETED,222.92
CARD_PAYMENT,Current,2024-10-19 20:07:21,2024-10-21 10:10:43,Uber Eats,-27.32,0,EUR,COMPLETED,195.6
CARD_PAYMENT,Current,2024-10-19 12:59:02,2024-10-21 10:19:55,Uber Eats,-11.56,0,EUR,COMPLETED,184.04
CARD_PAYMENT,Current,2024-10-20 13:10:02,2024-10-21 10:20:53,Uber,-4.99,0,EUR,COMPLETED,179.05
CARD_PAYMENT,Current,2024-10-19 20:20:20,2024-10-21 10:36:09,Minipreço,-8.46,0,EUR,COMPLETED,170.59
CARD_PAYMENT,Current,2024-10-20 08:16:35,2024-10-21 10:41:44,A Padaria Portuguesa,-2.5,0,EUR,COMPLETED,168.09
CARD_PAYMENT,Current,2024-10-20 12:25:47,2024-10-21 10:49:57,Jld Alfragide Lj 036,-18.9,0,EUR,COMPLETED,149.19
CARD_PAYMENT,Current,2024-10-20 12:45:20,2024-10-21 10:49:59,Cortefiel,-72.23,0,EUR,COMPLETED,76.96
TRANSFER,Current,2024-10-21 12:45:35,2024-10-21 12:45:35,To EUR Savings,-0.1,0,EUR,COMPLETED,76.86
TOPUP,Current,2024-10-21 12:50:10,2024-10-21 12:50:11,Apple Pay Top-Up by *6964,400,0,EUR,COMPLETED,476.86
CARD_PAYMENT,Current,2024-10-20 13:10:35,2024-10-22 10:16:51,Uber Eats,-34.78,0,EUR,COMPLETED,442.08
TRANSFER,Current,2024-10-23 07:30:26,2024-10-23 07:30:26,To EUR Savings,-0.18,0,EUR,COMPLETED,441.9
TRANSFER,Current,2024-10-23 08:03:28,2024-10-23 08:03:28,To EUR Savings,-0.5,0,EUR,COMPLETED,441.4
TRANSFER,Current,2024-10-23 08:12:25,2024-10-23 08:12:25,To EUR Savings,-0.01,0,EUR,COMPLETED,441.39
TRANSFER,Current,2024-10-23 08:41:57,2024-10-23 08:41:57,To EUR Savings,-0.7,0,EUR,COMPLETED,440.69
CARD_PAYMENT,Current,2024-10-21 12:45:34,2024-10-23 11:08:58,Uber Eats,-13.9,0,EUR,COMPLETED,426.79
CARD_PAYMENT,Current,2024-10-23 08:03:28,2024-10-24 09:34:31,Restauradores Square,-4.5,0,EUR,COMPLETED,422.29
CARD_PAYMENT,Current,2024-10-23 08:41:57,2024-10-24 09:34:35,Restauradores Square,-1.3,0,EUR,COMPLETED,420.99
CARD_PAYMENT,Current,2024-10-23 07:30:25,2024-10-24 10:43:07,Uber,-12.82,0,EUR,COMPLETED,408.17
TRANSFER,Current,2024-10-24 13:03:58,2024-10-24 13:03:58,To EUR Savings,-0.23,0,EUR,COMPLETED,407.94
TRANSFER,Current,2024-10-24 13:23:17,2024-10-24 13:23:17,To EUR Savings,-0.01,0,EUR,COMPLETED,407.93
CARD_PAYMENT,Current,2024-10-23 08:12:25,2024-10-24 13:41:17,YouTube,-12.99,0,EUR,COMPLETED,394.94
TRANSFER,Current,2024-10-26 08:15:16,2024-10-26 08:15:16,To EUR Savings,-0.5,0,EUR,COMPLETED,394.44
CARD_PAYMENT,Current,2024-10-24 13:23:17,2024-10-26 09:07:32,Google,-2.99,0,EUR,COMPLETED,391.45
CARD_PAYMENT,Current,2024-10-24 13:03:58,2024-10-26 09:36:08,Uber Eats,-30.17,0,EUR,COMPLETED,361.28
TRANSFER,Current,2024-10-27 08:33:26,2024-10-27 08:33:26,To EUR Savings,-0.5,0,EUR,COMPLETED,360.78
TRANSFER,Current,2024-10-27 09:34:27,2024-10-27 09:34:27,To EUR Savings,-0.36,0,EUR,COMPLETED,360.42
CARD_PAYMENT,Current,2024-10-26 08:15:16,2024-10-27 10:08:34,A Padaria Portuguesa,-2.5,0,EUR,COMPLETED,357.92
TRANSFER,Current,2024-10-27 12:37:35,2024-10-27 12:37:35,To EUR Savings,-0.5,0,EUR,COMPLETED,357.42
TRANSFER,Current,2024-10-27 13:12:52,2024-10-27 13:12:52,Revolut Bank UAB,-40,0,EUR,COMPLETED,317.42
TOPUP,Current,2024-10-27 13:55:01,2024-10-27 13:55:03,Apple Pay Top-Up by *6964,200,0,EUR,COMPLETED,517.42
TRANSFER,Current,2024-10-27 14:59:13,2024-10-27 14:59:13,To EUR Savings,-0.8,0,EUR,COMPLETED,516.62
TRANSFER,Current,2024-10-28 03:16:47,2024-10-28 03:16:47,To EUR Savings,-20,0,EUR,COMPLETED,496.62
CARD_PAYMENT,Current,2024-10-27 12:37:35,2024-10-28 08:58:48,Kombucha,-13.5,0,EUR,COMPLETED,483.12
CARD_PAYMENT,Current,2024-10-27 08:33:26,2024-10-28 10:27:39,A Padaria Portuguesa,-2.5,0,EUR,COMPLETED,480.62
CARD_PAYMENT,Current,2024-10-27 14:59:13,2024-10-28 11:14:26,La Casa Da Praia,-6.2,0,EUR,COMPLETED,474.42
CARD_PAYMENT,Current,2024-10-27 09:34:27,2024-10-28 11:15:45,Pingo Doce,-27.64,0,EUR,COMPLETED,446.78
TRANSFER,Current,2024-10-28 11:16:10,2024-10-28 11:16:10,To EUR Savings,-0.01,0,EUR,COMPLETED,446.77
TRANSFER,Current,2024-10-29 04:52:13,2024-10-29 04:52:13,To EUR Savings,-0.51,0,EUR,COMPLETED,446.26
TRANSFER,Current,2024-10-29 12:43:59,2024-10-29 12:43:59,To EUR Savings,-0.79,0,EUR,COMPLETED,445.47
TRANSFER,Current,2024-10-29 20:29:29,2024-10-29 20:29:29,To EUR Savings,-0.25,0,EUR,COMPLETED,445.22
TRANSFER,Current,2024-10-30 01:54:14,2024-10-30 01:54:14,To EUR Savings,-0.05,0,EUR,COMPLETED,445.17
CARD_PAYMENT,Current,2024-10-28 11:16:10,2024-10-30 10:08:18,PlayStation,-8.99,0,EUR,COMPLETED,436.18
CARD_PAYMENT,Current,2024-10-29 20:29:29,2024-10-31 09:09:42,Uber Eats,-18.75,0,EUR,COMPLETED,417.43
CARD_PAYMENT,Current,2024-10-29 12:43:58,2024-10-31 09:20:50,Uber Eats,-34.21,0,EUR,COMPLETED,383.22
TRANSFER,Current,2024-10-31 12:57:54,2024-10-31 12:57:54,To EUR Savings,-0.23,0,EUR,COMPLETED,382.99
TRANSFER,Current,2024-10-31 17:40:22,2024-10-31 17:40:22,To EUR Savings,-0.01,0,EUR,COMPLETED,382.98
TRANSFER,Current,2024-11-01 00:45:52,2024-11-01 00:45:52,To EUR Savings,-0.05,0,EUR,COMPLETED,382.93
TRANSFER,Current,2024-11-01 01:44:13,2024-11-01 01:44:13,To EUR Rainy day,-50,0,EUR,COMPLETED,332.93
TRANSFER,Current,2024-11-01 08:11:59,2024-11-01 08:11:59,To EUR Savings,-0.5,0,EUR,COMPLETED,332.43
CARD_PAYMENT,Current,2024-10-29 04:52:13,2024-11-01 10:13:06,Apple,-5.49,0,EUR,COMPLETED,326.94
CARD_PAYMENT,Current,2024-10-30 01:54:14,2024-11-01 10:39:03,Apple,-21.95,0,EUR,COMPLETED,304.99
TRANSFER,Current,2024-11-01 15:25:22,2024-11-01 15:25:22,To EUR Savings,-1,0,EUR,COMPLETED,303.99
TRANSFER,Current,2024-11-02 08:25:25,2024-11-02 08:25:25,To EUR Savings,-0.5,0,EUR,COMPLETED,303.49
CARD_PAYMENT,Current,2024-10-31 12:57:53,2024-11-02 10:24:12,Uber Eats,-30.77,0,EUR,COMPLETED,272.72
CARD_PAYMENT,Current,2024-11-01 08:11:59,2024-11-02 11:26:37,A Padaria Portuguesa,-2.5,0,EUR,COMPLETED,270.22
CARD_PAYMENT,Current,2024-11-01 15:25:22,2024-11-02 11:28:02,Britavola,-71,0,EUR,COMPLETED,199.22
TOPUP,Current,2024-11-02 12:42:11,2024-11-02 12:42:13,Apple Pay Top-Up by *6964,400,0,EUR,COMPLETED,599.22
TRANSFER,Current,2024-11-03 07:59:45,2024-11-03 07:59:45,To EUR Savings,-0.5,0,EUR,COMPLETED,598.72
TRANSFER,Current,2024-11-03 08:53:42,2024-11-03 08:53:42,To EUR Savings,-0.47,0,EUR,COMPLETED,598.25
CARD_PAYMENT,Current,2024-10-31 17:40:22,2024-11-03 09:15:29,PlayStation,-79.99,0,EUR,COMPLETED,518.26
TRANSFER,Current,2024-11-03 09:18:52,2024-11-03 09:18:52,To EUR Savings,-0.39,0,EUR,COMPLETED,517.87
CARD_PAYMENT,Current,2024-11-02 08:25:24,2024-11-03 09:39:19,A Padaria Portuguesa,-2.5,0,EUR,COMPLETED,515.37
CARD_PAYMENT,Current,2024-11-01 00:45:52,2024-11-03 11:06:23,Paddle,-39.95,0,EUR,COMPLETED,475.42
TRANSFER,Current,2024-11-03 12:42:37,2024-11-03 12:42:37,To EUR Savings,-0.71,0,EUR,COMPLETED,474.71
TRANSFER,Current,2024-11-04 01:48:26,2024-11-04 01:48:26,To EUR Savings,-20,0,EUR,COMPLETED,454.71
CARD_PAYMENT,Current,2024-11-03 09:18:51,2024-11-04 09:19:15,Amazon,-7.61,0,EUR,COMPLETED,447.1
CARD_PAYMENT,Current,2024-11-03 12:42:36,2024-11-04 09:49:25,Uber Eats,-25.57,0,EUR,COMPLETED,421.53
CARD_PAYMENT,Current,2024-11-03 08:53:42,2024-11-04 10:02:01,Pingo Doce,-12.53,0,EUR,COMPLETED,409
CARD_PAYMENT,Current,2024-11-03 07:59:45,2024-11-04 10:26:25,A Padaria Portuguesa,-2.5,0,EUR,COMPLETED,406.5
TRANSFER,Current,2024-11-04 11:09:22,2024-11-04 11:09:23,Revolut Bank UAB,-16.2,0,EUR,COMPLETED,390.3
TRANSFER,Current,2024-11-05 19:18:09,2024-11-05 19:18:09,To EUR Savings,-0.43,0,EUR,COMPLETED,389.87
TRANSFER,Current,2024-11-06 18:02:51,2024-11-06 18:02:51,To EUR Savings,-0.64,0,EUR,COMPLETED,389.23
CARD_PAYMENT,Current,2024-11-07 08:27:46,,Secretlabnl,-25,0,EUR,REVERTED,
TRANSFER,Current,2024-11-07 08:27:46,2024-11-07 08:27:46,To EUR Savings,-1,0,EUR,COMPLETED,388.23
TRANSFER,Current,2024-11-07 08:28:47,2024-11-07 08:28:47,To EUR Savings,-0.1,0,EUR,COMPLETED,388.13
TRANSFER,Current,2024-11-07 12:48:56,2024-11-07 12:48:56,To EUR Savings,-0.5,0,EUR,COMPLETED,387.63
CARD_PAYMENT,Current,2024-11-06 18:02:50,2024-11-07 13:46:27,GitHub,-9.36,0,EUR,COMPLETED,378.27
CARD_PAYMENT,Current,2024-11-07 12:48:56,2024-11-08 10:09:11,Uber Eats,-20.5,0,EUR,COMPLETED,357.77
CARD_PAYMENT,Current,2024-11-07 08:28:47,2024-11-08 10:23:17,Secretlabnl,-27.9,0,EUR,COMPLETED,329.87
CARD_PAYMENT,Current,2024-11-05 19:18:09,2024-11-08 15:20:56,Waves,-27.57,0,EUR,COMPLETED,302.3
TRANSFER,Current,2024-11-09 08:40:31,2024-11-09 08:40:31,To EUR Savings,-0.5,0,EUR,COMPLETED,301.8
TRANSFER,Current,2024-11-09 12:30:32,2024-11-09 12:30:32,To EUR Savings,-0.31,0,EUR,COMPLETED,301.49
TRANSFER,Current,2024-11-09 12:39:39,2024-11-09 12:39:39,To EUR Savings,-0.79,0,EUR,COMPLETED,300.7
TOPUP,Current,2024-11-09 12:53:03,2024-11-09 12:53:04,Apple Pay Top-Up by *6964,200,0,EUR,COMPLETED,500.7
TRANSFER,Current,2024-11-10 08:31:38,2024-11-10 08:31:38,To EUR Savings,-0.5,0,EUR,COMPLETED,500.2
TRANSFER,Current,2024-11-10 09:14:35,2024-11-10 09:14:35,To EUR Savings,-0.04,0,EUR,COMPLETED,500.16
TRANSFER,Current,2024-11-10 09:41:02,2024-11-10 09:41:02,To EUR Savings,-0.7,0,EUR,COMPLETED,499.46
CARD_PAYMENT,Current,2024-11-09 12:30:32,2024-11-10 11:12:59,Minipreço,-8.69,0,EUR,COMPLETED,490.77
CARD_PAYMENT,Current,2024-11-09 08:40:31,2024-11-10 11:18:15,A Padaria Portuguesa,-2.5,0,EUR,COMPLETED,488.27
TRANSFER,Current,2024-11-10 13:59:22,2024-11-10 13:59:22,To EUR Savings,-1,0,EUR,COMPLETED,487.27
TRANSFER,Current,2024-11-10 14:09:36,2024-11-10 14:09:36,To EUR Savings,-0.4,0,EUR,COMPLETED,486.87
TRANSFER,Current,2024-11-10 14:40:56,2024-11-10 14:40:56,To EUR Savings,-0.2,0,EUR,COMPLETED,486.67
TRANSFER,Current,2024-11-10 14:45:59,2024-11-10 14:45:59,To EUR Savings,-0.5,0,EUR,COMPLETED,486.17
TRANSFER,Current,2024-11-10 14:52:54,2024-11-10 14:52:54,To EUR Savings,-1,0,EUR,COMPLETED,485.17
TRANSFER,Current,2024-11-10 20:55:51,2024-11-10 20:55:51,To EUR Savings,-0.67,0,EUR,COMPLETED,484.5
TRANSFER,Current,2024-11-11 01:52:38,2024-11-11 01:52:38,To EUR Savings,-20,0,EUR,COMPLETED,464.5
CARD_PAYMENT,Current,2024-11-10 09:14:34,2024-11-11 10:15:21,Auchan,-35.96,0,EUR,COMPLETED,428.54
CARD_PAYMENT,Current,2024-11-10 09:41:02,2024-11-11 10:15:21,Pingo Doce,-23.3,0,EUR,COMPLETED,405.24
CARD_PAYMENT,Current,2024-11-10 14:40:56,2024-11-11 11:36:50,"Sabores Do Dia - Gelado Artesanal, Lda.",-3.8,0,EUR,COMPLETED,401.44
CARD_PAYMENT,Current,2024-11-10 13:59:22,2024-11-11 11:41:17,Saisish,-20,0,EUR,COMPLETED,381.44
CARD_PAYMENT,Current,2024-11-10 14:09:36,2024-11-11 11:41:17,Mercado De Alges,-7.6,0,EUR,COMPLETED,373.84
CARD_PAYMENT,Current,2024-11-10 08:31:38,2024-11-11 11:41:24,A Padaria Portuguesa,-2.5,0,EUR,COMPLETED,371.34
CARD_PAYMENT,Current,2024-11-10 14:45:59,2024-11-11 11:41:27,Mercado De Alges,-3.5,0,EUR,COMPLETED,367.84
CARD_PAYMENT,Current,2024-11-10 14:52:54,2024-11-11 11:41:29,Mercado De Alges,-2,0,EUR,COMPLETED,365.84
CARD_PAYMENT,Current,2024-11-09 12:39:38,2024-11-12 09:33:25,Uber Eats,-34.21,0,EUR,COMPLETED,331.63
CARD_PAYMENT,Current,2024-11-10 20:55:51,2024-11-12 10:37:44,Minipreço,-4.33,0,EUR,COMPLETED,327.3
TRANSFER,Current,2024-11-14 12:23:55,2024-11-14 12:23:55,To EUR Savings,-1,0,EUR,COMPLETED,326.3
TOPUP,Current,2024-11-14 12:24:30,2024-11-14 12:24:31,Apple Pay Top-Up by *6964,200,0,EUR,COMPLETED,526.3
TRANSFER,Current,2024-11-14 12:45:57,2024-11-14 12:45:57,To EUR Savings,-0.23,0,EUR,COMPLETED,526.07
CARD_PAYMENT,Current,2024-11-14 12:23:55,2024-11-15 11:28:53,Clinica Medis Alges,-116,0,EUR,COMPLETED,410.07
TRANSFER,Current,2024-11-16 08:25:05,2024-11-16 08:25:05,To EUR Savings,-0.5,0,EUR,COMPLETED,409.57
TRANSFER,Current,2024-11-16 09:24:58,2024-11-16 09:24:58,To EUR Savings,-0.15,0,EUR,COMPLETED,409.42
TRANSFER,Current,2024-11-17 08:27:30,2024-11-17 08:27:30,To EUR Savings,-0.5,0,EUR,COMPLETED,408.92
CARD_PAYMENT,Current,2024-11-14 12:45:57,2024-11-17 09:24:41,Uber Eats,-30.77,0,EUR,COMPLETED,378.15
CARD_PAYMENT,Current,2024-11-16 09:24:58,2024-11-17 10:07:08,Pingo Doce,-42.85,0,EUR,COMPLETED,335.3
CARD_PAYMENT,Current,2024-11-16 08:25:05,2024-11-17 12:16:44,A Padaria Portuguesa,-2.5,0,EUR,COMPLETED,332.8
TRANSFER,Current,2024-11-17 15:49:28,2024-11-17 15:49:28,To EUR Savings,-1,0,EUR,COMPLETED,331.8
TRANSFER,Current,2024-11-18 01:56:09,2024-11-18 01:56:09,To EUR Savings,-20,0,EUR,COMPLETED,311.8
CARD_PAYMENT,Current,2024-11-17 15:49:27,2024-11-18 09:27:16,Miió,-30,0,EUR,COMPLETED,281.8
CARD_PAYMENT,Current,2024-11-17 08:27:30,2024-11-18 09:32:51,A Padaria Portuguesa,-2.5,0,EUR,COMPLETED,279.3
TRANSFER,Current,2024-11-18 10:16:09,2024-11-18 10:16:09,To EUR Savings,-0.48,0,EUR,COMPLETED,278.82
TRANSFER,Current,2024-11-19 11:46:18,2024-11-19 11:46:18,To EUR Savings,-0.58,0,EUR,COMPLETED,278.24
CARD_PAYMENT,Current,2024-11-18 10:16:09,2024-11-19 15:37:43,Supermaven,-9.52,0,EUR,COMPLETED,268.72
TRANSFER,Current,2024-11-20 12:10:03,2024-11-20 12:10:03,To EUR Savings,-0.01,0,EUR,COMPLETED,268.71
TRANSFER,Current,2024-11-20 12:56:53,2024-11-20 12:56:53,To EUR Savings,-0.29,0,EUR,COMPLETED,268.42
CARD_PAYMENT,Current,2024-11-19 11:46:17,2024-11-20 14:27:07,OpenAI,-23.42,0,EUR,COMPLETED,245
CARD_PAYMENT,Current,2024-11-20 12:56:53,2024-11-21 09:12:51,Uber Eats,-17.71,0,EUR,COMPLETED,227.29
CARD_PAYMENT,Current,2024-11-20 12:10:03,2024-11-21 09:25:06,Uber,-4.99,0,EUR,COMPLETED,222.3
TRANSFER,Current,2024-11-22 13:04:48,2024-11-22 13:04:48,To EUR Savings,-0.5,0,EUR,COMPLETED,221.8
TRANSFER,Current,2024-11-23 07:53:37,2024-11-23 07:53:37,To EUR Savings,-0.5,0,EUR,COMPLETED,221.3
TRANSFER,Current,2024-11-23 08:12:26,2024-11-23 08:12:26,To EUR Savings,-0.01,0,EUR,COMPLETED,221.29
TOPUP,Current,2024-11-23 08:15:00,2024-11-23 08:15:02,Apple Pay Top-Up by *6964,200,0,EUR,COMPLETED,421.29
TRANSFER,Current,2024-11-23 09:03:17,2024-11-23 09:03:17,To EUR Savings,-0.24,0,EUR,COMPLETED,421.05
TRANSFER,Current,2024-11-23 09:14:37,2024-11-23 09:14:37,To EUR Savings,-0.75,0,EUR,COMPLETED,420.3
CARD_PAYMENT,Current,2024-11-22 13:04:48,2024-11-23 11:48:53,Uber Eats,-20.5,0,EUR,COMPLETED,399.8
TRANSFER,Current,2024-11-23 12:54:55,2024-11-23 12:54:55,To EUR Savings,-0.63,0,EUR,COMPLETED,399.17
TRANSFER,Current,2024-11-24 08:25:55,2024-11-24 08:25:55,To EUR Savings,-0.5,0,EUR,COMPLETED,398.67
CARD_PAYMENT,Current,2024-11-23 12:54:55,2024-11-24 10:46:19,Uber Eats,-16.37,0,EUR,COMPLETED,382.3
CARD_PAYMENT,Current,2024-11-23 09:03:17,2024-11-24 11:02:33,Pingo Doce,-36.76,0,EUR,COMPLETED,345.54
CARD_PAYMENT,Current,2024-11-23 09:14:36,2024-11-24 11:03:04,Pingo Doce,-1.25,0,EUR,COMPLETED,344.29
CARD_PAYMENT,Current,2024-11-23 07:53:37,2024-11-24 11:52:25,A Padaria Portuguesa,-2.5,0,EUR,COMPLETED,341.79
TRANSFER,Current,2024-11-24 12:52:15,2024-11-24 12:52:15,To EUR Savings,-0.83,0,EUR,COMPLETED,340.96
CARD_PAYMENT,Current,2024-11-23 08:12:26,2024-11-24 14:19:43,YouTube,-12.99,0,EUR,COMPLETED,327.97
TRANSFER,Current,2024-11-24 20:10:14,2024-11-24 20:10:14,To EUR Savings,-0.93,0,EUR,COMPLETED,327.04
TRANSFER,Current,2024-11-25 01:46:20,2024-11-25 01:46:20,To EUR Savings,-20,0,EUR,COMPLETED,307.04
CARD_PAYMENT,Current,2024-11-24 08:25:55,2024-11-25 11:59:13,A Padaria Portuguesa,-2.5,0,EUR,COMPLETED,304.54
TRANSFER,Current,2024-11-25 16:21:39,2024-11-25 16:21:39,To EUR Savings,-1,0,EUR,COMPLETED,303.54
TRANSFER,Current,2024-11-25 22:50:55,2024-11-25 22:50:55,To EUR Savings,-0.77,0,EUR,COMPLETED,302.77
CARD_PAYMENT,Current,2024-11-25 16:21:39,2024-11-26 10:12:18,Clinica Medis Alges,-110,0,EUR,COMPLETED,192.77
CARD_PAYMENT,Current,2024-11-24 12:52:15,2024-11-27 10:55:38,Uber Eats,-23.17,0,EUR,COMPLETED,169.6
CARD_PAYMENT,Current,2024-11-25 22:50:55,2024-11-27 11:59:24,Otdistribut,-1.23,0,EUR,COMPLETED,168.37
CARD_PAYMENT,Current,2024-11-24 20:10:13,2024-11-27 15:27:59,Tunecore,-45.07,0.45,EUR,COMPLETED,122.85
TRANSFER,Current,2024-11-28 11:16:07,2024-11-28 11:16:07,To EUR Savings,-0.01,0,EUR,COMPLETED,122.84
TRANSFER,Current,2024-11-28 12:50:07,2024-11-28 12:50:07,To EUR Savings,-0.23,0,EUR,COMPLETED,122.61
TOPUP,Current,2024-11-28 23:05:24,2024-11-28 23:05:25,Apple Pay Top-Up by *6964,400,0,EUR,COMPLETED,522.61
TRANSFER,Current,2024-11-29 05:52:07,2024-11-29 05:52:07,To EUR Savings,-0.51,0,EUR,COMPLETED,522.1
CARD_PAYMENT,Current,2024-11-28 11:16:07,2024-11-29 10:51:58,PlayStation,-8.99,0,EUR,COMPLETED,513.11
TRANSFER,Current,2024-11-30 02:57:45,2024-11-30 02:57:45,To EUR Savings,-0.05,0,EUR,COMPLETED,513.06
TRANSFER,Current,2024-11-30 08:01:07,2024-11-30 08:01:07,To EUR Savings,-0.5,0,EUR,COMPLETED,512.56
TRANSFER,Current,2024-11-30 12:40:00,2024-11-30 12:40:00,To EUR Savings,-0.33,0,EUR,COMPLETED,512.23
TRANSFER,Current,2024-12-01 01:11:14,2024-12-01 01:11:14,To EUR Rainy day,-50,0,EUR,COMPLETED,462.23
TRANSFER,Current,2024-12-01 08:20:28,2024-12-01 08:20:28,To EUR Savings,-0.5,0,EUR,COMPLETED,461.73
TRANSFER,Current,2024-12-01 08:59:43,2024-12-01 08:59:43,To EUR Savings,-0.8,0,EUR,COMPLETED,460.93
CARD_PAYMENT,Current,2024-11-30 08:01:07,2024-12-01 08:59:48,A Padaria Portuguesa,-2.5,0,EUR,COMPLETED,458.43
CARD_PAYMENT,Current,2024-11-28 12:50:07,2024-12-01 11:48:00,Uber Eats,-30.77,0,EUR,COMPLETED,427.66
TRANSFER,Current,2024-12-01 12:44:20,2024-12-01 12:44:20,To EUR Savings,-0.73,0,EUR,COMPLETED,426.93
TRANSFER,Current,2024-12-02 01:57:57,2024-12-02 01:57:57,To EUR Savings,-20,0,EUR,COMPLETED,406.93
CARD_PAYMENT,Current,2024-12-01 08:20:28,2024-12-02 11:12:48,A Padaria Portuguesa,-2.5,0,EUR,COMPLETED,404.43
CARD_PAYMENT,Current,2024-11-29 05:52:06,2024-12-02 12:22:31,Apple,-5.49,0,EUR,COMPLETED,398.94
CARD_PAYMENT,Current,2024-11-30 02:57:45,2024-12-02 12:48:32,Apple,-21.95,0,EUR,COMPLETED,376.99
CARD_PAYMENT,Current,2024-12-01 08:59:43,2024-12-02 13:29:50,Pingo Doce,-47.2,0,EUR,COMPLETED,329.79
CARD_PAYMENT,Current,2024-11-30 12:40:00,2024-12-03 12:08:23,Uber Eats,-14.67,0,EUR,COMPLETED,315.12
CARD_PAYMENT,Current,2024-12-01 12:44:20,2024-12-04 09:31:11,Uber Eats,-39.27,0,EUR,COMPLETED,275.85
TRANSFER,Current,2024-12-04 16:54:16,2024-12-04 16:54:16,To EUR Savings,-0.6,0,EUR,COMPLETED,275.25
CARD_PAYMENT,Current,2024-12-04 16:54:16,2024-12-05 11:39:03,Ricardo Romeu Monteiro,-69.4,0,EUR,COMPLETED,205.85
TRANSFER,Current,2024-12-05 12:10:34,2024-12-05 12:10:34,Revolut Bank UAB,60,0,EUR,COMPLETED,265.85
TRANSFER,Current,2024-12-05 13:06:04,2024-12-05 13:06:04,To EUR Savings,-0.23,0,EUR,COMPLETED,265.62
TOPUP,Current,2024-12-05 13:30:02,2024-12-05 13:30:03,Apple Pay Top-Up by *6964,200,0,EUR,COMPLETED,465.62
TRANSFER,Current,2024-12-06 12:50:56,2024-12-06 12:50:56,To EUR Savings,-0.69,0,EUR,COMPLETED,464.93
TRANSFER,Current,2024-12-06 22:34:14,2024-12-06 22:34:14,To EUR Savings,-0.01,0,EUR,COMPLETED,464.92
TRANSFER,Current,2024-12-07 08:34:44,2024-12-07 08:34:44,To EUR Savings,-0.5,0,EUR,COMPLETED,464.42
TRANSFER,Current,2024-12-07 09:31:32,2024-12-07 09:31:32,To EUR Savings,-0.45,0,EUR,COMPLETED,463.97
TRANSFER,Current,2024-12-07 11:19:26,2024-12-07 11:19:26,To EUR Savings,-0.16,0,EUR,COMPLETED,463.81
TRANSFER,Current,2024-12-08 08:46:48,2024-12-08 08:46:48,To EUR Savings,-0.5,0,EUR,COMPLETED,463.31
CARD_PAYMENT,Current,2024-12-07 09:31:32,2024-12-08 08:48:33,Pingo Doce,-24.55,0,EUR,COMPLETED,438.76
CARD_PAYMENT,Current,2024-12-05 13:06:04,2024-12-08 09:31:06,Uber Eats,-30.77,0,EUR,COMPLETED,407.99
CARD_PAYMENT,Current,2024-12-07 11:19:26,2024-12-08 10:34:22,Talho Super Desconto,-13.84,0,EUR,COMPLETED,394.15
CARD_PAYMENT,Current,2024-12-07 08:34:44,2024-12-08 10:47:37,A Padaria Portuguesa,-2.5,0,EUR,COMPLETED,391.65
TRANSFER,Current,2024-12-08 11:19:09,2024-12-08 11:19:09,To EUR Savings,-1,0,EUR,COMPLETED,390.65
TRANSFER,Current,2024-12-09 01:37:31,2024-12-09 01:37:31,To EUR Savings,-20,0,EUR,COMPLETED,370.65
CARD_PAYMENT,Current,2024-12-06 12:50:55,2024-12-09 09:46:02,Uber Eats,-35.31,0,EUR,COMPLETED,335.34
CARD_PAYMENT,Current,2024-12-06 22:34:14,2024-12-09 09:47:10,Apple,-3.99,0,EUR,COMPLETED,331.35
CARD_PAYMENT,Current,2024-12-08 08:46:48,2024-12-09 10:19:33,A Padaria Portuguesa,-2.5,0,EUR,COMPLETED,328.85
CARD_PAYMENT,Current,2024-12-08 11:19:08,2024-12-09 10:42:53,Brisa,-8,0,EUR,COMPLETED,320.85
TRANSFER,Current,2024-12-10 08:58:26,2024-12-10 08:58:26,To EUR Savings,-0.79,0,EUR,COMPLETED,320.06
CARD_PAYMENT,Current,2024-12-10 08:58:25,2024-12-11 12:01:13,Amazon,-13.21,0,EUR,COMPLETED,306.85
TRANSFER,Current,2024-12-11 19:59:00,2024-12-11 19:59:00,To EUR Savings,-0.78,0,EUR,COMPLETED,306.07
TRANSFER,Current,2024-12-11 22:57:54,2024-12-11 22:57:54,To EUR Savings,-0.01,0,EUR,COMPLETED,306.06
CARD_PAYMENT,Current,2024-12-11 19:59:00,2024-12-12 10:56:52,Minipreço,-13.22,0,EUR,COMPLETED,292.84
TRANSFER,Current,2024-12-12 13:00:46,2024-12-12 13:00:46,To EUR Savings,-0.23,0,EUR,COMPLETED,292.61
TRANSFER,Current,2024-12-12 14:29:01,2024-12-12 14:29:01,To EUR Savings,-0.06,0,EUR,COMPLETED,292.55
CARD_PAYMENT,Current,2024-12-12 14:29:01,2024-12-13 09:12:58,Uber Eats,-5.94,0,EUR,COMPLETED,286.61
CARD_PAYMENT,Current,2024-12-11 22:57:54,2024-12-13 10:47:35,PlayStation,-39.99,0,EUR,COMPLETED,246.62
TRANSFER,Current,2024-12-13 22:11:00,2024-12-13 22:11:00,To EUR Savings,-1,0,EUR,COMPLETED,245.62
TRANSFER,Current,2024-12-14 08:24:53,2024-12-14 08:24:53,To EUR Savings,-0.5,0,EUR,COMPLETED,245.12
TRANSFER,Current,2024-12-14 09:38:28,2024-12-14 09:38:28,To EUR Savings,-0.05,0,EUR,COMPLETED,245.07
TRANSFER,Current,2024-12-14 11:01:19,2024-12-14 11:01:19,To EUR Savings,-0.4,0,EUR,COMPLETED,244.67
TRANSFER,Current,2024-12-14 15:49:40,2024-12-14 15:49:40,To EUR Savings,-1,0,EUR,COMPLETED,243.67
TOPUP,Current,2024-12-14 16:36:37,2024-12-14 16:36:38,Apple Pay Top-Up by *6964,400,0,EUR,COMPLETED,643.67
TRANSFER,Current,2024-12-15 08:37:23,2024-12-15 08:37:23,To EUR Savings,-0.5,0,EUR,COMPLETED,643.17
CARD_PAYMENT,Current,2024-12-14 11:01:19,2024-12-15 10:44:29,Talho Super Desconto,-24.6,0,EUR,COMPLETED,618.57
CARD_PAYMENT,Current,2024-12-13 22:11:00,2024-12-15 10:44:36,Brasa de Sassoeiros - Páteo da Colina,-34,0,EUR,COMPLETED,584.57
CARD_PAYMENT,Current,2024-12-14 15:49:40,2024-12-15 10:48:31,SKECHERS Showroom Lisboa,-104,0,EUR,COMPLETED,480.57
CARD_PAYMENT,Current,2024-12-14 08:24:53,2024-12-15 10:59:01,A Padaria Portuguesa,-2.5,0,EUR,COMPLETED,478.07
TRANSFER,Current,2024-12-15 12:22:50,2024-12-15 12:22:50,To EUR Savings,-0.01,0,EUR,COMPLETED,478.06
CARD_PAYMENT,Current,2024-12-14 09:38:28,2024-12-15 12:30:09,Pingo Doce,-45.95,0,EUR,COMPLETED,432.11
CARD_PAYMENT,Current,2024-12-12 13:00:46,2024-12-15 12:59:13,Uber Eats,-30.77,0,EUR,COMPLETED,401.34
TRANSFER,Current,2024-12-15 16:23:35,2024-12-15 16:23:35,To EUR Savings,-1,0,EUR,COMPLETED,400.34
TRANSFER,Current,2024-12-16 01:43:11,2024-12-16 01:43:11,To EUR Savings,-20,0,EUR,COMPLETED,380.34
TRANSFER,Current,2024-12-16 08:28:38,2024-12-16 08:28:38,To EUR Savings,-0.5,0,EUR,COMPLETED,379.84
TRANSFER,Current,2024-12-16 11:32:07,2024-12-16 11:32:07,To EUR Savings,-1,0,EUR,COMPLETED,378.84
TRANSFER,Current,2024-12-16 12:02:22,2024-12-16 12:02:22,To EUR Savings,-0.15,0,EUR,COMPLETED,378.69
TRANSFER,Current,2024-12-16 12:06:26,2024-12-16 12:06:26,To EUR Savings,-0.9,0,EUR,COMPLETED,377.79
CARD_PAYMENT,Current,2024-12-15 16:23:34,2024-12-16 12:37:09,Uber Eats,-2,0,EUR,COMPLETED,375.79
CARD_PAYMENT,Current,2024-12-15 08:37:23,2024-12-16 12:51:27,A Padaria Portuguesa,-2.5,0,EUR,COMPLETED,373.29
TRANSFER,Current,2024-12-16 15:43:49,2024-12-16 15:43:49,To EUR Savings,-0.01,0,EUR,COMPLETED,373.28
TOPUP,Current,2024-12-16 15:45:52,2024-12-16 15:45:53,Apple Pay Top-Up by *6964,300,0,EUR,COMPLETED,673.28
TRANSFER,Current,2024-12-16 17:57:45,2024-12-16 17:57:45,To EUR Savings,-0.72,0,EUR,COMPLETED,672.56
TRANSFER,Current,2024-12-16 21:55:31,2024-12-16 21:55:31,To EUR Savings,-0.28,0,EUR,COMPLETED,672.28
TRANSFER,Current,2024-12-16 23:58:57,2024-12-16 23:58:57,To EUR Savings,-1,0,EUR,COMPLETED,671.28
TOPUP,Current,2024-12-17 01:03:58,2024-12-17 01:04:00,Apple Pay Top-Up by *6964,400,0,EUR,COMPLETED,1071.28
TRANSFER,Current,2024-12-17 01:05:43,2024-12-17 01:05:43,Revolut Bank UAB (Netherlands Branch),-380,0,EUR,COMPLETED,691.28
TRANSFER,Current,2024-12-17 01:14:19,2024-12-17 01:14:19,Revolut Bank UAB (Netherlands Branch),-50,0,EUR,COMPLETED,641.28
TRANSFER,Current,2024-12-17 09:37:29,2024-12-17 09:37:29,To EUR Savings,-1,0,EUR,COMPLETED,640.28
CARD_PAYMENT,Current,2024-12-16 11:32:06,2024-12-17 10:49:26,Calvin Klein,-108,0,EUR,COMPLETED,532.28
CARD_PAYMENT,Current,2024-12-16 12:02:22,2024-12-17 10:49:34,areas,-17.85,0,EUR,COMPLETED,514.43
CARD_PAYMENT,Current,2024-12-16 12:06:26,2024-12-17 10:49:48,Lis 9074,-2.1,0,EUR,COMPLETED,512.33
CARD_PAYMENT,Current,2024-12-16 08:28:38,2024-12-17 11:04:42,A Padaria Portuguesa,-2.5,0,EUR,COMPLETED,509.83
CARD_PAYMENT,Current,2024-12-16 15:43:48,2024-12-17 12:16:15,Apple,-30.99,0,EUR,COMPLETED,478.84
CARD_PAYMENT,Current,2024-12-16 23:58:57,2024-12-17 13:43:05,Vusryzsm,-50,0,EUR,COMPLETED,428.84
TRANSFER,Current,2024-12-17 15:28:14,2024-12-17 15:28:14,To EUR Savings,-1,0,EUR,COMPLETED,427.84
TRANSFER,Current,2024-12-17 22:32:53,2024-12-17 22:32:53,To EUR Savings,-0.5,0,EUR,COMPLETED,427.34
TRANSFER,Current,2024-12-18 07:49:46,2024-12-18 07:49:46,To EUR Savings,-0.68,0,EUR,COMPLETED,426.66
TOPUP,Current,2024-12-18 08:06:06,2024-12-18 08:06:07,Apple Pay Top-Up by *6964,200,0,EUR,COMPLETED,626.66
TRANSFER,Current,2024-12-18 09:06:19,2024-12-18 09:06:19,To EUR Savings,-0.09,0,EUR,COMPLETED,626.57
CARD_PAYMENT,Current,2024-12-17 09:37:29,2024-12-18 09:13:04,Gate Gourmet,-3,0,EUR,COMPLETED,623.57
TRANSFER,Current,2024-12-18 10:16:16,2024-12-18 10:16:16,To EUR Savings,-0.42,0,EUR,COMPLETED,623.15
TRANSFER,Current,2024-12-18 11:18:37,2024-12-18 11:18:37,To EUR Savings,-0.1,0,EUR,COMPLETED,623.05
CARD_PAYMENT,Current,2024-12-16 17:57:45,2024-12-18 12:14:19,Uber,-11.28,0,EUR,COMPLETED,611.77
CARD_PAYMENT,Current,2024-12-16 21:55:30,2024-12-18 12:27:46,Uber,-19.72,0,EUR,COMPLETED,592.05
CARD_PAYMENT,Current,2024-12-17 15:28:13,2024-12-18 12:30:32,Uber,-11,0,EUR,COMPLETED,581.05
CARD_PAYMENT,Current,2024-12-15 12:22:50,2024-12-18 12:36:00,Uber Eats,-50.99,0,EUR,COMPLETED,530.06
TRANSFER,Current,2024-12-18 22:56:47,2024-12-18 22:56:47,To EUR Savings,-1,0,EUR,COMPLETED,529.06
CARD_PAYMENT,Current,2024-12-18 22:56:47,2024-12-19 08:58:43,Gate Gourmet,-3,0,EUR,COMPLETED,526.06
TRANSFER,Current,2024-12-19 11:46:01,2024-12-19 11:46:01,To EUR Savings,-0.24,0,EUR,COMPLETED,525.82
CARD_PAYMENT,Current,2024-12-18 09:06:18,2024-12-19 12:03:58,HMSHost International,-7.91,0,EUR,COMPLETED,517.91
CARD_PAYMENT,Current,2024-12-18 11:18:37,2024-12-19 12:06:26,HMSHost International,-26.9,0,EUR,COMPLETED,491.01
CARD_PAYMENT,Current,2024-12-17 22:32:52,2024-12-19 12:23:46,Uber,-12.5,0,EUR,COMPLETED,478.51
TRANSFER,Current,2024-12-19 12:51:27,2024-12-19 12:51:27,To EUR Savings,-0.23,0,EUR,COMPLETED,478.28
TRANSFER,Current,2024-12-19 14:19:42,2024-12-19 14:19:42,To EUR Savings,-0.54,0,EUR,COMPLETED,477.74
CARD_PAYMENT,Current,2024-12-18 10:16:15,2024-12-19 15:48:43,Supermaven,-9.58,0,EUR,COMPLETED,468.16
TRANSFER,Current,2024-12-19 23:21:19,2024-12-19 23:21:19,Revolut Bank UAB,-69,0,EUR,COMPLETED,399.16
CARD_PAYMENT,Current,2024-12-19 14:19:42,2024-12-20 09:50:19,Uber Eats,-4.46,0,EUR,COMPLETED,394.7
TRANSFER,Current,2024-12-20 12:10:04,2024-12-20 12:10:04,To EUR Savings,-0.01,0,EUR,COMPLETED,394.69
CARD_PAYMENT,Current,2024-12-19 11:46:01,2024-12-20 15:04:56,OpenAI,-23.76,0,EUR,COMPLETED,370.93
TRANSFER,Current,2024-12-20 16:26:49,2024-12-20 16:26:49,To EUR Savings,-0.01,0,EUR,COMPLETED,370.92
TRANSFER,Current,2024-12-20 16:53:10,2024-12-20 16:53:10,To EUR Savings,-0.53,0,EUR,COMPLETED,370.39
TRANSFER,Current,2024-12-20 17:26:41,2024-12-20 17:26:41,To EUR Savings,-0.1,0,EUR,COMPLETED,370.29
TOPUP,Current,2024-12-20 17:27:03,2024-12-20 17:27:04,Apple Pay Top-Up by *6964,400,0,EUR,COMPLETED,770.29
TRANSFER,Current,2024-12-21 08:15:13,2024-12-21 08:15:13,To EUR Savings,-0.5,0,EUR,COMPLETED,769.79
TRANSFER,Current,2024-12-21 09:13:27,2024-12-21 09:13:27,To EUR Savings,-0.52,0,EUR,COMPLETED,769.27
TRANSFER,Current,2024-12-21 09:50:14,2024-12-21 09:50:14,To EUR Savings,-0.03,0,EUR,COMPLETED,769.24
CARD_PAYMENT,Current,2024-12-18 07:49:45,2024-12-21 11:43:22,Uber,-46.32,0,EUR,COMPLETED,722.92
CARD_PAYMENT,Current,2024-12-20 12:10:03,2024-12-21 11:59:05,Uber,-4.99,0,EUR,COMPLETED,717.93
TRANSFER,Current,2024-12-22 08:19:38,2024-12-22 08:19:38,To EUR Savings,-0.5,0,EUR,COMPLETED,717.43
TRANSFER,Current,2024-12-22 08:39:17,2024-12-22 08:39:17,To EUR Savings,-0.27,0,EUR,COMPLETED,717.16
TRANSFER,Current,2024-12-22 09:29:16,2024-12-22 09:29:16,To EUR Savings,-1,0,EUR,COMPLETED,716.16
CARD_PAYMENT,Current,2024-12-19 12:51:26,2024-12-22 10:37:22,Uber Eats,-30.77,0,EUR,COMPLETED,685.39
TRANSFER,Current,2024-12-22 12:25:58,2024-12-22 12:25:58,To EUR Savings,-0.14,0,EUR,COMPLETED,685.25
CARD_PAYMENT,Current,2024-12-21 09:13:26,2024-12-22 14:30:04,Pingo Doce,-74.48,0,EUR,COMPLETED,610.77
CARD_PAYMENT,Current,2024-12-21 09:50:14,2024-12-22 14:42:20,Talho Super Desconto,-10.97,0,EUR,COMPLETED,599.8
CARD_PAYMENT,Current,2024-12-21 08:15:13,2024-12-22 14:42:37,A Padaria Portuguesa,-2.5,0,EUR,COMPLETED,597.3
TRANSFER,Current,2024-12-23 01:37:53,2024-12-23 01:37:53,To EUR Savings,-20,0,EUR,COMPLETED,577.3
TRANSFER,Current,2024-12-23 08:03:33,2024-12-23 08:03:33,To EUR Savings,-0.5,0,EUR,COMPLETED,576.8
TRANSFER,Current,2024-12-23 08:12:26,2024-12-23 08:12:26,To EUR Savings,-0.01,0,EUR,COMPLETED,576.79
CARD_PAYMENT,Current,2024-12-20 16:26:49,2024-12-23 09:00:58,PlayStation,-3.99,0,EUR,COMPLETED,572.8
CARD_PAYMENT,Current,2024-12-20 16:53:10,2024-12-23 10:35:00,Steam,-4.47,0,EUR,COMPLETED,568.33
CARD_PAYMENT,Current,2024-12-22 12:25:58,2024-12-23 11:10:12,Cnt Bd Alges Bombeir,-21.86,0,EUR,COMPLETED,546.47
CARD_PAYMENT,Current,2024-12-22 08:19:38,2024-12-23 11:10:23,A Padaria Portuguesa,-2.5,0,EUR,COMPLETED,543.97
CARD_PAYMENT,Current,2024-12-20 17:26:41,2024-12-23 13:01:48,Amazon,-199.9,0,EUR,COMPLETED,344.07
TRANSFER,Current,2024-12-23 15:51:34,2024-12-23 15:51:34,To EUR Savings,-0.2,0,EUR,COMPLETED,343.87
TOPUP,Current,2024-12-23 19:04:58,2024-12-23 19:05:00,Apple Pay Top-Up by *6964,300,0,EUR,COMPLETED,643.87
TRANSFER,Current,2024-12-24 08:14:39,2024-12-24 08:14:39,To EUR Savings,-0.5,0,EUR,COMPLETED,643.37
TRANSFER,Current,2024-12-24 09:18:21,2024-12-24 09:18:21,To EUR Savings,-0.09,0,EUR,COMPLETED,643.28
CARD_PAYMENT,Current,2024-12-22 08:39:17,2024-12-24 10:06:10,Amazon,-8.73,0,EUR,COMPLETED,634.55
FEE,Current,2024-12-24 12:19:32,2024-12-24 12:19:32,Card Delivery,-3.99,0,EUR,COMPLETED,630.56
CARD_PAYMENT,Current,2024-12-23 08:12:26,2024-12-24 13:02:10,YouTube,-17.99,0,EUR,COMPLETED,612.57
TRANSFER,Current,2024-12-24 14:06:59,2024-12-24 14:06:59,To EUR Savings,-0.87,0,EUR,COMPLETED,611.7
TRANSFER,Current,2024-12-24 14:21:15,2024-12-24 14:21:15,To EUR Savings,-1,0,EUR,COMPLETED,610.7
CARD_PAYMENT,Current,2024-12-22 09:29:16,2024-12-24 15:05:42,MasterClass,-96,0,EUR,COMPLETED,514.7
CARD_PAYMENT,Current,2024-12-23 08:03:33,2024-12-24 16:47:00,A Padaria Portuguesa,-2.5,0,EUR,COMPLETED,512.2
CARD_PAYMENT,Current,2024-12-23 15:51:33,2024-12-24 16:49:18,Britavola,-61.8,0,EUR,COMPLETED,450.4
CARD_PAYMENT,Current,2024-12-24 14:21:15,2024-12-25 10:05:09,Alges Com Sabores,-18,0,EUR,COMPLETED,432.4
CARD_PAYMENT,Current,2024-12-24 14:06:58,2024-12-25 10:05:17,Pingo Doce,-8.13,0,EUR,COMPLETED,424.27
TRANSFER,Current,2024-12-25 10:09:56,2024-12-25 10:09:56,To EUR Savings,-1,0,EUR,COMPLETED,423.27
TOPUP,Current,2024-12-25 10:10:44,2024-12-25 10:10:46,Apple Pay Top-Up by *6964,400,0,EUR,COMPLETED,823.27
CARD_PAYMENT,Current,2024-12-24 08:14:39,2024-12-25 12:16:01,A Padaria Portuguesa,-2.5,0,EUR,COMPLETED,820.77
TRANSFER,Current,2024-12-26 08:28:06,2024-12-26 08:28:06,To EUR Savings,-0.5,0,EUR,COMPLETED,820.27
CARD_PAYMENT,Current,2024-12-24 09:18:21,2024-12-26 09:03:08,Pingo Doce,-81.91,0,EUR,COMPLETED,738.36
TRANSFER,Current,2024-12-26 12:43:55,2024-12-26 12:43:55,To EUR Savings,-0.23,0,EUR,COMPLETED,738.13
CARD_PAYMENT,Current,2024-12-26 08:28:05,2024-12-27 06:25:21,A Padaria Portuguesa,-2.5,0,EUR,COMPLETED,735.63
TRANSFER,Current,2024-12-27 08:37:49,2024-12-27 08:37:49,To EUR Savings,-0.5,0,EUR,COMPLETED,735.13
TRANSFER,Current,2024-12-27 09:35:19,2024-12-27 09:35:19,To EUR Savings,-1,0,EUR,COMPLETED,734.13
TRANSFER,Current,2024-12-27 09:55:46,2024-12-27 09:55:46,To EUR Savings,-0.71,0,EUR,COMPLETED,733.42
TRANSFER,Current,2024-12-27 10:11:02,2024-12-27 10:11:02,To EUR Savings,-1,0,EUR,COMPLETED,732.42
CARD_PAYMENT,Current,2024-12-25 10:09:56,2024-12-27 12:39:16,Spitfireaud,-269,0,EUR,COMPLETED,463.42
TRANSFER,Current,2024-12-27 15:01:01,2024-12-27 15:01:01,To EUR Savings,-1,0,EUR,COMPLETED,462.42
TRANSFER,Current,2024-12-27 23:48:54,2024-12-27 23:48:54,To EUR Savings,-1,0,EUR,COMPLETED,461.42
CARD_PAYMENT,Current,2024-12-27 08:37:48,2024-12-28 06:30:44,A Padaria Portuguesa,-2.5,0,EUR,COMPLETED,458.92
CARD_PAYMENT,Current,2024-12-27 09:35:18,2024-12-28 06:30:44,Gpab Posto De Comb,-40,0,EUR,COMPLETED,418.92
TRANSFER,Current,2024-12-28 08:34:29,2024-12-28 08:34:29,To EUR Savings,-0.5,0,EUR,COMPLETED,418.42
TRANSFER,Current,2024-12-28 10:25:52,2024-12-28 10:25:52,To EUR Savings,-0.62,0,EUR,COMPLETED,417.8
TRANSFER,Current,2024-12-28 10:29:38,2024-12-28 10:29:38,To EUR Savings,-0.72,0,EUR,COMPLETED,417.08
CARD_PAYMENT,Current,2024-12-27 09:55:45,2024-12-28 10:50:17,Auchan,-3.29,0,EUR,COMPLETED,413.79
CARD_PAYMENT,Current,2024-12-27 10:11:01,2024-12-28 10:51:10,Ericeira Surf & Skate,-69,0,EUR,COMPLETED,344.79
CARD_PAYMENT,Current,2024-12-27 15:01:01,2024-12-28 11:14:03,Colorfoto,-105,0,EUR,COMPLETED,239.79
TRANSFER,Current,2024-12-28 11:16:25,2024-12-28 11:16:25,To EUR Savings,-0.01,0,EUR,COMPLETED,239.78
TRANSFER,Current,2024-12-28 12:04:15,2024-12-28 12:04:15,To EUR,1000,0,EUR,COMPLETED,1239.78
TRANSFER,Current,2024-12-29 05:52:01,2024-12-29 05:52:01,To EUR Savings,-0.51,0,EUR,COMPLETED,1239.27
CARD_PAYMENT,Current,2024-12-28 10:17:01,2024-12-29 06:26:10,Maria Guida Abreu,-51.38,0,EUR,COMPLETED,1187.89
CARD_PAYMENT,Current,2024-12-28 10:28:06,2024-12-29 06:26:17,Talho Super Desconto,-51.28,0,EUR,COMPLETED,1136.61
CARD_PAYMENT,Current,2024-12-28 08:34:28,2024-12-29 06:28:39,A Padaria Portuguesa,-2.5,0,EUR,COMPLETED,1134.11
TRANSFER,Current,2024-12-29 08:29:48,2024-12-29 08:29:48,To EUR Savings,-0.28,0,EUR,COMPLETED,1133.83
CARD_PAYMENT,Current,2024-12-26 12:43:55,2024-12-29 08:36:36,Uber Eats,-30.77,0,EUR,COMPLETED,1103.06
CARD_PAYMENT,Current,2024-12-28 11:16:24,2024-12-29 09:02:22,PlayStation,-8.99,0,EUR,COMPLETED,1094.07
CARD_PAYMENT,Current,2024-12-27 23:48:54,2024-12-29 12:25:08,Spitfireaud,-17,0,EUR,COMPLETED,1077.07
TRANSFER,Current,2024-12-30 01:41:29,2024-12-30 01:41:29,To EUR Savings,-20,0,EUR,COMPLETED,1057.07
TRANSFER,Current,2024-12-30 02:53:43,2024-12-30 02:53:43,To EUR Savings,-0.05,0,EUR,COMPLETED,1057.02
TRANSFER,Current,2024-12-30 08:31:45,2024-12-30 08:31:45,To EUR Savings,-0.5,0,EUR,COMPLETED,1056.52
TRANSFER,Current,2024-12-30 09:28:12,2024-12-30 09:28:12,To EUR Savings,-0.84,0,EUR,COMPLETED,1055.68
CARD_PAYMENT,Current,2024-12-29 08:29:47,2024-12-30 09:37:52,Pastelaria Sao Pedro,-5.72,0,EUR,COMPLETED,1049.96
CARD_PAYMENT,Current,2024-12-29 05:52:01,2024-12-30 11:39:00,Apple,-5.49,0,EUR,COMPLETED,1044.47
TRANSFER,Current,2024-12-30 12:46:17,2024-12-30 12:46:17,To EUR Savings,-0.29,0,EUR,COMPLETED,1044.18
TRANSFER,Current,2024-12-30 20:20:23,2024-12-30 20:20:23,To EUR Savings,-0.47,0,EUR,COMPLETED,1043.71
CARD_PAYMENT,Current,2024-12-30 08:31:44,2024-12-31 06:31:36,A Padaria Portuguesa,-2.5,0,EUR,COMPLETED,1041.21
TRANSFER,Current,2024-12-31 08:30:59,2024-12-31 08:30:59,To EUR Savings,-0.5,0,EUR,COMPLETED,1040.71
TRANSFER,Current,2024-12-31 09:23:14,2024-12-31 09:23:14,To EUR Savings,-0.4,0,EUR,COMPLETED,1040.31
CARD_PAYMENT,Current,2024-12-30 12:46:16,2024-12-31 09:56:41,Uber Eats,-17.71,0,EUR,COMPLETED,1022.6
CARD_PAYMENT,Current,2024-12-30 02:53:43,2024-12-31 10:21:03,Apple,-21.95,0,EUR,COMPLETED,1000.65
CARD_PAYMENT,Current,2024-12-30 09:28:11,2024-12-31 11:55:22,Pingo Doce,-87.16,0,EUR,COMPLETED,913.49
TRANSFER,Current,2024-12-31 15:13:40,2024-12-31 15:13:40,To EUR Savings,-1,0,EUR,COMPLETED,912.49
TRANSFER,Current,2025-01-01 01:19:41,2025-01-01 01:19:41,To EUR Rainy day,-50,0,EUR,COMPLETED,862.49
CARD_PAYMENT,Current,2024-12-31 15:13:40,2025-01-01 09:08:05,Palacio Dos Leitoes,-150,0,EUR,COMPLETED,712.49
CARD_PAYMENT,Current,2024-12-31 08:30:59,2025-01-01 09:42:03,A Padaria Portuguesa,-2.5,0,EUR,COMPLETED,709.99
CARD_PAYMENT,Current,2024-12-30 20:20:23,2025-01-01 11:45:26,Uber Eats,-18.53,0,EUR,COMPLETED,691.46
TRANSFER,Current,2025-01-01 13:19:02,2025-01-01 13:19:02,To EUR Savings,-1,0,EUR,COMPLETED,690.46
CARD_PAYMENT,Current,2024-12-31 09:23:13,2025-01-01 14:26:38,Pingo Doce,-25.6,0,EUR,COMPLETED,664.86
CARD_PAYMENT,Current,2025-01-01 13:19:01,2025-01-03 09:08:05,WOO,-5,0,EUR,COMPLETED,659.86
TRANSFER,Current,2025-01-03 12:52:02,2025-01-03 12:52:02,To EUR Savings,-0.23,0,EUR,COMPLETED,659.63
TRANSFER,Current,2025-01-04 08:27:45,2025-01-04 08:27:45,To EUR Savings,-0.5,0,EUR,COMPLETED,659.13
TRANSFER,Current,2025-01-04 09:13:55,2025-01-04 09:13:55,To EUR Savings,-0.35,0,EUR,COMPLETED,658.78
TRANSFER,Current,2025-01-04 09:27:29,2025-01-04 09:27:29,To EUR Savings,-0.41,0,EUR,COMPLETED,658.37
CARD_PAYMENT,Current,2025-01-04 09:27:28,2025-01-05 06:29:30,Talho Super Desconto,-22.59,0,EUR,COMPLETED,635.78
CARD_PAYMENT,Current,2025-01-04 08:27:44,2025-01-05 06:31:47,A Padaria Portuguesa,-2.5,0,EUR,COMPLETED,633.28
CARD_PAYMENT,Current,2025-01-04 09:13:54,2025-01-05 09:47:28,Pingo Doce,-20.65,0,EUR,COMPLETED,612.63
TRANSFER,Current,2025-01-06 01:38:32,2025-01-06 01:38:32,To EUR Savings,-20,0,EUR,COMPLETED,592.63
CARD_PAYMENT,Current,2025-01-03 12:52:02,2025-01-06 10:11:27,Uber Eats,-30.77,0,EUR,COMPLETED,561.86
TRANSFER,Current,2025-01-06 17:09:35,2025-01-06 17:09:35,To EUR Savings,-0.51,0,EUR,COMPLETED,561.35
TRANSFER,Current,2025-01-07 08:33:52,2025-01-07 08:33:52,To EUR Savings,-0.01,0,EUR,COMPLETED,561.34
TRANSFER,Current,2025-01-07 12:32:35,2025-01-07 12:32:35,To EUR Savings,-0.01,0,EUR,COMPLETED,561.33
TRANSFER,Current,2025-01-07 21:30:55,2025-01-07 21:30:55,To EUR Savings,-0.52,0,EUR,COMPLETED,560.81
TRANSFER,Current,2025-01-07 23:27:17,2025-01-07 23:27:17,To EUR Savings,-0.68,0,EUR,COMPLETED,560.13
CARD_PAYMENT,Current,2025-01-06 17:09:35,2025-01-08 11:33:09,PlayStation,-17.49,0,EUR,COMPLETED,542.64
CARD_PAYMENT,Current,2025-01-07 12:32:35,2025-01-08 11:54:47,PlayStation,-19.99,0,EUR,COMPLETED,522.65
CARD_PAYMENT,Current,2025-01-07 08:33:52,2025-01-08 12:02:03,PlayStation,-13.99,0,EUR,COMPLETED,508.66
TRANSFER,Current,2025-01-08 12:06:46,2025-01-08 12:06:46,To EUR Savings,-0.71,0,EUR,COMPLETED,507.95
CARD_PAYMENT,Current,2025-01-07 23:27:17,2025-01-08 12:47:01,Amazon,-20.32,0,EUR,COMPLETED,487.63
TRANSFER,Current,2025-01-08 12:49:43,2025-01-08 12:49:43,To EUR Savings,-0.67,0,EUR,COMPLETED,486.96
TRANSFER,Current,2025-01-09 12:40:16,2025-01-09 12:40:16,To EUR Savings,-0.19,0,EUR,COMPLETED,486.77
TRANSFER,Current,2025-01-09 12:50:44,2025-01-09 12:50:44,To EUR Savings,-0.23,0,EUR,COMPLETED,486.54
CARD_PAYMENT,Current,2025-01-08 12:06:46,2025-01-09 15:20:29,Uber Eats,-13.29,0,EUR,COMPLETED,473.25
TRANSFER,Current,2025-01-10 00:41:47,2025-01-10 00:41:47,To EUR Savings,-0.01,0,EUR,COMPLETED,473.24
TRANSFER,Current,2025-01-10 08:37:26,2025-01-10 08:37:26,To EUR,400,0,EUR,COMPLETED,873.24
CARD_PAYMENT,Current,2025-01-07 21:30:55,2025-01-10 12:58:57,Uber Eats,-23.48,0,EUR,COMPLETED,849.76
TRANSFER,Current,2025-01-11 07:49:44,2025-01-11 07:49:44,To EUR Savings,-0.5,0,EUR,COMPLETED,849.26
TRANSFER,Current,2025-01-11 08:19:53,2025-01-11 08:19:53,To EUR Savings,-0.66,0,EUR,COMPLETED,848.6
CARD_PAYMENT,Current,2025-01-08 12:49:43,2025-01-11 10:45:59,Uber Eats,-26.33,0,EUR,COMPLETED,822.27
TRANSFER,Current,2025-01-11 11:04:15,2025-01-11 11:04:15,To EUR Savings,-0.75,0,EUR,COMPLETED,821.52
CARD_PAYMENT,Current,2025-01-10 00:41:47,2025-01-11 11:48:55,Bimotordj,-201.99,0,EUR,COMPLETED,619.53
CARD_PAYMENT,Current,2025-01-09 12:40:16,2025-01-11 15:55:46,GitHub,-8.81,0,EUR,COMPLETED,610.72
CARD_PAYMENT,Current,2025-01-11 11:04:15,2025-01-12 06:52:09,Burguezia Leitao,-5.25,0,EUR,COMPLETED,605.47
CARD_PAYMENT,Current,2025-01-11 07:49:43,2025-01-12 07:34:33,A Padaria Portuguesa,-2.5,0,EUR,COMPLETED,602.97
CARD_PAYMENT,Current,2025-01-09 12:50:43,2025-01-12 09:11:42,Uber Eats,-30.77,0,EUR,COMPLETED,572.2
TRANSFER,Current,2025-01-12 09:54:26,2025-01-12 09:54:26,To EUR Savings,-0.6,0,EUR,COMPLETED,571.6
TRANSFER,Current,2025-01-12 10:38:46,2025-01-12 10:38:46,To EUR Savings,-0.21,0,EUR,COMPLETED,571.39
TRANSFER,Current,2025-01-12 11:16:52,2025-01-12 11:16:52,To EUR Savings,-1,0,EUR,COMPLETED,570.39
CARD_PAYMENT,Current,2025-01-11 08:19:53,2025-01-12 11:27:58,Pingo Doce,-14.34,0,EUR,COMPLETED,556.05
TRANSFER,Current,2025-01-12 17:58:37,2025-01-12 17:58:37,To EUR Savings,-0.15,0,EUR,COMPLETED,555.9
TRANSFER,Current,2025-01-13 01:39:29,2025-01-13 01:39:29,To EUR Savings,-20,0,EUR,COMPLETED,535.9
CARD_PAYMENT,Current,2025-01-12 17:58:37,2025-01-13 05:50:01,Burguezia Leitao,-5.85,0,EUR,COMPLETED,530.05
CARD_PAYMENT,Current,2025-01-12 09:54:25,2025-01-13 05:54:04,Confeitaria Lailai,-3.4,0,EUR,COMPLETED,526.65
CARD_PAYMENT,Current,2025-01-12 10:38:45,2025-01-13 06:29:11,Lidl,-3.79,0,EUR,COMPLETED,522.86
TRANSFER,Current,2025-01-13 09:15:14,2025-01-13 09:15:14,To EUR Savings,-0.22,0,EUR,COMPLETED,522.64
CARD_PAYMENT,Current,2025-01-12 11:16:52,2025-01-13 09:15:43,Miió,-30,0,EUR,COMPLETED,492.64
CARD_PAYMENT,Current,2025-01-13 09:15:14,2025-01-14 10:03:20,Infcompanya,-21.78,0,EUR,COMPLETED,470.86
TRANSFER,Current,2025-01-14 11:49:34,2025-01-14 11:49:34,To EUR Savings,-0.81,0,EUR,COMPLETED,470.05
CARD_PAYMENT,Current,2025-01-14 11:49:34,2025-01-15 11:32:45,Amazon,-12.19,0,EUR,COMPLETED,457.86
TRANSFER,Current,2025-01-16 12:20:13,2025-01-16 12:20:13,To EUR Savings,-0.23,0,EUR,COMPLETED,457.63
TRANSFER,Current,2025-01-17 12:34:07,2025-01-17 12:34:07,To EUR Savings,-0.69,0,EUR,COMPLETED,456.94
TRANSFER,Current,2025-01-18 08:29:03,2025-01-18 08:29:03,To EUR Savings,-0.75,0,EUR,COMPLETED,456.19
TRANSFER,Current,2025-01-18 09:17:31,2025-01-18 09:17:31,To EUR Savings,-0.97,0,EUR,COMPLETED,455.22
TOPUP,Current,2025-01-18 09:52:29,2025-01-18 09:52:30,Apple Pay Top-Up by *0264,1400,0,EUR,COMPLETED,1855.22
TRANSFER,Current,2025-01-18 09:52:52,2025-01-18 09:52:52,To EUR Rainy day,-1400,0,EUR,COMPLETED,455.22
TRANSFER,Current,2025-01-18 09:58:24,2025-01-18 09:58:24,To EUR Savings,-0.09,0,EUR,COMPLETED,455.13
TRANSFER,Current,2025-01-18 10:16:39,2025-01-18 10:16:39,To EUR Savings,-0.23,0,EUR,COMPLETED,454.9
TRANSFER,Current,2025-01-18 15:37:12,2025-01-18 15:37:12,To EUR Savings,-0.48,0,EUR,COMPLETED,454.42
CARD_PAYMENT,Current,2025-01-18 08:29:02,2025-01-19 05:38:07,Paoloma,-3.25,0,EUR,COMPLETED,451.17
CARD_PAYMENT,Current,2025-01-18 09:58:24,2025-01-19 06:16:25,Talho Super Desconto,-46.91,0,EUR,COMPLETED,404.26
TRANSFER,Current,2025-01-19 08:42:08,2025-01-19 08:42:08,To EUR Savings,-0.5,0,EUR,COMPLETED,403.76
CARD_PAYMENT,Current,2025-01-18 15:37:11,2025-01-19 09:54:15,Auchan,-55.52,0,EUR,COMPLETED,348.24
CARD_PAYMENT,Current,2025-01-18 09:17:31,2025-01-19 09:54:28,Pingo Doce,-44.03,0,EUR,COMPLETED,304.21
TRANSFER,Current,2025-01-19 11:46:28,2025-01-19 11:46:28,To EUR Savings,-0.97,0,EUR,COMPLETED,303.24
TRANSFER,Current,2025-01-19 12:17:35,2025-01-19 12:17:35,To EUR Savings,-0.14,0,EUR,COMPLETED,303.1
CARD_PAYMENT,Current,2025-01-16 12:20:13,2025-01-19 12:34:58,Uber Eats,-30.77,0,EUR,COMPLETED,272.33
CARD_PAYMENT,Current,2025-01-18 10:16:39,2025-01-19 15:10:35,Supermaven,-9.77,0.1,EUR,COMPLETED,262.46
TRANSFER,Current,2025-01-20 01:45:24,2025-01-20 01:45:24,To EUR Savings,-20,0,EUR,COMPLETED,242.46
CARD_PAYMENT,Current,2025-01-19 12:17:34,2025-01-20 05:59:06,Minipreço,-7.86,0,EUR,COMPLETED,234.6
CARD_PAYMENT,Current,2025-01-19 08:42:07,2025-01-20 06:36:55,A Padaria Portuguesa,-2.5,0,EUR,COMPLETED,232.1
CARD_PAYMENT,Current,2025-01-17 12:34:07,2025-01-20 09:00:54,Uber Eats,-35.31,0,EUR,COMPLETED,196.79
TRANSFER,Current,2025-01-20 12:10:03,2025-01-20 12:10:03,To EUR Savings,-0.01,0,EUR,COMPLETED,196.78
CARD_PAYMENT,Current,2025-01-19 11:46:28,2025-01-20 15:03:54,OpenAI,-24.03,0.24,EUR,COMPLETED,172.51
CARD_PAYMENT,Current,2025-01-20 12:10:03,2025-01-21 09:54:33,Uber,-4.99,0,EUR,COMPLETED,167.52
TOPUP,Current,2025-01-21 13:50:40,2025-01-21 13:50:41,Apple Pay Top-Up by *0264,300,0,EUR,COMPLETED,467.52
TRANSFER,Current,2025-01-23 08:12:26,2025-01-23 08:12:26,To EUR Savings,-0.01,0,EUR,COMPLETED,467.51
TRANSFER,Current,2025-01-23 13:04:05,2025-01-23 13:04:05,To EUR Savings,-0.99,0,EUR,COMPLETED,466.52
CARD_PAYMENT,Current,2025-01-23 08:12:26,2025-01-24 14:39:38,YouTube,-17.99,0,EUR,COMPLETED,448.53
TRANSFER,Current,2025-01-25 08:14:06,2025-01-25 08:14:06,To EUR Savings,-0.5,0,EUR,COMPLETED,448.03
TRANSFER,Current,2025-01-25 08:56:43,2025-01-25 08:56:43,To EUR Savings,-0.55,0,EUR,COMPLETED,447.48
TRANSFER,Current,2025-01-25 12:37:46,2025-01-25 12:37:46,To EUR Savings,-0.82,0,EUR,COMPLETED,446.66
CARD_PAYMENT,Current,2025-01-25 08:14:05,2025-01-26 06:36:09,A Padaria Portuguesa,-2.5,0,EUR,COMPLETED,444.16
CARD_PAYMENT,Current,2025-01-25 08:56:42,2025-01-26 09:52:08,Pingo Doce,-40.45,0,EUR,COMPLETED,403.71
CARD_PAYMENT,Current,2025-01-23 13:04:05,2025-01-26 10:22:58,Uber Eats,-41.01,0,EUR,COMPLETED,362.7
TRANSFER,Current,2025-01-27 01:37:09,2025-01-27 01:37:09,To EUR Savings,-20,0,EUR,COMPLETED,342.7
CARD_PAYMENT,Current,2025-01-25 12:37:46,2025-01-28 09:33:35,Uber Eats,-23.18,0,EUR,COMPLETED,319.52
TRANSFER,Current,2025-01-28 11:16:10,2025-01-28 11:16:10,To EUR Savings,-0.01,0,EUR,COMPLETED,319.51
TRANSFER,Current,2025-01-29 05:52:17,2025-01-29 05:52:17,To EUR Savings,-0.51,0,EUR,COMPLETED,319
CARD_PAYMENT,Current,2025-01-28 11:16:10,2025-01-29 10:59:18,PlayStation,-8.99,0,EUR,COMPLETED,310.01
TRANSFER,Current,2025-01-29 22:24:25,2025-01-29 22:24:25,To EUR Savings,-0.23,0,EUR,COMPLETED,309.78
TRANSFER,Current,2025-01-30 02:53:46,2025-01-30 02:53:46,To EUR Savings,-0.05,0,EUR,COMPLETED,309.73
CARD_PAYMENT,Current,2025-01-29 05:52:17,2025-01-30 11:33:13,Apple,-5.49,0,EUR,COMPLETED,304.24
TRANSFER,Current,2025-01-30 12:47:11,2025-01-30 12:47:11,To EUR Savings,-0.23,0,EUR,COMPLETED,304.01
CARD_PAYMENT,Current,2025-01-30 02:53:46,2025-01-31 10:43:26,Apple,-21.95,0,EUR,COMPLETED,282.06
CARD_PAYMENT,Current,2025-01-29 22:24:25,2025-01-31 16:50:09,zooplus,-71.77,0,EUR,COMPLETED,210.29
TRANSFER,Current,2025-02-01 01:11:49,2025-02-01 01:11:49,To EUR Rainy day,-50,0,EUR,COMPLETED,160.29
TRANSFER,Current,2025-02-01 08:34:42,2025-02-01 08:34:42,To EUR Savings,-0.5,0,EUR,COMPLETED,159.79
TRANSFER,Current,2025-02-01 09:26:06,2025-02-01 09:26:06,To EUR Savings,-0.03,0,EUR,COMPLETED,159.76
CARD_PAYMENT,Current,2025-02-01 08:34:42,2025-02-02 05:52:19,A Padaria Portuguesa,-2.5,0,EUR,COMPLETED,157.26
TRANSFER,Current,2025-02-02 08:35:26,2025-02-02 08:35:26,To EUR Savings,-0.5,0,EUR,COMPLETED,156.76
CARD_PAYMENT,Current,2025-01-30 12:47:10,2025-02-02 08:45:29,Uber Eats,-30.77,0,EUR,COMPLETED,125.99
TRANSFER,Current,2025-02-02 08:59:15,2025-02-02 08:59:15,To EUR Savings,-1,0,EUR,COMPLETED,124.99
TOPUP,Current,2025-02-02 08:59:46,2025-02-02 08:59:47,Apple Pay Top-Up by *0264,400,0,EUR,COMPLETED,524.99
CARD_PAYMENT,Current,2025-02-01 09:26:05,2025-02-02 13:31:00,Pingo Doce,-58.97,0,EUR,COMPLETED,466.02
TRANSFER,Current,2025-02-03 01:42:28,2025-02-03 01:42:28,To EUR Savings,-20,0,EUR,COMPLETED,446.02
CARD_PAYMENT,Current,2025-02-02 08:35:26,2025-02-03 06:17:19,A Padaria Portuguesa,-2.5,0,EUR,COMPLETED,443.52
CARD_PAYMENT,Current,2025-02-02 08:59:15,2025-02-03 12:04:45,Spitfire Audio,-44,0,EUR,COMPLETED,399.52
TRANSFER,Current,2025-02-07 00:05:56,2025-02-07 00:05:56,To EUR Savings,-0.32,0,EUR,COMPLETED,399.2
TRANSFER,Current,2025-02-07 12:04:56,2025-02-07 12:04:56,To EUR Savings,-0.23,0,EUR,COMPLETED,398.97
TRANSFER,Current,2025-02-08 08:25:20,2025-02-08 08:25:20,To EUR Savings,-0.5,0,EUR,COMPLETED,398.47
TRANSFER,Current,2025-02-08 09:09:23,2025-02-08 09:09:23,To EUR Savings,-1,0,EUR,COMPLETED,397.47
TRANSFER,Current,2025-02-08 09:40:32,2025-02-08 09:40:32,To EUR Savings,-0.42,0,EUR,COMPLETED,397.05
TRANSFER,Current,2025-02-08 09:51:59,2025-02-08 09:51:59,To EUR Savings,-0.84,0,EUR,COMPLETED,396.21
TRANSFER,Current,2025-02-08 10:11:11,2025-02-08 10:11:11,To EUR Savings,-0.49,0,EUR,COMPLETED,395.72
TRANSFER,Current,2025-02-08 12:27:32,2025-02-08 12:27:32,To EUR Savings,-0.29,0,EUR,COMPLETED,395.43
CARD_PAYMENT,Current,2025-02-08 08:25:19,2025-02-09 05:30:58,A Padaria Portuguesa,-2.5,0,EUR,COMPLETED,392.93
TRANSFER,Current,2025-02-09 08:16:50,2025-02-09 08:16:50,To EUR Savings,-0.5,0,EUR,COMPLETED,392.43
CARD_PAYMENT,Current,2025-02-08 12:27:31,2025-02-09 09:40:43,Uber Eats,-17.71,0,EUR,COMPLETED,374.72
CARD_PAYMENT,Current,2025-02-07 00:05:56,2025-02-09 13:01:37,GitHub,-9.68,0,EUR,COMPLETED,365.04
CARD_PAYMENT,Current,2025-02-08 09:09:22,2025-02-09 14:11:46,Pingo Doce,-33,0,EUR,COMPLETED,332.04
TRANSFER,Current,2025-02-10 01:42:09,2025-02-10 01:42:09,To EUR Savings,-20,0,EUR,COMPLETED,312.04
CARD_PAYMENT,Current,2025-02-09 08:16:49,2025-02-10 05:34:03,A Padaria Portuguesa,-2.5,0,EUR,COMPLETED,309.54
CARD_PAYMENT,Current,2025-02-08 09:40:31,2025-02-10 10:14:23,Amazon,-10.58,0,EUR,COMPLETED,298.96
CARD_PAYMENT,Current,2025-02-08 09:51:59,2025-02-10 10:14:24,Amazon,-10.16,0,EUR,COMPLETED,288.8
CARD_PAYMENT,Current,2025-02-08 10:11:11,2025-02-10 10:14:28,Amazon,-32.51,0,EUR,COMPLETED,256.29
CARD_PAYMENT,Current,2025-02-07 12:04:56,2025-02-10 10:22:49,Uber Eats,-30.77,0,EUR,COMPLETED,225.52
TOPUP,Current,2025-02-11 15:16:20,2025-02-11 15:16:21,Apple Pay Top-Up by *0264,400,0,EUR,COMPLETED,625.52
TRANSFER,Current,2025-02-11 15:16:31,2025-02-11 15:16:31,To EUR Savings,-0.21,0,EUR,COMPLETED,625.31
TRANSFER,Current,2025-02-13 12:59:15,2025-02-13 12:59:15,To EUR Savings,-0.23,0,EUR,COMPLETED,625.08
CARD_PAYMENT,Current,2025-02-11 15:16:31,2025-02-14 09:43:35,Benqeuropeb,-171.79,0,EUR,COMPLETED,453.29
TOPUP,Current,2025-02-14 16:46:55,2025-02-14 16:46:56,Apple Pay Top-Up by *0264,400,0,EUR,COMPLETED,853.29
TRANSFER,Current,2025-02-14 17:06:05,2025-02-14 17:06:05,To EUR Savings,-0.02,0,EUR,COMPLETED,853.27
TRANSFER,Current,2025-02-14 23:39:54,2025-02-14 23:39:54,To EUR Savings,-0.53,0,EUR,COMPLETED,852.74
TRANSFER,Current,2025-02-15 07:54:48,2025-02-15 07:54:48,To EUR Savings,-0.5,0,EUR,COMPLETED,852.24
TRANSFER,Current,2025-02-15 08:29:53,2025-02-15 08:29:53,To EUR Savings,-0.42,0,EUR,COMPLETED,851.82
TRANSFER,Current,2025-02-16 08:43:36,2025-02-16 08:43:36,To EUR Savings,-0.5,0,EUR,COMPLETED,851.32
CARD_PAYMENT,Current,2025-02-15 07:54:48,2025-02-16 10:12:38,A Padaria Portuguesa,-2.5,0,EUR,COMPLETED,848.82
CARD_PAYMENT,Current,2025-02-14 17:06:05,2025-02-16 10:30:07,Guillemot,-79.98,0,EUR,COMPLETED,768.84
CARD_PAYMENT,Current,2025-02-13 12:59:15,2025-02-16 10:47:39,Uber Eats,-30.77,0,EUR,COMPLETED,738.07
TRANSFER,Current,2025-02-16 13:18:20,2025-02-16 13:18:20,To EUR Savings,-0.56,0,EUR,COMPLETED,737.51
TRANSFER,Current,2025-02-16 13:47:03,2025-02-16 13:47:03,To EUR Savings,-0.1,0,EUR,COMPLETED,737.41
CARD_PAYMENT,Current,2025-02-15 08:29:53,2025-02-16 15:10:55,Pingo Doce,-30.58,0,EUR,COMPLETED,706.83
TRANSFER,Current,2025-02-17 01:39:31,2025-02-17 01:39:31,To EUR Savings,-20,0,EUR,COMPLETED,686.83
CARD_PAYMENT,Current,2025-02-16 13:47:02,2025-02-17 04:58:05,L.o.h.a.d.,-24.9,0,EUR,COMPLETED,661.93
CARD_PAYMENT,Current,2025-02-16 08:43:35,2025-02-17 05:06:12,A Padaria Portuguesa,-2.5,0,EUR,COMPLETED,659.43
CARD_PAYMENT,Current,2025-02-16 13:18:19,2025-02-17 10:05:57,Rest Ramen Joe,-131.44,0,EUR,COMPLETED,527.99
CARD_PAYMENT,Current,2025-02-14 23:39:53,2025-02-17 10:17:36,Alipay,-4.47,0,EUR,COMPLETED,523.52
TRANSFER,Current,2025-02-18 16:34:19,2025-02-18 16:34:19,To EUR Savings,-0.94,0,EUR,COMPLETED,522.58
TRANSFER,Current,2025-02-18 18:52:44,2025-02-18 18:52:44,To EUR Savings,-0.01,0,EUR,COMPLETED,522.57
CARD_PAYMENT,Current,2025-02-18 16:34:18,2025-02-19 09:16:26,Amazon,-25.06,0,EUR,COMPLETED,497.51
CARD_PAYMENT,Current,2025-02-18 18:52:44,2025-02-19 09:58:43,Amazon,-10.99,0,EUR,COMPLETED,486.52
TRANSFER,Current,2025-02-19 11:46:09,2025-02-19 11:46:09,To EUR Savings,-0.28,0,EUR,COMPLETED,486.24
TRANSFER,Current,2025-02-20 12:10:02,2025-02-20 12:10:02,To EUR Savings,-0.01,0,EUR,COMPLETED,486.23
TRANSFER,Current,2025-02-20 12:54:14,2025-02-20 12:54:14,To EUR Savings,-0.69,0,EUR,COMPLETED,485.54
CARD_PAYMENT,Current,2025-02-19 11:46:08,2025-02-20 13:46:45,OpenAI,-23.72,0,EUR,COMPLETED,461.82
CARD_PAYMENT,Current,2025-02-20 12:10:02,2025-02-21 12:54:16,Uber,-4.99,0,EUR,COMPLETED,456.83
CARD_PAYMENT,Current,2025-02-20 12:54:13,2025-02-21 12:57:44,Uber Eats,-24.31,0,EUR,COMPLETED,432.52
TRANSFER,Current,2025-02-22 08:34:35,2025-02-22 08:34:35,To EUR Savings,-0.5,0,EUR,COMPLETED,432.02
TRANSFER,Current,2025-02-22 09:31:43,2025-02-22 09:31:43,To EUR Savings,-0.73,0,EUR,COMPLETED,431.29
TRANSFER,Current,2025-02-22 10:09:31,2025-02-22 10:09:31,To EUR Savings,-0.49,0,EUR,COMPLETED,430.8
TRANSFER,Current,2025-02-23 08:12:26,2025-02-23 08:12:26,To EUR Savings,-0.01,0,EUR,COMPLETED,430.79
TRANSFER,Current,2025-02-23 08:33:48,2025-02-23 08:33:48,To EUR Savings,-0.5,0,EUR,COMPLETED,430.29
CARD_PAYMENT,Current,2025-02-22 10:09:30,2025-02-23 11:45:00,Talho Super Desconto,-43.51,0,EUR,COMPLETED,386.78
CARD_PAYMENT,Current,2025-02-22 08:34:34,2025-02-23 11:46:01,A Padaria Portuguesa,-2.5,0,EUR,COMPLETED,384.28
CARD_PAYMENT,Current,2025-02-22 09:31:42,2025-02-23 11:59:08,Pingo Doce,-42.27,0,EUR,COMPLETED,342.01
TRANSFER,Current,2025-02-23 15:34:56,2025-02-23 15:34:56,To EUR Savings,-0.4,0,EUR,COMPLETED,341.61
TRANSFER,Current,2025-02-23 16:49:41,2025-02-23 16:49:41,To EUR Savings,-0.9,0,EUR,COMPLETED,340.71
TRANSFER,Current,2025-02-24 01:34:18,2025-02-24 01:34:18,To EUR Savings,-20,0,EUR,COMPLETED,320.71
CARD_PAYMENT,Current,2025-02-23 16:49:41,2025-02-24 05:30:04,Cipta Ii,-14.1,0,EUR,COMPLETED,306.61
CARD_PAYMENT,Current,2025-02-23 15:34:55,2025-02-24 05:37:21,Apribeiro,-96.6,0,EUR,COMPLETED,210.01
CARD_PAYMENT,Current,2025-02-23 08:33:48,2025-02-24 05:38:34,A Padaria Portuguesa,-2.5,0,EUR,COMPLETED,207.51
CARD_PAYMENT,Current,2025-02-23 08:12:26,2025-02-24 12:54:38,YouTube,-17.99,0,EUR,COMPLETED,189.52
TRANSFER,Current,2025-02-25 19:45:40,2025-02-25 19:45:40,To EUR Savings,-0.08,0,EUR,COMPLETED,189.44
TRANSFER,Current,2025-02-25 19:46:18,2025-02-25 19:46:18,To EUR Savings,-0.78,0,EUR,COMPLETED,188.66
TOPUP,Current,2025-02-25 20:23:35,2025-02-25 20:23:37,Apple Pay Top-Up by *0264,300,0,EUR,COMPLETED,488.66
TRANSFER,Current,2025-02-26 18:27:18,2025-02-26 18:27:18,To EUR Savings,-0.53,0,EUR,COMPLETED,488.13
CARD_PAYMENT,Current,2025-02-26 18:27:17,2025-02-27 05:10:36,Continente,-40.47,0,EUR,COMPLETED,447.66
CARD_PAYMENT,Current,2025-02-25 19:45:40,2025-02-27 10:53:07,Uber Eats,-16.92,0,EUR,COMPLETED,430.74
CARD_PAYMENT,Current,2025-02-25 19:46:18,2025-02-27 10:56:04,Uber Eats,-14.22,0,EUR,COMPLETED,416.52
TRANSFER,Current,2025-02-28 02:53:46,2025-02-28 02:53:46,To EUR Savings,-0.05,0,EUR,COMPLETED,416.47
TRANSFER,Current,2025-02-28 05:54:20,2025-02-28 05:54:20,To EUR Savings,-0.51,0,EUR,COMPLETED,415.96
TRANSFER,Current,2025-02-28 11:16:10,2025-02-28 11:16:10,To EUR Savings,-0.01,0,EUR,COMPLETED,415.95
TRANSFER,Current,2025-02-28 12:17:00,2025-02-28 12:17:00,To EUR Savings,-0.23,0,EUR,COMPLETED,415.72
TRANSFER,Current,2025-02-28 18:07:02,2025-02-28 18:07:02,To EUR Savings,-0.17,0,EUR,COMPLETED,415.55
TRANSFER,Current,2025-02-28 22:40:57,2025-02-28 22:40:57,To EUR Savings,-0.7,0,EUR,COMPLETED,414.85
TOPUP,Current,2025-02-28 22:42:06,2025-02-28 22:42:08,Apple Pay Top-Up by *0264,300,0,EUR,COMPLETED,714.85
TRANSFER,Current,2025-03-01 01:11:45,2025-03-01 01:11:45,To EUR Rainy day,-50,0,EUR,COMPLETED,664.85
TRANSFER,Current,2025-03-01 08:25:39,2025-03-01 08:25:39,To EUR Savings,-0.5,0,EUR,COMPLETED,664.35
CARD_PAYMENT,Current,2025-02-28 05:54:20,2025-03-01 08:54:48,Apple,-5.49,0,EUR,COMPLETED,658.86
CARD_PAYMENT,Current,2025-02-28 11:16:10,2025-03-01 08:58:04,PlayStation,-8.99,0,EUR,COMPLETED,649.87
TRANSFER,Current,2025-03-01 09:07:07,2025-03-01 09:07:07,To EUR Savings,-0.04,0,EUR,COMPLETED,649.83
CARD_PAYMENT,Current,2025-02-28 02:53:46,2025-03-01 10:04:33,Apple,-21.95,0,EUR,COMPLETED,627.88
TRANSFER,Current,2025-03-01 12:57:15,2025-03-01 12:57:15,To EUR Savings,-0.71,0,EUR,COMPLETED,627.17
CARD_PAYMENT,Current,2025-02-28 18:07:02,2025-03-01 14:27:25,Codeium,-17.83,0,EUR,COMPLETED,609.34
TRANSFER,Current,2025-03-02 07:48:49,2025-03-02 07:48:49,To EUR Savings,-0.5,0,EUR,COMPLETED,608.84
TOPUP,Current,2025-03-02 07:49:13,2025-03-02 07:49:14,Apple Pay Top-Up by *0264,200,0,EUR,COMPLETED,808.84
CARD_PAYMENT,Current,2025-03-01 12:57:15,2025-03-02 08:40:41,Uber Eats,-13.29,0,EUR,COMPLETED,795.55
CARD_PAYMENT,Current,2025-03-01 09:07:07,2025-03-02 15:36:21,Pingo Doce,-32.96,0,EUR,COMPLETED,762.59
CARD_PAYMENT,Current,2025-02-28 22:40:56,2025-03-02 15:39:25,Cataplana D Ideias,-285.3,0,EUR,COMPLETED,477.29
CARD_PAYMENT,Current,2025-03-01 08:25:38,2025-03-02 15:44:40,A Padaria Portuguesa,-2.5,0,EUR,COMPLETED,474.79
TRANSFER,Current,2025-03-02 21:33:05,2025-03-02 21:33:05,To EUR Savings,-0.5,0,EUR,COMPLETED,474.29
TRANSFER,Current,2025-03-03 01:41:58,2025-03-03 01:41:58,To EUR Savings,-20,0,EUR,COMPLETED,454.29
CARD_PAYMENT,Current,2025-03-02 07:48:48,2025-03-03 05:26:19,A Padaria Portuguesa,-2.5,0,EUR,COMPLETED,451.79
CARD_PAYMENT,Current,2025-02-28 12:17:00,2025-03-03 10:55:31,Uber Eats,-30.77,0,EUR,COMPLETED,421.02
CARD_PAYMENT,Current,2025-03-02 21:33:04,2025-03-04 11:24:58,Casa Sandes Cozido,-8.5,0,EUR,COMPLETED,412.52
TRANSFER,Current,2025-03-04 12:40:20,2025-03-04 12:40:20,To EUR Savings,-0.69,0,EUR,COMPLETED,411.83
TRANSFER,Current,2025-03-06 12:14:12,2025-03-06 12:14:12,To EUR Savings,-0.23,0,EUR,COMPLETED,411.6
TRANSFER,Current,2025-03-06 15:19:41,2025-03-06 15:19:41,To EUR Savings,-0.29,0,EUR,COMPLETED,411.31
TRANSFER,Current,2025-03-06 18:06:21,2025-03-06 18:06:21,To EUR Savings,-0.69,0,EUR,COMPLETED,410.62
CARD_PAYMENT,Current,2025-03-06 15:19:41,2025-03-07 13:06:22,CLAUDE,-5.71,0,EUR,COMPLETED,404.91
CARD_PAYMENT,Current,2025-03-04 12:40:19,2025-03-07 15:23:46,Uber Eats,-35.31,0,EUR,COMPLETED,369.6
CARD_PAYMENT,Current,2025-03-06 18:06:21,2025-03-08 16:10:11,GitHub,-9.31,0,EUR,COMPLETED,360.29
TRANSFER,Current,2025-03-08 23:44:40,2025-03-08 23:44:40,To EUR Savings,-0.01,0,EUR,COMPLETED,360.28
TRANSFER,Current,2025-03-09 08:49:01,2025-03-09 08:49:01,To EUR Savings,-0.5,0,EUR,COMPLETED,359.78
TRANSFER,Current,2025-03-09 09:33:08,2025-03-09 09:33:08,To EUR Savings,-0.01,0,EUR,COMPLETED,359.77
CARD_PAYMENT,Current,2025-03-06 12:14:11,2025-03-09 12:40:04,Uber Eats,-30.77,0,EUR,COMPLETED,329
TRANSFER,Current,2025-03-09 14:18:10,2025-03-09 14:18:10,To EUR Savings,-0.7,0,EUR,COMPLETED,328.3
TRANSFER,Current,2025-03-09 20:47:20,2025-03-09 20:47:20,To EUR Savings,-0.5,0,EUR,COMPLETED,327.8
TRANSFER,Current,2025-03-10 01:36:34,2025-03-10 01:36:34,To EUR Savings,-20,0,EUR,COMPLETED,307.8
CARD_PAYMENT,Current,2025-03-09 14:18:09,2025-03-10 03:55:32,Cafe Rest Beira Rio,-31.3,0,EUR,COMPLETED,276.5
CARD_PAYMENT,Current,2025-03-09 08:49:00,2025-03-10 04:04:23,A Padaria Portuguesa,-2.5,0,EUR,COMPLETED,274
TRANSFER,Current,2025-03-10 09:47:11,2025-03-10 09:47:11,To EUR Savings,-0.25,0,EUR,COMPLETED,273.75
CARD_PAYMENT,Current,2025-03-09 09:33:07,2025-03-10 10:35:04,Pingo Doce,-37.99,0,EUR,COMPLETED,235.76
CARD_PAYMENT,Current,2025-03-08 23:44:40,2025-03-10 11:06:55,Apple,-8.99,0,EUR,COMPLETED,226.77
TRANSFER,Current,2025-03-10 13:12:59,2025-03-10 13:12:59,To EUR Savings,-1,0,EUR,COMPLETED,225.77
TRANSFER,Current,2025-03-11 03:10:34,2025-03-11 03:10:34,To EUR Savings,-1,0,EUR,COMPLETED,224.77
CARD_PAYMENT,Current,2025-03-09 20:47:19,2025-03-11 04:01:19,Isabel Bandeira,-14.5,0,EUR,COMPLETED,210.27
CARD_PAYMENT,Current,2025-03-10 09:47:10,2025-03-11 04:02:09,C C Pombalinho,-7.75,0,EUR,COMPLETED,202.52
CARD_PAYMENT,Current,2025-03-10 13:12:58,2025-03-11 04:13:38,Pizzaria Rest Grill,-21,0,EUR,COMPLETED,181.52
CARD_PAYMENT,Current,2025-03-11 03:10:34,2025-03-11 09:44:56,Miió,-20,0,EUR,COMPLETED,161.52
TOPUP,Current,2025-03-12 22:51:43,2025-03-12 22:51:44,Apple Pay Top-Up by *0264,200,0,EUR,COMPLETED,361.52
TRANSFER,Current,2025-03-13 12:07:58,2025-03-13 12:07:58,To EUR Savings,-0.23,0,EUR,COMPLETED,361.29
TRANSFER,Current,2025-03-13 20:24:30,2025-03-13 20:24:30,To EUR Savings,-0.01,0,EUR,COMPLETED,361.28
TRANSFER,Current,2025-03-14 19:34:49,2025-03-14 19:34:49,To EUR Savings,-0.99,0,EUR,COMPLETED,360.29
TRANSFER,Current,2025-03-14 20:51:30,2025-03-14 20:51:30,To EUR Savings,-0.03,0,EUR,COMPLETED,360.26
TRANSFER,Current,2025-03-15 07:57:17,2025-03-15 07:57:17,To EUR Savings,-0.5,0,EUR,COMPLETED,359.76
TRANSFER,Current,2025-03-15 09:11:51,2025-03-15 09:11:51,To EUR Savings,-0.43,0,EUR,COMPLETED,359.33
TRANSFER,Current,2025-03-15 09:26:59,2025-03-15 09:26:59,To EUR Savings,-0.07,0,EUR,COMPLETED,359.26
TRANSFER,Current,2025-03-15 09:50:27,2025-03-15 09:50:27,To EUR Savings,-0.37,0,EUR,COMPLETED,358.89
TRANSFER,Current,2025-03-15 10:29:52,2025-03-15 10:29:52,To EUR Savings,-0.85,0,EUR,COMPLETED,358.04
TOPUP,Current,2025-03-15 10:30:51,2025-03-15 10:30:52,Apple Pay Top-Up by *0264,400,0,EUR,COMPLETED,758.04
CARD_PAYMENT,Current,2025-03-13 20:24:30,2025-03-15 16:37:34,PlayStation,-9.99,0,EUR,COMPLETED,748.05
CARD_PAYMENT,Current,2025-03-15 10:29:51,2025-03-16 09:12:15,Talho Super Desconto,-50.15,0,EUR,COMPLETED,697.9
CARD_PAYMENT,Current,2025-03-15 07:57:16,2025-03-16 09:12:41,A Padaria Portuguesa,-2.5,0,EUR,COMPLETED,695.4
CARD_PAYMENT,Current,2025-03-15 09:26:59,2025-03-16 15:16:49,Auchan,-60.93,0,EUR,COMPLETED,634.47
CARD_PAYMENT,Current,2025-03-15 09:50:26,2025-03-16 15:16:51,Pingo Doce,-39.63,0,EUR,COMPLETED,594.84
CARD_PAYMENT,Current,2025-03-15 09:11:51,2025-03-16 15:16:57,Leroy Merlin,-26.57,0,EUR,COMPLETED,568.27
CARD_PAYMENT,Current,2025-03-14 19:34:49,2025-03-16 15:37:19,Uber Eats,-41.01,0,EUR,COMPLETED,527.26
CARD_PAYMENT,Current,2025-03-13 12:07:58,2025-03-16 15:42:43,Uber Eats,-30.77,0,EUR,COMPLETED,496.49
CARD_PAYMENT,Current,2025-03-14 20:51:30,2025-03-16 15:44:21,Uber Eats,-3.97,0,EUR,COMPLETED,492.52
TRANSFER,Current,2025-03-17 01:47:52,2025-03-17 01:47:52,To EUR Savings,-20,0,EUR,COMPLETED,472.52
TRANSFER,Current,2025-03-19 11:45:49,2025-03-19 11:45:49,To EUR Savings,-0.34,0,EUR,COMPLETED,472.18
TRANSFER,Current,2025-03-20 12:06:39,2025-03-20 12:06:39,To EUR Savings,-0.23,0,EUR,COMPLETED,471.95
TRANSFER,Current,2025-03-20 12:10:03,2025-03-20 12:10:03,To EUR Savings,-0.01,0,EUR,COMPLETED,471.94
CARD_PAYMENT,Current,2025-03-19 11:45:49,2025-03-20 16:15:48,OpenAI,-22.66,0,EUR,COMPLETED,449.28
TRANSFER,Current,2025-03-20 23:16:47,2025-03-20 23:16:47,To EUR Savings,-0.01,0,EUR,COMPLETED,449.27
TRANSFER,Current,2025-03-21 09:13:28,2025-03-21 09:13:28,To EUR Savings,-1,0,EUR,COMPLETED,448.27
TOPUP,Current,2025-03-21 09:14:18,2025-03-21 09:14:19,Apple Pay Top-Up by *0264,200,0,EUR,COMPLETED,648.27
CARD_PAYMENT,Current,2025-03-20 12:10:03,2025-03-21 11:04:14,Uber,-4.99,0,EUR,COMPLETED,643.28
CARD_PAYMENT,Current,2025-03-20 23:16:46,2025-03-21 12:47:13,F1,-59.99,0,EUR,COMPLETED,583.29
TRANSFER,Current,2025-03-22 07:33:17,2025-03-22 07:33:17,To EUR Savings,-0.5,0,EUR,COMPLETED,582.79
TRANSFER,Current,2025-03-22 08:53:32,2025-03-22 08:53:32,To EUR Savings,-0.99,0,EUR,COMPLETED,581.8
CARD_PAYMENT,Current,2025-03-22 07:33:17,2025-03-23 04:08:41,A Padaria Portuguesa,-2.5,0,EUR,COMPLETED,579.3
TRANSFER,Current,2025-03-23 07:12:25,2025-03-23 07:12:25,To EUR Savings,-0.01,0,EUR,COMPLETED,579.29
TRANSFER,Current,2025-03-23 08:38:01,2025-03-23 08:38:01,To EUR Savings,-0.5,0,EUR,COMPLETED,578.79
CARD_PAYMENT,Current,2025-03-22 08:53:32,2025-03-23 12:57:51,Pingo Doce,-57.01,0,EUR,COMPLETED,521.78
CARD_PAYMENT,Current,2025-03-20 12:06:39,2025-03-23 13:45:43,Uber Eats,-30.77,0,EUR,COMPLETED,491.01
TRANSFER,Current,2025-03-24 01:44:06,2025-03-24 01:44:06,To EUR Savings,-20,0,EUR,COMPLETED,471.01
CARD_PAYMENT,Current,2025-03-23 08:38:00,2025-03-24 04:03:54,A Padaria Portuguesa,-2.5,0,EUR,COMPLETED,468.51
CARD_PAYMENT,Current,2025-03-21 09:13:26,2025-03-24 09:28:53,Ikeaportuga 15,-93,0,EUR,COMPLETED,375.51
CARD_PAYMENT,Current,2025-03-23 07:12:25,2025-03-25 13:04:46,YouTube,-17.99,0,EUR,COMPLETED,357.52
TRANSFER,Current,2025-03-26 08:26:33,2025-03-26 08:26:33,To EUR Savings,-1,0,EUR,COMPLETED,356.52
TRANSFER,Current,2025-03-27 08:38:38,2025-03-27 08:38:38,To EUR Savings,-1,0,EUR,COMPLETED,355.52
TRANSFER,Current,2025-03-27 12:05:03,2025-03-27 12:05:03,To EUR Savings,-0.23,0,EUR,COMPLETED,355.29
TRANSFER,Current,2025-03-27 20:50:10,2025-03-27 20:50:10,To EUR Savings,-0.01,0,EUR,COMPLETED,355.28
TOPUP,Current,2025-03-28 08:08:36,2025-03-28 08:08:37,Apple Pay Top-Up by *0264,200,0,EUR,COMPLETED,555.28
TRANSFER,Current,2025-03-28 10:01:17,2025-03-28 10:01:17,To EUR Savings,-1,0,EUR,COMPLETED,554.28
TRANSFER,Current,2025-03-28 12:49:55,2025-03-28 12:49:55,To EUR Savings,-0.78,0,EUR,COMPLETED,553.5
TRANSFER,Current,2025-03-28 16:55:54,2025-03-28 16:55:54,To EUR Savings,-1,0,EUR,COMPLETED,552.5
TRANSFER,Current,2025-03-28 18:20:02,2025-03-28 18:20:02,To EUR,600,0,EUR,COMPLETED,1152.5
TRANSFER,Current,2025-03-28 18:20:34,2025-03-28 18:20:34,To EUR Savings,-0.32,0,EUR,COMPLETED,1152.18
TRANSFER,Current,2025-03-28 19:07:46,2025-03-28 19:07:46,To EUR Savings,-0.87,0,EUR,COMPLETED,1151.31
TRANSFER,Current,2025-03-28 22:28:25,2025-03-28 22:28:25,To EUR Savings,-0.95,0,EUR,COMPLETED,1150.36
TRANSFER,Current,2025-03-29 04:52:00,2025-03-29 04:52:00,To EUR Savings,-0.51,0,EUR,COMPLETED,1149.85
TRANSFER,Current,2025-03-29 08:23:38,2025-03-29 08:23:38,To EUR Savings,-0.5,0,EUR,COMPLETED,1149.35
TRANSFER,Current,2025-03-29 09:30:28,2025-03-29 09:30:28,To EUR Savings,-0.36,0,EUR,COMPLETED,1148.99
CARD_PAYMENT,Current,2025-03-27 20:50:10,2025-03-29 11:41:01,Netflix,-12.99,0,EUR,COMPLETED,1136
CARD_PAYMENT,Current,2025-03-26 08:26:32,2025-03-29 11:41:37,Ikeaportuga 15,-17,0,EUR,COMPLETED,1119
CARD_PAYMENT,Current,2025-03-28 18:20:34,2025-03-29 12:03:30,Zaask,-582.68,0,EUR,COMPLETED,536.32
CARD_PAYMENT,Current,2025-03-28 19:07:46,2025-03-29 17:55:37,Codeium,-17.13,0,EUR,COMPLETED,519.19
CARD_PAYMENT,Current,2025-03-28 10:01:16,2025-03-29 18:36:52,Hospital Da Luz Oeir,-19,0,EUR,COMPLETED,500.19
TRANSFER,Current,2025-03-30 02:53:57,2025-03-30 02:53:57,To EUR Savings,-0.05,0,EUR,COMPLETED,500.14
CARD_PAYMENT,Current,2025-03-29 08:23:37,2025-03-30 06:18:02,A Padaria Portuguesa,-2.5,0,EUR,COMPLETED,497.64
TRANSFER,Current,2025-03-30 08:26:42,2025-03-30 08:26:42,To EUR Savings,-0.5,0,EUR,COMPLETED,497.14
TRANSFER,Current,2025-03-30 09:25:22,2025-03-30 09:25:22,To EUR Savings,-0.28,0,EUR,COMPLETED,496.86
CARD_PAYMENT,Current,2025-03-27 12:04:58,2025-03-30 10:09:46,Uber Eats,-30.77,0,EUR,COMPLETED,466.09
CARD_PAYMENT,Current,2025-03-28 12:49:54,2025-03-30 10:21:48,Uber Eats,-18.22,0,EUR,COMPLETED,447.87
CARD_PAYMENT,Current,2025-03-28 22:28:24,2025-03-30 15:40:21,La Siesta Cocina Mexicana,-54.05,0,EUR,COMPLETED,393.82
CARD_PAYMENT,Current,2025-03-29 09:30:25,2025-03-30 15:40:26,Controlauto Miraflores,-36.64,0,EUR,COMPLETED,357.18
CARD_PAYMENT,Current,2025-03-27 08:38:38,2025-03-30 16:55:34,Ikeaportuga 15,-17,0,EUR,COMPLETED,340.18
CARD_PAYMENT,Current,2025-03-29 04:52:00,2025-03-30 17:04:59,Apple,-5.49,0,EUR,COMPLETED,334.69
TRANSFER,Current,2025-03-31 02:52:56,2025-03-31 02:52:56,To EUR Savings,-20,0,EUR,COMPLETED,314.69
CARD_PAYMENT,Current,2025-03-30 08:26:41,2025-03-31 06:44:02,A Padaria Portuguesa,-2.5,0,EUR,COMPLETED,312.19
CARD_PAYMENT,Current,2025-03-30 09:25:22,2025-03-31 09:59:58,Pingo Doce,-27.72,0,EUR,COMPLETED,284.47
CARD_PAYMENT,Current,2025-03-28 16:55:54,2025-03-31 10:39:27,Ikeaportuga 15,-17,0,EUR,COMPLETED,267.47
CARD_PAYMENT,Current,2025-03-30 02:53:57,2025-03-31 12:11:18,Apple,-21.95,0,EUR,COMPLETED,245.52
TRANSFER,Current,2025-04-01 02:16:05,2025-04-01 02:16:05,To EUR Rainy day,-50,0,EUR,COMPLETED,195.52
TRANSFER,Current,2025-04-02 12:15:41,2025-04-02 12:15:41,To EUR Savings,-0.01,0,EUR,COMPLETED,195.51
TRANSFER,Current,2025-04-02 18:04:02,2025-04-02 18:04:02,To EUR Savings,-1,0,EUR,COMPLETED,194.51
CARD_PAYMENT,Current,2025-04-02 18:03:36,2025-04-03 09:34:42,Hospital Luz Oeiras,-3,0,EUR,COMPLETED,191.51
CARD_PAYMENT,Current,2025-04-03 12:01:20,,Uber Eats,-31.66,0,EUR,PENDING,
TRANSFER,Current,2025-04-03 12:01:21,2025-04-03 12:01:21,To EUR Savings,-0.34,0,EUR,COMPLETED,191.17
TOPUP,Current,2025-04-03 12:01:55,2025-04-03 12:01:56,Apple Pay Top-Up by *0264,200,0,EUR,COMPLETED,391.17
CARD_PAYMENT,Current,2025-04-02 12:15:40,2025-04-04 08:58:08,PlayStation,-8.99,0,EUR,COMPLETED,382.18
TRANSFER,Savings,2021-12-10 12:38:03,2021-12-10 12:38:03,Balance migration to another region or legal entity,-1750,0,EUR,COMPLETED,64.96
TRANSFER,Savings,2021-12-10 12:38:03,2021-12-10 12:38:03,Balance migration to another region or legal entity,1750,0,EUR,COMPLETED,1814.96
TRANSFER,Savings,2021-12-10 12:38:03,2021-12-10 12:38:03,Balance migration to another region or legal entity,-64.96,0,EUR,COMPLETED,1750
TRANSFER,Savings,2021-12-10 12:38:03,2021-12-10 12:38:03,Balance migration to another region or legal entity,64.96,0,EUR,COMPLETED,1814.96
TRANSFER,Savings,2021-12-12 07:48:03,2021-12-12 07:48:03,To EUR Savings,0.01,0,EUR,COMPLETED,1814.97
TRANSFER,Savings,2021-12-13 07:32:05,2021-12-13 07:32:05,To EUR Savings,20,0,EUR,COMPLETED,1834.97
EXCHANGE,Savings,2021-12-13 08:11:18,2021-12-13 08:11:18,Exchange to EUR,0.65,0,EUR,COMPLETED,1835.62
TRANSFER,Savings,2021-12-16 10:32:44,2021-12-16 10:32:44,To EUR Savings,0.55,0,EUR,COMPLETED,1836.17
TRANSFER,Savings,2021-12-17 21:40:57,2021-12-17 21:40:57,To EUR Savings,0.51,0,EUR,COMPLETED,1836.68
TRANSFER,Savings,2021-12-20 07:34:47,2021-12-20 07:34:47,To EUR Savings,20,0,EUR,COMPLETED,1856.68
TRANSFER,Savings,2021-12-20 17:41:15,2021-12-20 17:41:15,To EUR Savings,0.21,0,EUR,COMPLETED,1856.89
TRANSFER,Savings,2021-12-22 11:46:40,2021-12-22 11:46:40,To EUR Savings,1,0,EUR,COMPLETED,1857.89
TRANSFER,Savings,2021-12-27 07:36:08,2021-12-27 07:36:08,To EUR Savings,20,0,EUR,COMPLETED,1877.89
TRANSFER,Savings,2021-12-29 13:03:49,2021-12-29 13:03:49,To EUR Savings,0.01,0,EUR,COMPLETED,1877.9
TRANSFER,Savings,2021-12-30 12:44:33,2021-12-30 12:44:33,To EUR Savings,0.1,0,EUR,COMPLETED,1878
TRANSFER,Savings,2021-12-31 18:26:51,2021-12-31 18:26:51,To EUR Savings,0.01,0,EUR,COMPLETED,1878.01
TRANSFER,Savings,2022-01-01 00:14:17,2022-01-01 00:14:17,To EUR Savings,0.4,0,EUR,COMPLETED,1878.41
TRANSFER,Savings,2022-01-01 00:15:04,2022-01-01 00:15:04,To EUR Savings,0.06,0,EUR,COMPLETED,1878.47
TRANSFER,Savings,2022-01-01 00:21:41,2022-01-01 00:21:41,To EUR Savings,0.6,0,EUR,COMPLETED,1879.07
EXCHANGE,Savings,2022-01-02 14:07:12,2022-01-02 14:07:12,Exchange to EUR,0.5,0,EUR,COMPLETED,1879.57
TRANSFER,Savings,2022-01-03 07:39:35,2022-01-03 07:39:35,To EUR Savings,20,0,EUR,COMPLETED,1899.57
TRANSFER,Savings,2022-01-06 21:14:09,2022-01-06 21:14:09,To EUR Savings,1,0,EUR,COMPLETED,1900.57
TRANSFER,Savings,2022-01-10 07:44:55,2022-01-10 07:44:55,To EUR Savings,20,0,EUR,COMPLETED,1920.57
TRANSFER,Savings,2022-01-10 10:10:24,2022-01-10 10:10:24,To EUR Savings,0.02,0,EUR,COMPLETED,1920.59
TRANSFER,Savings,2022-01-12 20:47:45,2022-01-12 20:47:45,To EUR Savings,0.01,0,EUR,COMPLETED,1920.6
TRANSFER,Savings,2022-01-15 10:02:38,2022-01-15 10:02:38,To EUR Savings,0.62,0,EUR,COMPLETED,1921.22
TRANSFER,Savings,2022-01-15 14:33:34,2022-01-15 14:33:34,To EUR Savings,0.33,0,EUR,COMPLETED,1921.55
TRANSFER,Savings,2022-01-16 13:04:42,2022-01-16 13:04:42,To EUR Savings,0.7,0,EUR,COMPLETED,1922.25
TRANSFER,Savings,2022-01-16 14:07:40,2022-01-16 14:07:40,To EUR Savings,0.05,0,EUR,COMPLETED,1922.3
TRANSFER,Savings,2022-01-17 07:43:09,2022-01-17 07:43:09,To EUR Savings,20,0,EUR,COMPLETED,1942.3
TRANSFER,Savings,2022-01-17 08:41:15,2022-01-17 08:41:15,To EUR Savings,0.79,0,EUR,COMPLETED,1943.09
TRANSFER,Savings,2022-01-17 21:41:03,2022-01-17 21:41:03,To EUR Savings,0.51,0,EUR,COMPLETED,1943.6
TRANSFER,Savings,2022-01-21 16:22:09,2022-01-21 16:22:09,To EUR Savings,0.9,0,EUR,COMPLETED,1944.5
TRANSFER,Savings,2022-01-22 08:36:45,2022-01-22 08:36:45,To EUR Savings,1,0,EUR,COMPLETED,1945.5
TRANSFER,Savings,2022-01-22 14:40:04,2022-01-22 14:40:04,To EUR Savings,0.7,0,EUR,COMPLETED,1946.2
TRANSFER,Savings,2022-01-23 08:26:32,2022-01-23 08:26:32,To EUR Savings,1,0,EUR,COMPLETED,1947.2
TRANSFER,Savings,2022-01-23 08:34:44,2022-01-23 08:34:44,To EUR Savings,0.41,0,EUR,COMPLETED,1947.61
TRANSFER,Savings,2022-01-23 14:11:30,2022-01-23 14:11:30,To EUR Savings,0.5,0,EUR,COMPLETED,1948.11
TRANSFER,Savings,2022-01-23 14:26:33,2022-01-23 14:26:33,To EUR Savings,0.2,0,EUR,COMPLETED,1948.31
TRANSFER,Savings,2022-01-24 07:45:17,2022-01-24 07:45:17,To EUR Savings,20,0,EUR,COMPLETED,1968.31
TRANSFER,Savings,2022-01-24 13:13:20,2022-01-24 13:13:20,To EUR Savings,1,0,EUR,COMPLETED,1969.31
TRANSFER,Savings,2022-01-28 13:48:50,2022-01-28 13:48:50,To EUR Savings,0.12,0,EUR,COMPLETED,1969.43
TRANSFER,Savings,2022-01-28 17:11:56,2022-01-28 17:11:56,To EUR Savings,0.59,0,EUR,COMPLETED,1970.02
TRANSFER,Savings,2022-01-29 08:40:24,2022-01-29 08:40:24,To EUR Savings,1,0,EUR,COMPLETED,1971.02
TRANSFER,Savings,2022-01-29 14:03:06,2022-01-29 14:03:06,To EUR Savings,0.01,0,EUR,COMPLETED,1971.03
TRANSFER,Savings,2022-01-29 14:42:18,2022-01-29 14:42:18,To EUR Savings,0.5,0,EUR,COMPLETED,1971.53
TRANSFER,Savings,2022-01-29 14:46:25,2022-01-29 14:46:25,To EUR Savings,1,0,EUR,COMPLETED,1972.53
TRANSFER,Savings,2022-01-29 19:19:51,2022-01-29 19:19:51,To EUR Savings,1,0,EUR,COMPLETED,1973.53
TRANSFER,Savings,2022-01-31 07:52:57,2022-01-31 07:52:57,To EUR Savings,20,0,EUR,COMPLETED,1993.53
TRANSFER,Savings,2022-01-31 15:50:56,2022-01-31 15:50:56,To EUR Savings,0.5,0,EUR,COMPLETED,1994.03
TRANSFER,Savings,2022-02-02 10:10:11,2022-02-02 10:10:11,To EUR Savings,0.01,0,EUR,COMPLETED,1994.04
TRANSFER,Savings,2022-02-02 13:08:56,2022-02-02 13:08:56,To EUR Savings,0.86,0,EUR,COMPLETED,1994.9
TRANSFER,Savings,2022-02-02 13:36:26,2022-02-02 13:36:26,To EUR Savings,0.13,0,EUR,COMPLETED,1995.03
TRANSFER,Savings,2022-02-04 19:35:38,2022-02-04 19:35:38,To EUR Savings,0.51,0,EUR,COMPLETED,1995.54
TRANSFER,Savings,2022-02-05 08:49:34,2022-02-05 08:49:34,To EUR Savings,1,0,EUR,COMPLETED,1996.54
TRANSFER,Savings,2022-02-05 13:13:26,2022-02-05 13:13:26,To EUR Savings,0.1,0,EUR,COMPLETED,1996.64
TRANSFER,Savings,2022-02-05 13:22:56,2022-02-05 13:22:56,To EUR Savings,0.3,0,EUR,COMPLETED,1996.94
TRANSFER,Savings,2022-02-05 15:54:39,2022-02-05 15:54:39,To EUR Savings,1,0,EUR,COMPLETED,1997.94
TRANSFER,Savings,2022-02-05 20:38:30,2022-02-05 20:38:30,To EUR Savings,0.71,0,EUR,COMPLETED,1998.65
TRANSFER,Savings,2022-02-05 22:40:35,2022-02-05 22:40:35,To EUR Savings,0.65,0,EUR,COMPLETED,1999.3
TRANSFER,Savings,2022-02-06 09:20:09,2022-02-06 09:20:09,To EUR Savings,1,0,EUR,COMPLETED,2000.3
TRANSFER,Savings,2022-02-06 15:19:25,2022-02-06 15:19:25,To EUR Savings,0.62,0,EUR,COMPLETED,2000.92
TRANSFER,Savings,2022-02-06 16:44:34,2022-02-06 16:44:34,To EUR Savings,0.01,0,EUR,COMPLETED,2000.93
TRANSFER,Savings,2022-02-07 07:51:27,2022-02-07 07:51:27,To EUR Savings,20,0,EUR,COMPLETED,2020.93
TRANSFER,Savings,2022-02-07 08:41:42,2022-02-07 08:41:42,To EUR Savings,0.65,0,EUR,COMPLETED,2021.58
TRANSFER,Savings,2022-02-08 08:50:59,2022-02-08 08:50:59,To EUR Savings,0.01,0,EUR,COMPLETED,2021.59
TRANSFER,Savings,2022-02-08 09:30:10,2022-02-08 09:30:10,To EUR Savings,0.7,0,EUR,COMPLETED,2022.29
TRANSFER,Savings,2022-02-09 08:33:32,2022-02-09 08:33:32,To EUR Savings,0.68,0,EUR,COMPLETED,2022.97
TRANSFER,Savings,2022-02-11 12:03:16,2022-02-11 12:03:16,To EUR Savings,0.55,0,EUR,COMPLETED,2023.52
TRANSFER,Savings,2022-02-11 14:13:04,2022-02-11 14:13:04,To EUR Savings,1,0,EUR,COMPLETED,2024.52
TRANSFER,Savings,2022-02-12 09:14:03,2022-02-12 09:14:03,To EUR Savings,1,0,EUR,COMPLETED,2025.52
TRANSFER,Savings,2022-02-12 14:03:13,2022-02-12 14:03:13,To EUR Savings,0.1,0,EUR,COMPLETED,2025.62
TRANSFER,Savings,2022-02-12 22:50:25,2022-02-12 22:50:25,To EUR Savings,1,0,EUR,COMPLETED,2026.62
TRANSFER,Savings,2022-02-13 09:16:11,2022-02-13 09:16:11,To EUR Savings,1,0,EUR,COMPLETED,2027.62
TRANSFER,Savings,2022-02-13 13:07:44,2022-02-13 13:07:44,To EUR Savings,0.62,0,EUR,COMPLETED,2028.24
TRANSFER,Savings,2022-02-14 07:52:15,2022-02-14 07:52:15,To EUR Savings,20,0,EUR,COMPLETED,2048.24
TRANSFER,Savings,2022-02-14 12:42:09,2022-02-14 12:42:09,To EUR Savings,0.75,0,EUR,COMPLETED,2048.99
TRANSFER,Savings,2022-02-14 20:22:03,2022-02-14 20:22:03,To EUR Savings,0.39,0,EUR,COMPLETED,2049.38
TRANSFER,Savings,2022-02-15 08:28:30,2022-02-15 08:28:30,To EUR Savings,0.27,0,EUR,COMPLETED,2049.65
TRANSFER,Savings,2022-02-15 12:54:50,2022-02-15 12:54:50,To EUR Savings,0.01,0,EUR,COMPLETED,2049.66
TRANSFER,Savings,2022-02-15 13:19:05,2022-02-15 13:19:05,To EUR Savings,1,0,EUR,COMPLETED,2050.66
TRANSFER,Savings,2022-02-17 21:44:07,2022-02-17 21:44:07,To EUR Savings,0.51,0,EUR,COMPLETED,2051.17
TRANSFER,Savings,2022-02-19 08:31:56,2022-02-19 08:31:56,To EUR Savings,1,0,EUR,COMPLETED,2052.17
TRANSFER,Savings,2022-02-19 19:21:23,2022-02-19 19:21:23,To EUR Savings,0.42,0,EUR,COMPLETED,2052.59
TRANSFER,Savings,2022-02-20 10:10:48,2022-02-20 10:10:48,To EUR Savings,0.05,0,EUR,COMPLETED,2052.64
TRANSFER,Savings,2022-02-20 13:13:08,2022-02-20 13:13:08,To EUR Savings,0.5,0,EUR,COMPLETED,2053.14
TRANSFER,Savings,2022-02-20 13:20:42,2022-02-20 13:20:42,To EUR Savings,0.8,0,EUR,COMPLETED,2053.94
TRANSFER,Savings,2022-02-20 13:47:09,2022-02-20 13:47:09,To EUR Savings,0.2,0,EUR,COMPLETED,2054.14
TRANSFER,Savings,2022-02-20 20:55:17,2022-02-20 20:55:17,To EUR Savings,0.01,0,EUR,COMPLETED,2054.15
TRANSFER,Savings,2022-02-21 07:53:57,2022-02-21 07:53:57,To EUR Savings,20,0,EUR,COMPLETED,2074.15
TRANSFER,Savings,2022-02-21 10:17:32,2022-02-21 10:17:32,To EUR Savings,0.58,0,EUR,COMPLETED,2074.73
TRANSFER,Savings,2022-02-22 14:11:25,2022-02-22 14:11:25,To EUR Savings,0.75,0,EUR,COMPLETED,2075.48
TRANSFER,Savings,2022-02-23 10:13:02,2022-02-23 10:13:02,To EUR Savings,0.59,0,EUR,COMPLETED,2076.07
TRANSFER,Savings,2022-02-24 12:55:33,2022-02-24 12:55:33,To EUR Savings,0.75,0,EUR,COMPLETED,2076.82
TRANSFER,Savings,2022-02-25 10:03:58,2022-02-25 10:03:58,To EUR Savings,0.17,0,EUR,COMPLETED,2076.99
TRANSFER,Savings,2022-02-25 13:02:21,2022-02-25 13:02:21,To EUR Savings,0.09,0,EUR,COMPLETED,2077.08
TRANSFER,Savings,2022-02-26 08:45:33,2022-02-26 08:45:33,To EUR Savings,1,0,EUR,COMPLETED,2078.08
TRANSFER,Savings,2022-02-26 09:06:29,2022-02-26 09:06:29,To EUR Rainy day,250,0,EUR,COMPLETED,2328.08
TRANSFER,Savings,2022-02-26 20:47:45,2022-02-26 20:47:45,To EUR Savings,0.58,0,EUR,COMPLETED,2328.66
TRANSFER,Savings,2022-02-27 00:32:37,2022-02-27 00:32:37,To EUR Savings,0.01,0,EUR,COMPLETED,2328.67
TRANSFER,Savings,2022-02-27 00:35:37,2022-02-27 00:35:37,To EUR Savings,0.51,0,EUR,COMPLETED,2329.18
TRANSFER,Savings,2022-02-27 08:58:57,2022-02-27 08:58:57,To EUR Savings,0.5,0,EUR,COMPLETED,2329.68
TRANSFER,Savings,2022-02-27 13:19:10,2022-02-27 13:19:10,To EUR Savings,0.3,0,EUR,COMPLETED,2329.98
TRANSFER,Savings,2022-02-27 14:01:40,2022-02-27 14:01:40,To EUR Savings,0.3,0,EUR,COMPLETED,2330.28
TRANSFER,Savings,2022-02-28 08:15:12,2022-02-28 08:15:12,To EUR Savings,20,0,EUR,COMPLETED,2350.28
TRANSFER,Savings,2022-02-28 13:03:47,2022-02-28 13:03:47,To EUR Savings,0.01,0,EUR,COMPLETED,2350.29
TRANSFER,Savings,2022-03-01 07:56:23,2022-03-01 07:56:23,To EUR Savings,1,0,EUR,COMPLETED,2351.29
TRANSFER,Savings,2022-03-01 14:13:44,2022-03-01 14:13:44,To EUR Savings,0.7,0,EUR,COMPLETED,2351.99
TRANSFER,Savings,2022-03-01 14:55:46,2022-03-01 14:55:46,To EUR Savings,0.2,0,EUR,COMPLETED,2352.19
TRANSFER,Savings,2022-03-02 10:15:17,2022-03-02 10:15:17,To EUR Savings,0.99,0,EUR,COMPLETED,2353.18
TRANSFER,Savings,2022-03-05 08:38:02,2022-03-05 08:38:02,To EUR Savings,1,0,EUR,COMPLETED,2354.18
TRANSFER,Savings,2022-03-06 08:45:00,2022-03-06 08:45:00,To EUR Savings,1,0,EUR,COMPLETED,2355.18
TRANSFER,Savings,2022-03-06 09:53:35,2022-03-06 09:53:35,To EUR Savings,0.02,0,EUR,COMPLETED,2355.2
TRANSFER,Savings,2022-03-06 14:31:50,2022-03-06 14:31:50,To EUR Savings,0.2,0,EUR,COMPLETED,2355.4
TRANSFER,Savings,2022-03-06 14:36:16,2022-03-06 14:36:16,To EUR Savings,0.1,0,EUR,COMPLETED,2355.5
TRANSFER,Savings,2022-03-07 07:59:09,2022-03-07 07:59:09,To EUR Savings,20,0,EUR,COMPLETED,2375.5
TRANSFER,Savings,2022-03-07 22:08:34,2022-03-07 22:08:34,To EUR Savings,0.1,0,EUR,COMPLETED,2375.6
TRANSFER,Savings,2022-03-08 08:51:02,2022-03-08 08:51:02,To EUR Savings,0.01,0,EUR,COMPLETED,2375.61
TRANSFER,Savings,2022-03-11 12:03:10,2022-03-11 12:03:10,To EUR Savings,0.02,0,EUR,COMPLETED,2375.63
TRANSFER,Savings,2022-03-11 12:35:05,2022-03-11 12:35:05,To EUR Savings,1,0,EUR,COMPLETED,2376.63
TRANSFER,Savings,2022-03-11 12:58:01,2022-03-11 12:58:01,To EUR Savings,1,0,EUR,COMPLETED,2377.63
TRANSFER,Savings,2022-03-11 13:51:20,2022-03-11 13:51:20,To EUR Savings,0.23,0,EUR,COMPLETED,2377.86
TRANSFER,Savings,2022-03-12 08:38:27,2022-03-12 08:38:27,To EUR Savings,1,0,EUR,COMPLETED,2378.86
TRANSFER,Savings,2022-03-12 10:01:03,2022-03-12 10:01:03,To EUR Savings,0.75,0,EUR,COMPLETED,2379.61
TRANSFER,Savings,2022-03-12 13:12:04,2022-03-12 13:12:04,To EUR Savings,0.75,0,EUR,COMPLETED,2380.36
TRANSFER,Savings,2022-03-12 20:41:49,2022-03-12 20:41:49,To EUR Savings,0.55,0,EUR,COMPLETED,2380.91
TRANSFER,Savings,2022-03-13 08:27:29,2022-03-13 08:27:29,To EUR Savings,1,0,EUR,COMPLETED,2381.91
TRANSFER,Savings,2022-03-13 13:23:13,2022-03-13 13:23:13,To EUR Savings,0.2,0,EUR,COMPLETED,2382.11
TRANSFER,Savings,2022-03-13 14:25:42,2022-03-13 14:25:42,To EUR Savings,0.2,0,EUR,COMPLETED,2382.31
TRANSFER,Savings,2022-03-14 07:59:26,2022-03-14 07:59:26,To EUR Savings,20,0,EUR,COMPLETED,2402.31
TRANSFER,Savings,2022-03-15 12:54:43,2022-03-15 12:54:43,To EUR Savings,0.01,0,EUR,COMPLETED,2402.32
TRANSFER,Savings,2022-03-15 13:01:55,2022-03-15 13:01:55,To EUR Savings,0.75,0,EUR,COMPLETED,2403.07
TRANSFER,Savings,2022-03-16 13:11:31,2022-03-16 13:11:31,To EUR Savings,0.27,0,EUR,COMPLETED,2403.34
TRANSFER,Savings,2022-03-17 12:52:00,2022-03-17 12:52:00,To EUR Savings,0.75,0,EUR,COMPLETED,2404.09
TRANSFER,Savings,2022-03-17 21:40:58,2022-03-17 21:40:58,To EUR Savings,0.51,0,EUR,COMPLETED,2404.6
TRANSFER,Savings,2022-03-18 19:53:49,2022-03-18 19:53:49,To EUR Savings,0.8,0,EUR,COMPLETED,2405.4
TRANSFER,Savings,2022-03-19 08:28:17,2022-03-19 08:28:17,To EUR Savings,1,0,EUR,COMPLETED,2406.4
TRANSFER,Savings,2022-03-20 00:09:34,2022-03-20 00:09:34,To EUR Savings,0.01,0,EUR,COMPLETED,2406.41
TRANSFER,Savings,2022-03-20 08:10:40,2022-03-20 08:10:40,To EUR Savings,1,0,EUR,COMPLETED,2407.41
TRANSFER,Savings,2022-03-21 08:01:05,2022-03-21 08:01:05,To EUR Savings,20,0,EUR,COMPLETED,2427.41
TRANSFER,Savings,2022-03-22 09:55:56,2022-03-22 09:55:56,To EUR Savings,0.01,0,EUR,COMPLETED,2427.42
TRANSFER,Savings,2022-03-22 12:45:31,2022-03-22 12:45:31,To EUR Savings,0.75,0,EUR,COMPLETED,2428.17
TRANSFER,Savings,2022-03-26 08:47:04,2022-03-26 08:47:04,To EUR Savings,1,0,EUR,COMPLETED,2429.17
TRANSFER,Savings,2022-03-26 23:32:44,2022-03-26 23:32:44,To EUR Savings,0.01,0,EUR,COMPLETED,2429.18
TRANSFER,Savings,2022-03-26 23:34:55,2022-03-26 23:34:55,To EUR Savings,0.51,0,EUR,COMPLETED,2429.69
TRANSFER,Savings,2022-03-28 09:05:50,2022-03-28 09:05:50,To EUR Savings,20,0,EUR,COMPLETED,2449.69
TRANSFER,Savings,2022-03-28 14:03:42,2022-03-28 14:03:42,To EUR Savings,0.01,0,EUR,COMPLETED,2449.7
TRANSFER,Savings,2022-03-29 12:43:39,2022-03-29 12:43:39,To EUR Savings,0.9,0,EUR,COMPLETED,2450.6
TRANSFER,Savings,2022-03-31 20:05:26,2022-03-31 20:05:26,To EUR Savings,0.01,0,EUR,COMPLETED,2450.61
TRANSFER,Savings,2022-04-02 09:29:07,2022-04-02 09:29:07,To EUR Savings,0.6,0,EUR,COMPLETED,2451.21
TRANSFER,Savings,2022-04-02 13:57:08,2022-04-02 13:57:08,To EUR Savings,0.2,0,EUR,COMPLETED,2451.41
TRANSFER,Savings,2022-04-03 15:18:51,2022-04-03 15:18:51,To EUR Savings,0.8,0,EUR,COMPLETED,2452.21
TRANSFER,Savings,2022-04-04 09:06:17,2022-04-04 09:06:17,To EUR Savings,20,0,EUR,COMPLETED,2472.21
TRANSFER,Savings,2022-04-04 13:42:36,2022-04-04 13:42:36,To EUR Savings,0.55,0,EUR,COMPLETED,2472.76
TRANSFER,Savings,2022-04-05 12:46:05,2022-04-05 12:46:05,To EUR Savings,0.9,0,EUR,COMPLETED,2473.66
TRANSFER,Savings,2022-04-06 10:48:36,2022-04-06 10:48:36,To EUR Savings,0.01,0,EUR,COMPLETED,2473.67
TRANSFER,Savings,2022-04-06 10:57:36,2022-04-06 10:57:36,To EUR Savings,0.53,0,EUR,COMPLETED,2474.2
TRANSFER,Savings,2022-04-06 11:13:28,2022-04-06 11:13:28,To EUR Savings,0.3,0,EUR,COMPLETED,2474.5
TRANSFER,Savings,2022-04-06 11:21:09,2022-04-06 11:21:09,To EUR Savings,0.2,0,EUR,COMPLETED,2474.7
TRANSFER,Savings,2022-04-06 13:21:04,2022-04-06 13:21:04,To EUR Savings,0.5,0,EUR,COMPLETED,2475.2
TRANSFER,Savings,2022-04-06 13:31:44,2022-04-06 13:31:44,To EUR Savings,0.3,0,EUR,COMPLETED,2475.5
TRANSFER,Savings,2022-04-06 14:19:35,2022-04-06 14:19:35,To EUR Savings,0.85,0,EUR,COMPLETED,2476.35
TRANSFER,Savings,2022-04-06 17:45:21,2022-04-06 17:45:21,To EUR Savings,0.15,0,EUR,COMPLETED,2476.5
TRANSFER,Savings,2022-04-06 17:50:11,2022-04-06 17:50:11,To EUR Savings,0.2,0,EUR,COMPLETED,2476.7
TRANSFER,Savings,2022-04-06 22:41:20,2022-04-06 22:41:20,To EUR Savings,0.36,0,EUR,COMPLETED,2477.06
TRANSFER,Savings,2022-04-06 23:00:16,2022-04-06 23:00:16,To EUR Savings,0.15,0,EUR,COMPLETED,2477.21
TRANSFER,Savings,2022-04-07 08:03:31,2022-04-07 08:03:31,To EUR Savings,0.4,0,EUR,COMPLETED,2477.61
TRANSFER,Savings,2022-04-07 09:38:28,2022-04-07 09:38:28,To EUR Savings,0.23,0,EUR,COMPLETED,2477.84
TRANSFER,Savings,2022-04-07 10:25:53,2022-04-07 10:25:53,To EUR Savings,0.65,0,EUR,COMPLETED,2478.49
TRANSFER,Savings,2022-04-07 12:55:36,2022-04-07 12:55:36,To EUR Savings,0.89,0,EUR,COMPLETED,2479.38
TRANSFER,Savings,2022-04-07 13:17:54,2022-04-07 13:17:54,To EUR Savings,0.87,0,EUR,COMPLETED,2480.25
TRANSFER,Savings,2022-04-07 13:45:13,2022-04-07 13:45:13,To EUR Savings,0.33,0,EUR,COMPLETED,2480.58
TRANSFER,Savings,2022-04-07 16:50:20,2022-04-07 16:50:20,To EUR Savings,0.02,0,EUR,COMPLETED,2480.6
TRANSFER,Savings,2022-04-07 17:33:21,2022-04-07 17:33:21,To EUR Savings,0.5,0,EUR,COMPLETED,2481.1
TRANSFER,Savings,2022-04-08 07:57:38,2022-04-08 07:57:38,To EUR Savings,0.95,0,EUR,COMPLETED,2482.05
TRANSFER,Savings,2022-04-08 08:39:40,2022-04-08 08:39:40,To EUR Savings,0.35,0,EUR,COMPLETED,2482.4
TRANSFER,Savings,2022-04-08 08:55:34,2022-04-08 08:55:34,To EUR Savings,0.01,0,EUR,COMPLETED,2482.41
TRANSFER,Savings,2022-04-08 08:59:45,2022-04-08 08:59:45,To EUR Savings,0.23,0,EUR,COMPLETED,2482.64
TRANSFER,Savings,2022-04-08 09:40:32,2022-04-08 09:40:32,To EUR Savings,0.82,0,EUR,COMPLETED,2483.46
TRANSFER,Savings,2022-04-08 09:42:06,2022-04-08 09:42:06,To EUR Savings,0.82,0,EUR,COMPLETED,2484.28
TRANSFER,Savings,2022-04-08 13:37:49,2022-04-08 13:37:49,To EUR Savings,0.1,0,EUR,COMPLETED,2484.38
TRANSFER,Savings,2022-04-08 14:25:45,2022-04-08 14:25:45,To EUR Savings,0.29,0,EUR,COMPLETED,2484.67
TRANSFER,Savings,2022-04-08 15:25:50,2022-04-08 15:25:50,To EUR Savings,0.41,0,EUR,COMPLETED,2485.08
TRANSFER,Savings,2022-04-08 15:38:46,2022-04-08 15:38:46,To EUR Savings,0.01,0,EUR,COMPLETED,2485.09
TRANSFER,Savings,2022-04-08 18:45:41,2022-04-08 18:45:41,To EUR Savings,0.4,0,EUR,COMPLETED,2485.49
TRANSFER,Savings,2022-04-09 11:11:01,2022-04-09 11:11:01,To EUR Savings,0.87,0,EUR,COMPLETED,2486.36
TRANSFER,Savings,2022-04-09 14:20:29,2022-04-09 14:20:29,To EUR Savings,0.19,0,EUR,COMPLETED,2486.55
TRANSFER,Savings,2022-04-09 18:23:00,2022-04-09 18:23:00,To EUR Savings,0.44,0,EUR,COMPLETED,2486.99
TRANSFER,Savings,2022-04-09 20:24:41,2022-04-09 20:24:41,To EUR Savings,0.1,0,EUR,COMPLETED,2487.09
TRANSFER,Savings,2022-04-10 09:05:43,2022-04-10 09:05:43,To EUR Savings,0.83,0,EUR,COMPLETED,2487.92
TRANSFER,Savings,2022-04-10 12:37:26,2022-04-10 12:37:26,To EUR Savings,0.68,0,EUR,COMPLETED,2488.6
TRANSFER,Savings,2022-04-10 12:55:09,2022-04-10 12:55:09,To EUR Savings,0.25,0,EUR,COMPLETED,2488.85
TRANSFER,Savings,2022-04-10 13:49:18,2022-04-10 13:49:18,To EUR Savings,0.83,0,EUR,COMPLETED,2489.68
TRANSFER,Savings,2022-04-10 16:26:01,2022-04-10 16:26:01,To EUR Savings,0.21,0,EUR,COMPLETED,2489.89
TRANSFER,Savings,2022-04-10 23:19:04,2022-04-10 23:19:04,To EUR Savings,0.15,0,EUR,COMPLETED,2490.04
TRANSFER,Savings,2022-04-11 09:34:58,2022-04-11 09:34:58,To EUR Savings,20,0,EUR,COMPLETED,2510.04
TRANSFER,Savings,2022-04-11 12:02:26,2022-04-11 12:02:26,To EUR Savings,0.85,0,EUR,COMPLETED,2510.89
TRANSFER,Savings,2022-04-11 12:17:14,2022-04-11 12:17:14,To EUR Savings,0.29,0,EUR,COMPLETED,2511.18
TRANSFER,Savings,2022-04-11 14:55:00,2022-04-11 14:55:00,To EUR Savings,0.89,0,EUR,COMPLETED,2512.07
TRANSFER,Savings,2022-04-11 17:01:32,2022-04-11 17:01:32,To EUR Savings,0.85,0,EUR,COMPLETED,2512.92
TRANSFER,Savings,2022-04-11 17:31:53,2022-04-11 17:31:53,To EUR Savings,0.9,0,EUR,COMPLETED,2513.82
TRANSFER,Savings,2022-04-11 21:22:52,2022-04-11 21:22:52,To EUR Savings,0.24,0,EUR,COMPLETED,2514.06
TRANSFER,Savings,2022-04-11 21:59:08,2022-04-11 21:59:08,To EUR Savings,0.61,0,EUR,COMPLETED,2514.67
TRANSFER,Savings,2022-04-12 12:42:59,2022-04-12 12:42:59,To EUR Savings,0.2,0,EUR,COMPLETED,2514.87
TRANSFER,Savings,2022-04-13 19:02:06,2022-04-13 19:02:06,To EUR Savings,0.85,0,EUR,COMPLETED,2515.72
TRANSFER,Savings,2022-04-16 09:52:46,2022-04-16 09:52:46,To EUR Savings,0.8,0,EUR,COMPLETED,2516.52
TRANSFER,Savings,2022-04-16 13:32:57,2022-04-16 13:32:57,To EUR Savings,0.2,0,EUR,COMPLETED,2516.72
TRANSFER,Savings,2022-04-16 14:32:44,2022-04-16 14:32:44,To EUR Savings,0.25,0,EUR,COMPLETED,2516.97
TRANSFER,Savings,2022-04-17 10:15:30,2022-04-17 10:15:30,To EUR Savings,0.1,0,EUR,COMPLETED,2517.07
TRANSFER,Savings,2022-04-17 13:56:49,2022-04-17 13:56:49,To EUR Savings,0.2,0,EUR,COMPLETED,2517.27
TRANSFER,Savings,2022-04-17 21:40:57,2022-04-17 21:40:57,To EUR Savings,0.51,0,EUR,COMPLETED,2517.78
TRANSFER,Savings,2022-04-18 09:09:01,2022-04-18 09:09:01,To EUR Savings,20,0,EUR,COMPLETED,2537.78
TRANSFER,Savings,2022-04-19 09:40:20,2022-04-19 09:40:20,To EUR Savings,0.7,0,EUR,COMPLETED,2538.48
TRANSFER,Savings,2022-04-19 12:53:18,2022-04-19 12:53:18,To EUR Savings,0.2,0,EUR,COMPLETED,2538.68
TRANSFER,Savings,2022-04-23 15:42:43,2022-04-23 15:42:43,To EUR Savings,0.1,0,EUR,COMPLETED,2538.78
TRANSFER,Savings,2022-04-24 16:34:25,2022-04-24 16:34:25,To EUR Savings,1,0,EUR,COMPLETED,2539.78
TRANSFER,Savings,2022-04-25 09:12:56,2022-04-25 09:12:56,To EUR Savings,20,0,EUR,COMPLETED,2559.78
TRANSFER,Savings,2022-04-25 21:31:53,2022-04-25 21:31:53,To EUR Savings,0.2,0,EUR,COMPLETED,2559.98
TRANSFER,Savings,2022-04-26 13:07:21,2022-04-26 13:07:21,To EUR Savings,0.2,0,EUR,COMPLETED,2560.18
TRANSFER,Savings,2022-04-27 00:32:29,2022-04-27 00:32:29,To EUR Savings,0.01,0,EUR,COMPLETED,2560.19
TRANSFER,Savings,2022-04-27 00:34:07,2022-04-27 00:34:07,To EUR Savings,0.51,0,EUR,COMPLETED,2560.7
TRANSFER,Savings,2022-04-28 14:03:43,2022-04-28 14:03:43,To EUR Savings,0.01,0,EUR,COMPLETED,2560.71
TRANSFER,Savings,2022-04-28 15:57:42,2022-04-28 15:57:42,To EUR Savings,0.5,0,EUR,COMPLETED,2561.21
TRANSFER,Savings,2022-04-29 12:52:23,2022-04-29 12:52:23,To EUR Savings,0.2,0,EUR,COMPLETED,2561.41
TRANSFER,Savings,2022-05-02 03:14:48,2022-05-02 03:14:48,To EUR Savings,0.01,0,EUR,COMPLETED,2561.42
TRANSFER,Savings,2022-05-02 09:16:21,2022-05-02 09:16:21,To EUR Savings,20,0,EUR,COMPLETED,2581.42
TRANSFER,Savings,2022-05-02 12:34:47,2022-05-02 12:34:47,To EUR Savings,0.23,0,EUR,COMPLETED,2581.65
TRANSFER,Savings,2022-05-03 12:50:18,2022-05-03 12:50:18,To EUR Savings,0.35,0,EUR,COMPLETED,2582
TRANSFER,Savings,2022-05-03 23:21:12,2022-05-03 23:21:12,To EUR Savings,0.3,0,EUR,COMPLETED,2582.3
TRANSFER,Savings,2022-05-04 12:34:56,2022-05-04 12:34:56,To EUR Savings,0.3,0,EUR,COMPLETED,2582.6
TRANSFER,Savings,2022-05-04 14:35:29,2022-05-04 14:35:29,To EUR Savings,0.65,0,EUR,COMPLETED,2583.25
TRANSFER,Savings,2022-05-04 14:41:28,2022-05-04 14:41:28,To EUR Savings,0.83,0,EUR,COMPLETED,2584.08
TRANSFER,Savings,2022-05-06 19:39:37,2022-05-06 19:39:37,To EUR Savings,0.01,0,EUR,COMPLETED,2584.09
TRANSFER,Savings,2022-05-08 08:51:14,2022-05-08 08:51:14,To EUR Savings,0.01,0,EUR,COMPLETED,2584.1
TRANSFER,Savings,2022-05-09 09:14:44,2022-05-09 09:14:44,To EUR Savings,20,0,EUR,COMPLETED,2604.1
TRANSFER,Savings,2022-05-10 12:48:47,2022-05-10 12:48:47,To EUR Savings,0.8,0,EUR,COMPLETED,2604.9
TRANSFER,Savings,2022-05-13 12:38:14,2022-05-13 12:38:14,To EUR Savings,0.1,0,EUR,COMPLETED,2605
TRANSFER,Savings,2022-05-15 10:43:10,2022-05-15 10:43:10,To EUR Savings,0.54,0,EUR,COMPLETED,2605.54
TRANSFER,Savings,2022-05-15 11:46:43,2022-05-15 11:46:43,To EUR Savings,1,0,EUR,COMPLETED,2606.54
TRANSFER,Savings,2022-05-16 09:17:32,2022-05-16 09:17:32,To EUR Savings,20,0,EUR,COMPLETED,2626.54
TRANSFER,Savings,2022-05-17 12:51:55,2022-05-17 12:51:55,To EUR Savings,0.8,0,EUR,COMPLETED,2627.34
TRANSFER,Savings,2022-05-17 21:40:58,2022-05-17 21:40:58,To EUR Savings,0.51,0,EUR,COMPLETED,2627.85
TRANSFER,Savings,2022-05-19 15:53:17,2022-05-19 15:53:17,To EUR Savings,0.13,0,EUR,COMPLETED,2627.98
TRANSFER,Savings,2022-05-21 07:53:03,2022-05-21 07:53:03,To EUR Savings,0.85,0,EUR,COMPLETED,2628.83
TRANSFER,Savings,2022-05-21 09:17:19,2022-05-21 09:17:19,To EUR Savings,1,0,EUR,COMPLETED,2629.83
TRANSFER,Savings,2022-05-21 14:03:30,2022-05-21 14:03:30,To EUR Savings,1,0,EUR,COMPLETED,2630.83
TRANSFER,Savings,2022-05-22 08:01:11,2022-05-22 08:01:11,To EUR Savings,0.85,0,EUR,COMPLETED,2631.68
TRANSFER,Savings,2022-05-22 12:33:37,2022-05-22 12:33:37,To EUR Savings,0.65,0,EUR,COMPLETED,2632.33
TRANSFER,Savings,2022-05-22 22:29:15,2022-05-22 22:29:15,To EUR Savings,0.01,0,EUR,COMPLETED,2632.34
TRANSFER,Savings,2022-05-23 09:17:57,2022-05-23 09:17:57,To EUR Savings,20,0,EUR,COMPLETED,2652.34
TRANSFER,Savings,2022-05-24 12:45:27,2022-05-24 12:45:27,To EUR Savings,0.65,0,EUR,COMPLETED,2652.99
TRANSFER,Savings,2022-05-24 12:56:40,2022-05-24 12:56:40,To EUR Savings,0.87,0,EUR,COMPLETED,2653.86
TRANSFER,Savings,2022-05-25 21:33:36,2022-05-25 21:33:36,To EUR Rainy day,1000,0,EUR,COMPLETED,3653.86
TRANSFER,Savings,2022-05-26 08:46:01,2022-05-26 08:46:01,To EUR Savings,0.53,0,EUR,COMPLETED,3654.39
TRANSFER,Savings,2022-05-26 08:53:23,2022-05-26 08:53:23,To EUR Savings,0.4,0,EUR,COMPLETED,3654.79
TRANSFER,Savings,2022-05-27 00:32:20,2022-05-27 00:32:20,To EUR Savings,0.01,0,EUR,COMPLETED,3654.8
TRANSFER,Savings,2022-05-27 00:34:53,2022-05-27 00:34:53,To EUR Savings,0.51,0,EUR,COMPLETED,3655.31
TRANSFER,Savings,2022-05-27 20:17:02,2022-05-27 20:17:02,To EUR Savings,1,0,EUR,COMPLETED,3656.31
TRANSFER,Savings,2022-05-28 08:34:32,2022-05-28 08:34:32,To EUR Savings,0.85,0,EUR,COMPLETED,3657.16
TRANSFER,Savings,2022-05-28 09:57:28,2022-05-28 09:57:28,To EUR Savings,0.72,0,EUR,COMPLETED,3657.88
TRANSFER,Savings,2022-05-28 13:08:01,2022-05-28 13:08:01,To EUR Savings,0.01,0,EUR,COMPLETED,3657.89
TRANSFER,Savings,2022-05-28 14:03:43,2022-05-28 14:03:43,To EUR Savings,0.01,0,EUR,COMPLETED,3657.9
TRANSFER,Savings,2022-05-28 20:28:18,2022-05-28 20:28:18,To EUR Savings,0.3,0,EUR,COMPLETED,3658.2
TRANSFER,Savings,2022-05-29 09:06:11,2022-05-29 09:06:11,To EUR Savings,0.85,0,EUR,COMPLETED,3659.05
TRANSFER,Savings,2022-05-29 12:43:18,2022-05-29 12:43:18,To EUR Savings,1,0,EUR,COMPLETED,3660.05
TRANSFER,Savings,2022-05-29 13:29:48,2022-05-29 13:29:48,To EUR Savings,0.2,0,EUR,COMPLETED,3660.25
TRANSFER,Savings,2022-05-29 17:59:55,2022-05-29 17:59:55,To EUR Savings,0.12,0,EUR,COMPLETED,3660.37
TRANSFER,Savings,2022-05-29 18:06:09,2022-05-29 18:06:09,To EUR Savings,0.23,0,EUR,COMPLETED,3660.6
TRANSFER,Savings,2022-05-29 18:19:18,2022-05-29 18:19:18,To EUR Savings,0.26,0,EUR,COMPLETED,3660.86
TRANSFER,Savings,2022-05-30 08:43:20,2022-05-30 08:43:20,To EUR Savings,0.25,0,EUR,COMPLETED,3661.11
TRANSFER,Savings,2022-05-30 16:50:02,2022-05-30 16:50:02,To EUR Savings,1,0,EUR,COMPLETED,3662.11
TRANSFER,Savings,2022-05-31 08:40:24,2022-05-31 08:40:24,To EUR Savings,0.98,0,EUR,COMPLETED,3663.09
TRANSFER,Savings,2022-06-01 08:37:06,2022-06-01 08:37:06,To EUR Savings,0.39,0,EUR,COMPLETED,3663.48
TRANSFER,Savings,2022-06-02 08:56:45,2022-06-02 08:56:45,To EUR Savings,0.23,0,EUR,COMPLETED,3663.71
TRANSFER,Savings,2022-06-02 11:01:21,2022-06-02 11:01:21,To EUR Savings,0.74,0,EUR,COMPLETED,3664.45
TRANSFER,Savings,2022-06-03 08:42:49,2022-06-03 08:42:49,To EUR Savings,0.33,0,EUR,COMPLETED,3664.78
TRANSFER,Savings,2022-06-03 12:42:23,2022-06-03 12:42:23,To EUR Savings,0.3,0,EUR,COMPLETED,3665.08
TRANSFER,Savings,2022-06-03 12:52:48,2022-06-03 12:52:48,To EUR Savings,0.09,0,EUR,COMPLETED,3665.17
TRANSFER,Savings,2022-06-04 09:46:53,2022-06-04 09:46:53,To EUR Savings,0.2,0,EUR,COMPLETED,3665.37
TRANSFER,Savings,2022-06-04 10:11:40,2022-06-04 10:11:40,To EUR Savings,0.61,0,EUR,COMPLETED,3665.98
TRANSFER,Savings,2022-06-05 07:15:56,2022-06-05 07:15:56,To EUR Savings,0.77,0,EUR,COMPLETED,3666.75
TRANSFER,Savings,2022-06-05 09:54:42,2022-06-05 09:54:42,To EUR Savings,0.3,0,EUR,COMPLETED,3667.05
TRANSFER,Savings,2022-06-05 10:14:44,2022-06-05 10:14:44,To EUR,-500,0,EUR,COMPLETED,3167.05
TRANSFER,Savings,2022-06-05 12:14:37,2022-06-05 12:14:37,To EUR Savings,0.56,0,EUR,COMPLETED,3167.61
TRANSFER,Savings,2022-06-05 23:30:00,2022-06-05 23:30:00,To EUR Savings,1,0,EUR,COMPLETED,3168.61
TRANSFER,Savings,2022-06-06 08:36:22,2022-06-06 08:36:22,To EUR Savings,0.94,0,EUR,COMPLETED,3169.55
TRANSFER,Savings,2022-06-06 09:22:52,2022-06-06 09:22:52,To EUR Savings,20,0,EUR,COMPLETED,3189.55
TRANSFER,Savings,2022-06-06 12:29:26,2022-06-06 12:29:26,To EUR Savings,1,0,EUR,COMPLETED,3190.55
TRANSFER,Savings,2022-06-06 13:51:01,2022-06-06 13:51:01,To EUR Savings,0.3,0,EUR,COMPLETED,3190.85
TRANSFER,Savings,2022-06-07 12:50:51,2022-06-07 12:50:51,To EUR Savings,0.8,0,EUR,COMPLETED,3191.65
TRANSFER,Savings,2022-06-08 08:45:13,2022-06-08 08:45:13,To EUR Savings,0.25,0,EUR,COMPLETED,3191.9
TRANSFER,Savings,2022-06-08 08:52:38,2022-06-08 08:52:38,To EUR Savings,0.01,0,EUR,COMPLETED,3191.91
TRANSFER,Savings,2022-06-09 08:24:33,2022-06-09 08:24:33,To EUR Savings,0.85,0,EUR,COMPLETED,3192.76
TRANSFER,Savings,2022-06-09 10:28:47,2022-06-09 10:28:47,To EUR,-500,0,EUR,COMPLETED,2692.76
TRANSFER,Savings,2022-06-09 10:29:16,2022-06-09 10:29:16,To EUR Savings,0.2,0,EUR,COMPLETED,2692.96
TRANSFER,Savings,2022-06-09 14:59:48,2022-06-09 14:59:48,To EUR Savings,0.9,0,EUR,COMPLETED,2693.86
TRANSFER,Savings,2022-06-10 10:28:52,2022-06-10 10:28:52,To EUR Savings,1,0,EUR,COMPLETED,2694.86
TRANSFER,Savings,2022-06-10 21:23:25,2022-06-10 21:23:25,To EUR Savings,1,0,EUR,COMPLETED,2695.86
TRANSFER,Savings,2022-06-11 10:23:25,2022-06-11 10:23:25,To EUR Savings,1,0,EUR,COMPLETED,2696.86
TRANSFER,Savings,2022-06-11 14:23:34,2022-06-11 14:23:34,To EUR Savings,0.9,0,EUR,COMPLETED,2697.76
TRANSFER,Savings,2022-06-11 14:45:17,2022-06-11 14:45:17,To EUR Savings,1,0,EUR,COMPLETED,2698.76
TRANSFER,Savings,2022-06-11 21:41:38,2022-06-11 21:41:38,To EUR Savings,0.01,0,EUR,COMPLETED,2698.77
TRANSFER,Savings,2022-06-12 10:13:06,2022-06-12 10:13:06,To EUR Savings,0.5,0,EUR,COMPLETED,2699.27
TRANSFER,Savings,2022-06-12 16:08:07,2022-06-12 16:08:07,To EUR Savings,0.8,0,EUR,COMPLETED,2700.07
TRANSFER,Savings,2022-06-13 08:57:04,2022-06-13 08:57:04,To EUR Savings,0.85,0,EUR,COMPLETED,2700.92
TRANSFER,Savings,2022-06-13 09:23:20,2022-06-13 09:23:20,To EUR Savings,20,0,EUR,COMPLETED,2720.92
TRANSFER,Savings,2022-06-13 12:06:00,2022-06-13 12:06:00,To EUR Savings,0.8,0,EUR,COMPLETED,2721.72
TRANSFER,Savings,2022-06-14 18:59:02,2022-06-14 18:59:02,To EUR Savings,0.43,0,EUR,COMPLETED,2722.15
TRANSFER,Savings,2022-06-15 20:26:32,2022-06-15 20:26:32,To EUR Savings,0.77,0,EUR,COMPLETED,2722.92
TRANSFER,Savings,2022-06-16 08:44:05,2022-06-16 08:44:05,To EUR Savings,0.38,0,EUR,COMPLETED,2723.3
TRANSFER,Savings,2022-06-17 08:47:33,2022-06-17 08:47:33,To EUR Savings,0.94,0,EUR,COMPLETED,2724.24
TRANSFER,Savings,2022-06-17 21:40:58,2022-06-17 21:40:58,To EUR Savings,0.51,0,EUR,COMPLETED,2724.75
TRANSFER,Savings,2022-06-18 07:56:26,2022-06-18 07:56:26,To EUR Savings,0.85,0,EUR,COMPLETED,2725.6
TRANSFER,Savings,2022-06-18 10:47:33,2022-06-18 10:47:33,To EUR Savings,1,0,EUR,COMPLETED,2726.6
TRANSFER,Savings,2022-06-18 10:57:01,2022-06-18 10:57:01,To EUR Savings,0.55,0,EUR,COMPLETED,2727.15
TRANSFER,Savings,2022-06-19 08:54:51,2022-06-19 08:54:51,To EUR Savings,0.85,0,EUR,COMPLETED,2728
TRANSFER,Savings,2022-06-19 10:59:41,2022-06-19 10:59:41,To EUR Savings,0.56,0,EUR,COMPLETED,2728.56
TRANSFER,Savings,2022-06-19 12:22:54,2022-06-19 12:22:54,To EUR Savings,0.5,0,EUR,COMPLETED,2729.06
TRANSFER,Savings,2022-06-19 12:25:01,2022-06-19 12:25:01,To EUR Savings,0.1,0,EUR,COMPLETED,2729.16
TRANSFER,Savings,2022-06-19 12:32:07,2022-06-19 12:32:07,To EUR Savings,1,0,EUR,COMPLETED,2730.16
TRANSFER,Savings,2022-06-19 13:01:14,2022-06-19 13:01:14,To EUR Savings,0.2,0,EUR,COMPLETED,2730.36
TRANSFER,Savings,2022-06-19 14:02:15,2022-06-19 14:02:15,To EUR Savings,0.2,0,EUR,COMPLETED,2730.56
TRANSFER,Savings,2022-06-19 15:11:07,2022-06-19 15:11:07,To EUR Savings,1,0,EUR,COMPLETED,2731.56
TRANSFER,Savings,2022-06-19 22:18:19,2022-06-19 22:18:19,To EUR Savings,0.9,0,EUR,COMPLETED,2732.46
TRANSFER,Savings,2022-06-20 08:28:58,2022-06-20 08:28:58,To EUR Savings,0.85,0,EUR,COMPLETED,2733.31
TRANSFER,Savings,2022-06-20 09:26:32,2022-06-20 09:26:32,To EUR Savings,20,0,EUR,COMPLETED,2753.31
TRANSFER,Savings,2022-06-20 11:40:14,2022-06-20 11:40:14,To EUR Savings,1,0,EUR,COMPLETED,2754.31
TRANSFER,Savings,2022-06-20 12:19:26,2022-06-20 12:19:26,To EUR Savings,0.2,0,EUR,COMPLETED,2754.51
TRANSFER,Savings,2022-06-20 14:10:49,2022-06-20 14:10:49,To EUR Savings,0.7,0,EUR,COMPLETED,2755.21
TRANSFER,Savings,2022-06-21 08:34:38,2022-06-21 08:34:38,To EUR Savings,0.85,0,EUR,COMPLETED,2756.06
TRANSFER,Savings,2022-06-21 13:14:19,2022-06-21 13:14:19,To EUR Savings,1,0,EUR,COMPLETED,2757.06
TRANSFER,Savings,2022-06-21 14:45:36,2022-06-21 14:45:36,To EUR Savings,0.4,0,EUR,COMPLETED,2757.46
TRANSFER,Savings,2022-06-21 19:07:19,2022-06-21 19:07:19,To EUR Savings,0.66,0,EUR,COMPLETED,2758.12
TRANSFER,Savings,2022-06-22 11:55:17,2022-06-22 11:55:17,To EUR Savings,0.15,0,EUR,COMPLETED,2758.27
TRANSFER,Savings,2022-06-22 15:15:56,2022-06-22 15:15:56,To EUR Savings,0.2,0,EUR,COMPLETED,2758.47
TRANSFER,Savings,2022-06-23 08:20:35,2022-06-23 08:20:35,To EUR Savings,0.85,0,EUR,COMPLETED,2759.32
TRANSFER,Savings,2022-06-23 14:40:18,2022-06-23 14:40:18,To EUR Savings,0.84,0,EUR,COMPLETED,2760.16
TRANSFER,Savings,2022-06-23 16:23:35,2022-06-23 16:23:35,To EUR Savings,0.5,0,EUR,COMPLETED,2760.66
TRANSFER,Savings,2022-06-23 17:55:17,2022-06-23 17:55:17,To EUR Savings,0.01,0,EUR,COMPLETED,2760.67
TRANSFER,Savings,2022-06-23 20:24:38,2022-06-23 20:24:38,To EUR Savings,0.81,0,EUR,COMPLETED,2761.48
TRANSFER,Savings,2022-06-24 09:13:27,2022-06-24 09:13:27,To EUR Savings,0.85,0,EUR,COMPLETED,2762.33
TRANSFER,Savings,2022-06-24 18:13:28,2022-06-24 18:13:28,To EUR Savings,0.5,0,EUR,COMPLETED,2762.83
TRANSFER,Savings,2022-06-25 08:42:33,2022-06-25 08:42:33,To EUR Savings,0.85,0,EUR,COMPLETED,2763.68
TRANSFER,Savings,2022-06-25 14:47:41,2022-06-25 14:47:41,To EUR Savings,0.1,0,EUR,COMPLETED,2763.78
TRANSFER,Savings,2022-06-25 23:49:04,2022-06-25 23:49:04,To EUR Savings,0.8,0,EUR,COMPLETED,2764.58
TRANSFER,Savings,2022-06-26 07:27:10,2022-06-26 07:27:10,To EUR Savings,0.89,0,EUR,COMPLETED,2765.47
TRANSFER,Savings,2022-06-26 07:45:08,2022-06-26 07:45:08,To EUR Savings,0.85,0,EUR,COMPLETED,2766.32
TRANSFER,Savings,2022-06-26 09:22:57,2022-06-26 09:22:57,To EUR Savings,0.5,0,EUR,COMPLETED,2766.82
TRANSFER,Savings,2022-06-26 09:28:37,2022-06-26 09:28:37,To EUR Savings,0.51,0,EUR,COMPLETED,2767.33
TRANSFER,Savings,2022-06-26 22:45:44,2022-06-26 22:45:44,To EUR Savings,1,0,EUR,COMPLETED,2768.33
TRANSFER,Savings,2022-06-26 22:47:02,2022-06-26 22:47:02,To EUR Savings,0.8,0,EUR,COMPLETED,2769.13
TRANSFER,Savings,2022-06-27 00:32:54,2022-06-27 00:32:54,To EUR Savings,0.01,0,EUR,COMPLETED,2769.14
TRANSFER,Savings,2022-06-27 00:35:50,2022-06-27 00:35:50,To EUR Savings,0.51,0,EUR,COMPLETED,2769.65
TRANSFER,Savings,2022-06-27 09:28:06,2022-06-27 09:28:06,To EUR Savings,20,0,EUR,COMPLETED,2789.65
TRANSFER,Savings,2022-06-27 09:37:01,2022-06-27 09:37:01,To EUR Savings,0.85,0,EUR,COMPLETED,2790.5
TRANSFER,Savings,2022-06-27 16:31:56,2022-06-27 16:31:56,To EUR Savings,0.65,0,EUR,COMPLETED,2791.15
TRANSFER,Savings,2022-06-27 20:08:46,2022-06-27 20:08:46,To EUR Savings,0.66,0,EUR,COMPLETED,2791.81
TRANSFER,Savings,2022-06-28 09:16:19,2022-06-28 09:16:19,To EUR Savings,0.85,0,EUR,COMPLETED,2792.66
TRANSFER,Savings,2022-06-28 10:19:37,2022-06-28 10:19:37,To EUR Savings,0.1,0,EUR,COMPLETED,2792.76
TRANSFER,Savings,2022-06-28 10:50:03,2022-06-28 10:50:03,To EUR Savings,0.05,0,EUR,COMPLETED,2792.81
TRANSFER,Savings,2022-06-28 13:11:30,2022-06-28 13:11:30,To EUR Savings,1,0,EUR,COMPLETED,2793.81
TRANSFER,Savings,2022-06-28 14:03:43,2022-06-28 14:03:43,To EUR Savings,0.01,0,EUR,COMPLETED,2793.82
TRANSFER,Savings,2022-06-28 14:06:19,2022-06-28 14:06:19,To EUR Savings,0.2,0,EUR,COMPLETED,2794.02
TRANSFER,Savings,2022-06-29 09:27:52,2022-06-29 09:27:52,To EUR Savings,0.85,0,EUR,COMPLETED,2794.87
TRANSFER,Savings,2022-06-30 10:39:45,2022-06-30 10:39:45,To EUR Savings,0.71,0,EUR,COMPLETED,2795.58
TRANSFER,Savings,2022-06-30 10:43:17,2022-06-30 10:43:17,To EUR Savings,0.45,0,EUR,COMPLETED,2796.03
TRANSFER,Savings,2022-07-01 14:34:00,2022-07-01 14:34:00,To EUR Savings,0.6,0,EUR,COMPLETED,2796.63
TRANSFER,Savings,2022-07-01 17:04:12,2022-07-01 17:04:12,To EUR Savings,0.55,0,EUR,COMPLETED,2797.18
TRANSFER,Savings,2022-07-01 20:23:10,2022-07-01 20:23:10,To EUR Savings,0.2,0,EUR,COMPLETED,2797.38
TRANSFER,Savings,2022-07-02 03:13:49,2022-07-02 03:13:49,To EUR Savings,0.01,0,EUR,COMPLETED,2797.39
TRANSFER,Savings,2022-07-02 14:41:04,2022-07-02 14:41:04,To EUR Savings,0.9,0,EUR,COMPLETED,2798.29
TRANSFER,Savings,2022-07-02 18:04:36,2022-07-02 18:04:36,To EUR Savings,0.14,0,EUR,COMPLETED,2798.43
TRANSFER,Savings,2022-07-03 10:42:08,2022-07-03 10:42:08,To EUR Savings,0.2,0,EUR,COMPLETED,2798.63
TRANSFER,Savings,2022-07-03 14:36:54,2022-07-03 14:36:54,To EUR Savings,0.5,0,EUR,COMPLETED,2799.13
TRANSFER,Savings,2022-07-04 09:29:50,2022-07-04 09:29:50,To EUR Savings,20,0,EUR,COMPLETED,2819.13
TRANSFER,Savings,2022-07-05 12:55:26,2022-07-05 12:55:26,To EUR Savings,0.01,0,EUR,COMPLETED,2819.14
TRANSFER,Savings,2022-07-05 18:54:20,2022-07-05 18:54:20,To EUR Savings,0.82,0,EUR,COMPLETED,2819.96
TRANSFER,Savings,2022-07-05 20:54:11,2022-07-05 20:54:11,To EUR Savings,0.31,0,EUR,COMPLETED,2820.27
TRANSFER,Savings,2022-07-06 12:37:59,2022-07-06 12:37:59,To EUR Savings,0.98,0,EUR,COMPLETED,2821.25
TRANSFER,Savings,2022-07-06 19:36:18,2022-07-06 19:36:18,To EUR Savings,0.01,0,EUR,COMPLETED,2821.26
TRANSFER,Savings,2022-07-07 09:48:38,2022-07-07 09:48:38,To EUR Savings,0.85,0,EUR,COMPLETED,2822.11
TRANSFER,Savings,2022-07-08 07:30:17,2022-07-08 07:30:17,To EUR Savings,0.85,0,EUR,COMPLETED,2822.96
TRANSFER,Savings,2022-07-08 08:51:04,2022-07-08 08:51:04,To EUR Savings,0.01,0,EUR,COMPLETED,2822.97
TRANSFER,Savings,2022-07-09 09:28:13,2022-07-09 09:28:13,To EUR Savings,0.85,0,EUR,COMPLETED,2823.82
TRANSFER,Savings,2022-07-09 09:59:32,2022-07-09 09:59:32,To EUR Savings,0.42,0,EUR,COMPLETED,2824.24
TRANSFER,Savings,2022-07-09 13:47:02,2022-07-09 13:47:02,To EUR Savings,0.51,0,EUR,COMPLETED,2824.75
TRANSFER,Savings,2022-07-10 08:39:59,2022-07-10 08:39:59,To EUR Savings,0.85,0,EUR,COMPLETED,2825.6
TRANSFER,Savings,2022-07-10 12:45:51,2022-07-10 12:45:51,To EUR Savings,0.68,0,EUR,COMPLETED,2826.28
TRANSFER,Savings,2022-07-10 19:50:01,2022-07-10 19:50:01,To EUR Savings,1,0,EUR,COMPLETED,2827.28
TRANSFER,Savings,2022-07-11 09:31:47,2022-07-11 09:31:47,To EUR Savings,20,0,EUR,COMPLETED,2847.28
TRANSFER,Savings,2022-07-12 07:47:11,2022-07-12 07:47:11,To EUR Savings,0.21,0,EUR,COMPLETED,2847.49
TRANSFER,Savings,2022-07-12 09:59:05,2022-07-12 09:59:05,To EUR Savings,0.05,0,EUR,COMPLETED,2847.54
TRANSFER,Savings,2022-07-15 17:52:53,2022-07-15 17:52:53,To EUR Savings,0.81,0,EUR,COMPLETED,2848.35
TRANSFER,Savings,2022-07-16 08:31:03,2022-07-16 08:31:03,To EUR Savings,0.85,0,EUR,COMPLETED,2849.2
TRANSFER,Savings,2022-07-16 13:00:07,2022-07-16 13:00:07,To EUR Savings,0.8,0,EUR,COMPLETED,2850
TRANSFER,Savings,2022-07-16 13:05:31,2022-07-16 13:05:31,To EUR Savings,0.7,0,EUR,COMPLETED,2850.7
TRANSFER,Savings,2022-07-17 13:06:05,2022-07-17 13:06:05,To EUR Savings,0.2,0,EUR,COMPLETED,2850.9
TRANSFER,Savings,2022-07-17 21:40:57,2022-07-17 21:40:57,To EUR Savings,0.51,0,EUR,COMPLETED,2851.41
TRANSFER,Savings,2022-07-18 09:32:27,2022-07-18 09:32:27,To EUR Savings,20,0,EUR,COMPLETED,2871.41
TRANSFER,Savings,2022-07-19 08:44:48,2022-07-19 08:44:48,To EUR Savings,0.03,0,EUR,COMPLETED,2871.44
TRANSFER,Savings,2022-07-19 12:49:42,2022-07-19 12:49:42,To EUR Savings,0.61,0,EUR,COMPLETED,2872.05
TRANSFER,Savings,2022-07-20 07:37:09,2022-07-20 07:37:09,To EUR Savings,0.85,0,EUR,COMPLETED,2872.9
TRANSFER,Savings,2022-07-22 16:25:47,2022-07-22 16:25:47,To EUR Savings,0.01,0,EUR,COMPLETED,2872.91
TRANSFER,Savings,2022-07-23 13:03:15,2022-07-23 13:03:15,To EUR Savings,0.1,0,EUR,COMPLETED,2873.01
TRANSFER,Savings,2022-07-24 14:42:52,2022-07-24 14:42:52,To EUR Savings,0.01,0,EUR,COMPLETED,2873.02
TRANSFER,Savings,2022-07-24 14:43:19,2022-07-24 14:43:19,To EUR Savings,0.01,0,EUR,COMPLETED,2873.03
TRANSFER,Savings,2022-07-25 00:07:30,2022-07-25 00:07:30,To EUR Savings,0.17,0,EUR,COMPLETED,2873.2
TRANSFER,Savings,2022-07-25 09:36:44,2022-07-25 09:36:44,To EUR Savings,20,0,EUR,COMPLETED,2893.2
TRANSFER,Savings,2022-07-26 08:47:45,2022-07-26 08:47:45,To EUR Savings,0.6,0,EUR,COMPLETED,2893.8
TRANSFER,Savings,2022-07-26 23:14:14,2022-07-26 23:14:14,To EUR Savings,0.29,0,EUR,COMPLETED,2894.09
TRANSFER,Savings,2022-07-27 00:33:37,2022-07-27 00:33:37,To EUR Savings,0.01,0,EUR,COMPLETED,2894.1
TRANSFER,Savings,2022-07-27 00:36:50,2022-07-27 00:36:50,To EUR Savings,0.51,0,EUR,COMPLETED,2894.61
TRANSFER,Savings,2022-07-27 12:44:06,2022-07-27 12:44:06,To EUR Savings,0.83,0,EUR,COMPLETED,2895.44
TRANSFER,Savings,2022-07-28 12:34:40,2022-07-28 12:34:40,To EUR Savings,0.01,0,EUR,COMPLETED,2895.45
TRANSFER,Savings,2022-07-28 13:13:54,2022-07-28 13:13:54,To EUR Savings,0.2,0,EUR,COMPLETED,2895.65
TRANSFER,Savings,2022-07-28 14:03:46,2022-07-28 14:03:46,To EUR Savings,0.01,0,EUR,COMPLETED,2895.66
TRANSFER,Savings,2022-07-29 22:15:04,2022-07-29 22:15:04,To EUR Savings,0.8,0,EUR,COMPLETED,2896.46
TRANSFER,Savings,2022-07-30 07:50:27,2022-07-30 07:50:27,To EUR Savings,0.85,0,EUR,COMPLETED,2897.31
TRANSFER,Savings,2022-07-30 08:58:00,2022-07-30 08:58:00,To EUR Savings,0.67,0,EUR,COMPLETED,2897.98
TRANSFER,Savings,2022-07-30 10:28:30,2022-07-30 10:28:30,To EUR Savings,0.75,0,EUR,COMPLETED,2898.73
TRANSFER,Savings,2022-07-30 10:46:59,2022-07-30 10:46:59,To EUR Savings,0.92,0,EUR,COMPLETED,2899.65
TRANSFER,Savings,2022-07-30 11:10:47,2022-07-30 11:10:47,To EUR Savings,0.51,0,EUR,COMPLETED,2900.16
TRANSFER,Savings,2022-07-30 20:27:01,2022-07-30 20:27:01,To EUR Savings,0.01,0,EUR,COMPLETED,2900.17
TRANSFER,Savings,2022-07-31 07:17:14,2022-07-31 07:17:14,To EUR Savings,0.85,0,EUR,COMPLETED,2901.02
TRANSFER,Savings,2022-07-31 09:08:10,2022-07-31 09:08:10,To EUR Savings,0.82,0,EUR,COMPLETED,2901.84
TRANSFER,Savings,2022-07-31 10:23:16,2022-07-31 10:23:16,To EUR Savings,0.37,0,EUR,COMPLETED,2902.21
TRANSFER,Savings,2022-08-01 09:21:32,2022-08-01 09:21:32,To EUR Savings,0.28,0,EUR,COMPLETED,2902.49
TRANSFER,Savings,2022-08-01 10:10:01,2022-08-01 10:10:01,To EUR Savings,20,0,EUR,COMPLETED,2922.49
TRANSFER,Savings,2022-08-01 12:49:17,2022-08-01 12:49:17,To EUR Savings,0.94,0,EUR,COMPLETED,2923.43
TRANSFER,Savings,2022-08-02 03:13:34,2022-08-02 03:13:34,To EUR Savings,0.01,0,EUR,COMPLETED,2923.44
TRANSFER,Savings,2022-08-03 08:47:31,2022-08-03 08:47:31,To EUR Savings,0.04,0,EUR,COMPLETED,2923.48
TRANSFER,Savings,2022-08-03 09:14:19,2022-08-03 09:14:19,To EUR Savings,0.05,0,EUR,COMPLETED,2923.53
TRANSFER,Savings,2022-08-05 12:54:41,2022-08-05 12:54:41,To EUR Savings,0.66,0,EUR,COMPLETED,2924.19
TRANSFER,Savings,2022-08-05 14:15:57,2022-08-05 14:15:57,To EUR Savings,0.21,0,EUR,COMPLETED,2924.4
TRANSFER,Savings,2022-08-06 07:32:39,2022-08-06 07:32:39,To EUR Savings,0.85,0,EUR,COMPLETED,2925.25
TRANSFER,Savings,2022-08-07 07:22:26,2022-08-07 07:22:26,To EUR Savings,0.85,0,EUR,COMPLETED,2926.1
TRANSFER,Savings,2022-08-07 08:24:17,2022-08-07 08:24:17,To EUR Savings,0.22,0,EUR,COMPLETED,2926.32
TRANSFER,Savings,2022-08-07 13:51:33,2022-08-07 13:51:33,To EUR Savings,0.2,0,EUR,COMPLETED,2926.52
TRANSFER,Savings,2022-08-07 14:02:36,2022-08-07 14:02:36,To EUR Savings,1,0,EUR,COMPLETED,2927.52
TRANSFER,Savings,2022-08-08 08:53:45,2022-08-08 08:53:45,To EUR Savings,0.01,0,EUR,COMPLETED,2927.53
TRANSFER,Savings,2022-08-08 08:59:48,2022-08-08 08:59:48,To EUR Savings,0.15,0,EUR,COMPLETED,2927.68
TRANSFER,Savings,2022-08-08 09:41:55,2022-08-08 09:41:55,To EUR Savings,20,0,EUR,COMPLETED,2947.68
TRANSFER,Savings,2022-08-09 09:02:11,2022-08-09 09:02:11,To EUR Savings,0.55,0,EUR,COMPLETED,2948.23
TRANSFER,Savings,2022-08-09 11:55:50,2022-08-09 11:55:50,To EUR Savings,0.01,0,EUR,COMPLETED,2948.24
TRANSFER,Savings,2022-08-09 12:43:17,2022-08-09 12:43:17,To EUR Savings,0.83,0,EUR,COMPLETED,2949.07
TRANSFER,Savings,2022-08-10 07:49:06,2022-08-10 07:49:06,To EUR Savings,0.25,0,EUR,COMPLETED,2949.32
TRANSFER,Savings,2022-08-10 09:56:21,2022-08-10 09:56:21,To EUR Savings,0.85,0,EUR,COMPLETED,2950.17
TRANSFER,Savings,2022-08-11 09:06:48,2022-08-11 09:06:48,To EUR Savings,0.11,0,EUR,COMPLETED,2950.28
TRANSFER,Savings,2022-08-11 11:04:31,2022-08-11 11:04:31,To EUR Savings,0.01,0,EUR,COMPLETED,2950.29
TRANSFER,Savings,2022-08-12 20:32:22,2022-08-12 20:32:22,To EUR Savings,0.5,0,EUR,COMPLETED,2950.79
TRANSFER,Savings,2022-08-13 13:20:03,2022-08-13 13:20:03,To EUR Savings,0.3,0,EUR,COMPLETED,2951.09
TRANSFER,Savings,2022-08-13 13:37:10,2022-08-13 13:37:10,To EUR Savings,0.97,0,EUR,COMPLETED,2952.06
TRANSFER,Savings,2022-08-13 21:29:33,2022-08-13 21:29:33,To EUR Savings,0.7,0,EUR,COMPLETED,2952.76
TRANSFER,Savings,2022-08-14 13:13:24,2022-08-14 13:13:24,To EUR Savings,0.7,0,EUR,COMPLETED,2953.46
TRANSFER,Savings,2022-08-15 09:48:17,2022-08-15 09:48:17,To EUR Savings,20,0,EUR,COMPLETED,2973.46
TRANSFER,Savings,2022-08-15 13:03:43,2022-08-15 13:03:43,To EUR Savings,0.4,0,EUR,COMPLETED,2973.86
TRANSFER,Savings,2022-08-16 18:01:56,2022-08-16 18:01:56,To EUR Savings,0.7,0,EUR,COMPLETED,2974.56
TRANSFER,Savings,2022-08-17 17:44:43,2022-08-17 17:44:43,To EUR Savings,0.35,0,EUR,COMPLETED,2974.91
TRANSFER,Savings,2022-08-17 21:40:58,2022-08-17 21:40:58,To EUR Savings,0.51,0,EUR,COMPLETED,2975.42
TRANSFER,Savings,2022-08-18 13:02:13,2022-08-18 13:02:13,To EUR Savings,0.44,0,EUR,COMPLETED,2975.86
TRANSFER,Savings,2022-08-20 08:27:34,2022-08-20 08:27:34,To EUR Savings,0.85,0,EUR,COMPLETED,2976.71
TRANSFER,Savings,2022-08-21 08:26:53,2022-08-21 08:26:53,To EUR Savings,0.85,0,EUR,COMPLETED,2977.56
TRANSFER,Savings,2022-08-21 09:13:45,2022-08-21 09:13:45,To EUR Savings,0.05,0,EUR,COMPLETED,2977.61
TRANSFER,Savings,2022-08-21 09:34:05,2022-08-21 09:34:05,To EUR Savings,0.46,0,EUR,COMPLETED,2978.07
TRANSFER,Savings,2022-08-21 09:50:13,2022-08-21 09:50:13,To EUR Savings,0.94,0,EUR,COMPLETED,2979.01
TRANSFER,Savings,2022-08-21 10:14:18,2022-08-21 10:14:18,To EUR Savings,0.5,0,EUR,COMPLETED,2979.51
TRANSFER,Savings,2022-08-21 12:14:00,2022-08-21 12:14:00,To EUR Savings,0.04,0,EUR,COMPLETED,2979.55
TRANSFER,Savings,2022-08-22 09:45:49,2022-08-22 09:45:49,To EUR Savings,20,0,EUR,COMPLETED,2999.55
TRANSFER,Savings,2022-08-22 20:30:13,2022-08-22 20:30:13,To EUR Savings,0.66,0,EUR,COMPLETED,3000.21
TRANSFER,Savings,2022-08-23 08:53:11,2022-08-23 08:53:11,To EUR Savings,0.49,0,EUR,COMPLETED,3000.7
TRANSFER,Savings,2022-08-24 07:41:03,2022-08-24 07:41:03,To EUR Savings,0.85,0,EUR,COMPLETED,3001.55
TRANSFER,Savings,2022-08-24 08:21:54,2022-08-24 08:21:54,To EUR Savings,1,0,EUR,COMPLETED,3002.55
TRANSFER,Savings,2022-08-24 12:48:48,2022-08-24 12:48:48,To EUR Savings,0.33,0,EUR,COMPLETED,3002.88
TRANSFER,Savings,2022-08-24 18:01:34,2022-08-24 18:01:34,To EUR Savings,0.76,0,EUR,COMPLETED,3003.64
TRANSFER,Savings,2022-08-25 09:07:36,2022-08-25 09:07:36,To EUR Savings,0.93,0,EUR,COMPLETED,3004.57
TRANSFER,Savings,2022-08-25 12:48:36,2022-08-25 12:48:36,To EUR Savings,0.51,0,EUR,COMPLETED,3005.08
TRANSFER,Savings,2022-08-25 18:05:50,2022-08-25 18:05:50,To EUR Savings,0.01,0,EUR,COMPLETED,3005.09
TRANSFER,Savings,2022-08-27 00:33:05,2022-08-27 00:33:05,To EUR Savings,0.01,0,EUR,COMPLETED,3005.1
TRANSFER,Savings,2022-08-27 00:34:14,2022-08-27 00:34:14,To EUR Savings,0.51,0,EUR,COMPLETED,3005.61
TRANSFER,Savings,2022-08-27 08:07:39,2022-08-27 08:07:39,To EUR Savings,0.85,0,EUR,COMPLETED,3006.46
TRANSFER,Savings,2022-08-27 13:30:41,2022-08-27 13:30:41,To EUR Savings,0.8,0,EUR,COMPLETED,3007.26
TRANSFER,Savings,2022-08-28 07:42:25,2022-08-28 07:42:25,To EUR Savings,0.85,0,EUR,COMPLETED,3008.11
TRANSFER,Savings,2022-08-28 09:09:10,2022-08-28 09:09:10,To EUR Savings,0.36,0,EUR,COMPLETED,3008.47
TRANSFER,Savings,2022-08-28 12:41:25,2022-08-28 12:41:25,To EUR Savings,0.25,0,EUR,COMPLETED,3008.72
TRANSFER,Savings,2022-08-28 14:03:44,2022-08-28 14:03:44,To EUR Savings,0.01,0,EUR,COMPLETED,3008.73
TRANSFER,Savings,2022-08-29 09:49:30,2022-08-29 09:49:30,To EUR Savings,20,0,EUR,COMPLETED,3028.73
TRANSFER,Savings,2022-08-30 12:46:06,2022-08-30 12:46:06,To EUR Savings,0.33,0,EUR,COMPLETED,3029.06
TRANSFER,Savings,2022-08-31 13:06:41,2022-08-31 13:06:41,To EUR Savings,0.45,0,EUR,COMPLETED,3029.51
TRANSFER,Savings,2022-09-01 07:53:09,2022-09-01 07:53:09,To EUR Savings,0.85,0,EUR,COMPLETED,3030.36
TRANSFER,Savings,2022-09-01 11:17:29,2022-09-01 11:17:29,To EUR Savings,0.8,0,EUR,COMPLETED,3031.16
TRANSFER,Savings,2022-09-01 11:27:23,2022-09-01 11:27:23,To EUR Savings,0.4,0,EUR,COMPLETED,3031.56
TRANSFER,Savings,2022-09-02 10:19:49,2022-09-02 10:19:49,To EUR Savings,0.3,0,EUR,COMPLETED,3031.86
TRANSFER,Savings,2022-09-02 12:33:43,2022-09-02 12:33:43,To EUR Savings,0.3,0,EUR,COMPLETED,3032.16
TRANSFER,Savings,2022-09-02 12:55:01,2022-09-02 12:55:01,To EUR Savings,0.3,0,EUR,COMPLETED,3032.46
TRANSFER,Savings,2022-09-02 15:22:07,2022-09-02 15:22:07,To EUR Savings,0.25,0,EUR,COMPLETED,3032.71
EXCHANGE,Savings,2022-09-03 01:29:15,2022-09-03 01:29:15,Exchange to EUR,0.85,0.01,EUR,COMPLETED,3033.55
TRANSFER,Savings,2022-09-03 09:42:15,2022-09-03 09:42:15,To EUR Savings,0.9,0,EUR,COMPLETED,3034.45
TRANSFER,Savings,2022-09-03 15:04:45,2022-09-03 15:04:45,To EUR Savings,1,0,EUR,COMPLETED,3035.45
TRANSFER,Savings,2022-09-03 15:09:58,2022-09-03 15:09:58,To EUR Savings,1,0,EUR,COMPLETED,3036.45
TRANSFER,Savings,2022-09-03 17:31:01,2022-09-03 17:31:01,To EUR Savings,0.06,0,EUR,COMPLETED,3036.51
TRANSFER,Savings,2022-09-03 22:30:14,2022-09-03 22:30:14,To EUR Savings,1,0,EUR,COMPLETED,3037.51
TRANSFER,Savings,2022-09-04 14:07:40,2022-09-04 14:07:40,To EUR Savings,0.5,0,EUR,COMPLETED,3038.01
TRANSFER,Savings,2022-09-04 19:17:25,2022-09-04 19:17:25,To EUR Savings,0.05,0,EUR,COMPLETED,3038.06
TRANSFER,Savings,2022-09-05 01:14:13,2022-09-05 01:14:13,To EUR Savings,0.41,0,EUR,COMPLETED,3038.47
TRANSFER,Savings,2022-09-05 09:55:41,2022-09-05 09:55:41,To EUR Savings,20,0,EUR,COMPLETED,3058.47
TRANSFER,Savings,2022-09-06 12:46:14,2022-09-06 12:46:14,To EUR Savings,0.33,0,EUR,COMPLETED,3058.8
TRANSFER,Savings,2022-09-08 08:32:37,2022-09-08 08:32:37,To EUR Savings,0.33,0,EUR,COMPLETED,3059.13
TRANSFER,Savings,2022-09-08 08:53:15,2022-09-08 08:53:15,To EUR Savings,0.01,0,EUR,COMPLETED,3059.14
TRANSFER,Savings,2022-09-08 17:10:39,2022-09-08 17:10:39,To EUR Savings,0.4,0,EUR,COMPLETED,3059.54
TRANSFER,Savings,2022-09-09 12:49:44,2022-09-09 12:49:44,To EUR Savings,0.51,0,EUR,COMPLETED,3060.05
TRANSFER,Savings,2022-09-10 19:12:46,2022-09-10 19:12:46,To EUR Savings,0.55,0,EUR,COMPLETED,3060.6
TRANSFER,Savings,2022-09-11 12:13:19,2022-09-11 12:13:19,To EUR Savings,0.1,0,EUR,COMPLETED,3060.7
TRANSFER,Savings,2022-09-11 16:13:34,2022-09-11 16:13:34,To EUR Savings,0.92,0,EUR,COMPLETED,3061.62
TRANSFER,Savings,2022-09-11 20:04:06,2022-09-11 20:04:06,To EUR Savings,0.75,0,EUR,COMPLETED,3062.37
TRANSFER,Savings,2022-09-12 09:54:09,2022-09-12 09:54:09,To EUR Savings,20,0,EUR,COMPLETED,3082.37
TRANSFER,Savings,2022-09-12 16:22:24,2022-09-12 16:22:24,To EUR Savings,1,0,EUR,COMPLETED,3083.37
TRANSFER,Savings,2022-09-12 16:36:47,2022-09-12 16:36:47,To EUR Savings,0.12,0,EUR,COMPLETED,3083.49
TRANSFER,Savings,2022-09-14 20:11:12,2022-09-14 20:11:12,To EUR Savings,0.33,0,EUR,COMPLETED,3083.82
TRANSFER,Savings,2022-09-15 11:19:03,2022-09-15 11:19:03,To EUR Savings,0.1,0,EUR,COMPLETED,3083.92
TRANSFER,Savings,2022-09-15 16:37:04,2022-09-15 16:37:04,To EUR Savings,0.05,0,EUR,COMPLETED,3083.97
TRANSFER,Savings,2022-09-16 17:24:28,2022-09-16 17:24:28,To EUR Savings,0.26,0,EUR,COMPLETED,3084.23
TRANSFER,Savings,2022-09-16 17:28:30,2022-09-16 17:28:30,To EUR,-84,0,EUR,COMPLETED,3000.23
TRANSFER,Savings,2022-09-16 18:30:14,2022-09-16 18:30:14,To EUR Savings,0.76,0,EUR,COMPLETED,3000.99
TRANSFER,Savings,2022-09-16 19:58:57,2022-09-16 19:58:57,To EUR Savings,0.4,0,EUR,COMPLETED,3001.39
TRANSFER,Savings,2022-09-17 21:40:58,2022-09-17 21:40:58,To EUR Savings,0.51,0,EUR,COMPLETED,3001.9
TRANSFER,Savings,2022-09-18 09:06:28,2022-09-18 09:06:28,To EUR Savings,0.65,0,EUR,COMPLETED,3002.55
TRANSFER,Savings,2022-09-18 12:39:49,2022-09-18 12:39:49,To EUR Savings,0.01,0,EUR,COMPLETED,3002.56
TRANSFER,Savings,2022-09-18 12:54:27,2022-09-18 12:54:27,To EUR Savings,0.51,0,EUR,COMPLETED,3003.07
TRANSFER,Savings,2022-09-19 09:55:00,2022-09-19 09:55:00,To EUR Savings,20,0,EUR,COMPLETED,3023.07
TRANSFER,Savings,2022-09-22 12:42:54,2022-09-22 12:42:54,To EUR Savings,0.22,0,EUR,COMPLETED,3023.29
TRANSFER,Savings,2022-09-22 23:02:33,2022-09-22 23:02:33,To EUR Savings,0.54,0,EUR,COMPLETED,3023.83
TRANSFER,Savings,2022-09-23 08:24:43,2022-09-23 08:24:43,To EUR Savings,0.35,0,EUR,COMPLETED,3024.18
TRANSFER,Savings,2022-09-24 07:51:39,2022-09-24 07:51:39,To EUR Savings,0.65,0,EUR,COMPLETED,3024.83
TRANSFER,Savings,2022-09-24 10:42:51,2022-09-24 10:42:51,To EUR Savings,0.02,0,EUR,COMPLETED,3024.85
TRANSFER,Savings,2022-09-24 12:27:52,2022-09-24 12:27:52,To EUR Savings,0.17,0,EUR,COMPLETED,3025.02
TRANSFER,Savings,2022-09-24 13:06:01,2022-09-24 13:06:01,To EUR Savings,0.1,0,EUR,COMPLETED,3025.12
TRANSFER,Savings,2022-09-24 13:06:50,2022-09-24 13:06:50,To EUR Savings,0.8,0,EUR,COMPLETED,3025.92
TRANSFER,Savings,2022-09-24 14:00:32,2022-09-24 14:00:32,To EUR Savings,1,0,EUR,COMPLETED,3026.92
TRANSFER,Savings,2022-09-24 14:11:34,2022-09-24 14:11:34,To EUR Savings,1,0,EUR,COMPLETED,3027.92
TRANSFER,Savings,2022-09-25 08:22:02,2022-09-25 08:22:02,To EUR Savings,0.65,0,EUR,COMPLETED,3028.57
TRANSFER,Savings,2022-09-25 09:17:45,2022-09-25 09:17:45,To EUR Savings,0.34,0,EUR,COMPLETED,3028.91
TRANSFER,Savings,2022-09-25 16:01:49,2022-09-25 16:01:49,To EUR Savings,1,0,EUR,COMPLETED,3029.91
TRANSFER,Savings,2022-09-26 10:00:25,2022-09-26 10:00:25,To EUR Savings,20,0,EUR,COMPLETED,3049.91
TRANSFER,Savings,2022-09-27 00:32:20,2022-09-27 00:32:20,To EUR Savings,0.01,0,EUR,COMPLETED,3049.92
TRANSFER,Savings,2022-09-27 00:33:41,2022-09-27 00:33:41,To EUR Savings,0.51,0,EUR,COMPLETED,3050.43
TRANSFER,Savings,2022-09-27 18:23:04,2022-09-27 18:23:04,To EUR Savings,0.01,0,EUR,COMPLETED,3050.44
TRANSFER,Savings,2022-09-28 14:03:46,2022-09-28 14:03:46,To EUR Savings,0.01,0,EUR,COMPLETED,3050.45
TRANSFER,Savings,2022-09-29 12:51:08,2022-09-29 12:51:08,To EUR Savings,0.33,0,EUR,COMPLETED,3050.78
TRANSFER,Savings,2022-09-29 19:09:05,2022-09-29 19:09:05,To EUR Savings,0.12,0,EUR,COMPLETED,3050.9
TRANSFER,Savings,2022-09-30 21:09:56,2022-09-30 21:09:56,To EUR Savings,0.75,0,EUR,COMPLETED,3051.65
TRANSFER,Savings,2022-09-30 22:04:05,2022-09-30 22:04:05,To EUR Savings,1,0,EUR,COMPLETED,3052.65
TRANSFER,Savings,2022-10-01 07:56:56,2022-10-01 07:56:56,To EUR Savings,0.65,0,EUR,COMPLETED,3053.3
TRANSFER,Savings,2022-10-01 12:53:20,2022-10-01 12:53:20,To EUR Savings,1,0,EUR,COMPLETED,3054.3
TRANSFER,Savings,2022-10-01 13:05:42,2022-10-01 13:05:42,To EUR Savings,1,0,EUR,COMPLETED,3055.3
TRANSFER,Savings,2022-10-01 13:10:48,2022-10-01 13:10:48,To EUR Savings,1,0,EUR,COMPLETED,3056.3
TRANSFER,Savings,2022-10-01 20:01:01,2022-10-01 20:01:01,To EUR Savings,0.11,0,EUR,COMPLETED,3056.41
TRANSFER,Savings,2022-10-02 03:16:48,2022-10-02 03:16:48,To EUR Savings,0.01,0,EUR,COMPLETED,3056.42
TRANSFER,Savings,2022-10-02 08:34:21,2022-10-02 08:34:21,To EUR Savings,0.65,0,EUR,COMPLETED,3057.07
TRANSFER,Savings,2022-10-02 09:22:16,2022-10-02 09:22:16,To EUR Savings,0.05,0,EUR,COMPLETED,3057.12
TRANSFER,Savings,2022-10-02 09:51:12,2022-10-02 09:51:12,To EUR Savings,1,0,EUR,COMPLETED,3058.12
TRANSFER,Savings,2022-10-02 11:38:53,2022-10-02 11:38:53,To EUR Savings,0.01,0,EUR,COMPLETED,3058.13
TRANSFER,Savings,2022-10-02 17:43:39,2022-10-02 17:43:39,To EUR Savings,0.64,0,EUR,COMPLETED,3058.77
TRANSFER,Savings,2022-10-03 10:03:55,2022-10-03 10:03:55,To EUR Savings,20,0,EUR,COMPLETED,3078.77
TRANSFER,Savings,2022-10-03 10:37:36,2022-10-03 10:37:36,To EUR Savings,0.55,0,EUR,COMPLETED,3079.32
TRANSFER,Savings,2022-10-04 07:49:43,2022-10-04 07:49:43,To EUR Savings,0.3,0,EUR,COMPLETED,3079.62
TRANSFER,Savings,2022-10-04 10:19:06,2022-10-04 10:19:06,To EUR Savings,0.6,0,EUR,COMPLETED,3080.22
TRANSFER,Savings,2022-10-04 13:09:20,2022-10-04 13:09:20,To EUR Savings,0.1,0,EUR,COMPLETED,3080.32
TRANSFER,Savings,2022-10-04 16:42:45,2022-10-04 16:42:45,To EUR Savings,0.5,0,EUR,COMPLETED,3080.82
TRANSFER,Savings,2022-10-04 17:36:41,2022-10-04 17:36:41,To EUR Savings,0.39,0,EUR,COMPLETED,3081.21
TRANSFER,Savings,2022-10-05 08:23:00,2022-10-05 08:23:00,To EUR Savings,0.65,0,EUR,COMPLETED,3081.86
TRANSFER,Savings,2022-10-05 14:59:12,2022-10-05 14:59:12,To EUR Savings,0.01,0,EUR,COMPLETED,3081.87
TRANSFER,Savings,2022-10-05 20:01:26,2022-10-05 20:01:26,To EUR Savings,0.02,0,EUR,COMPLETED,3081.89
TRANSFER,Savings,2022-10-06 07:05:46,2022-10-06 07:05:46,To EUR Savings,0.53,0,EUR,COMPLETED,3082.42
TRANSFER,Savings,2022-10-06 07:24:12,2022-10-06 07:24:12,To EUR Savings,0.65,0,EUR,COMPLETED,3083.07
TRANSFER,Savings,2022-10-06 08:34:43,2022-10-06 08:34:43,To EUR Savings,0.35,0,EUR,COMPLETED,3083.42
TRANSFER,Savings,2022-10-06 13:11:02,2022-10-06 13:11:02,To EUR Savings,0.4,0,EUR,COMPLETED,3083.82
TRANSFER,Savings,2022-10-06 13:15:15,2022-10-06 13:15:15,To EUR Savings,0.6,0,EUR,COMPLETED,3084.42
TRANSFER,Savings,2022-10-06 22:23:59,2022-10-06 22:23:59,To EUR Savings,0.71,0,EUR,COMPLETED,3085.13
TRANSFER,Savings,2022-10-08 08:19:59,2022-10-08 08:19:59,To EUR Savings,0.65,0,EUR,COMPLETED,3085.78
TRANSFER,Savings,2022-10-08 15:11:46,2022-10-08 15:11:46,To EUR,-85.78,0,EUR,COMPLETED,3000
TRANSFER,Savings,2022-10-09 08:00:45,2022-10-09 08:00:45,To EUR Savings,0.65,0,EUR,COMPLETED,3000.65
TRANSFER,Savings,2022-10-09 11:41:12,2022-10-09 11:41:12,To EUR Savings,0.75,0,EUR,COMPLETED,3001.4
TRANSFER,Savings,2022-10-09 12:20:34,2022-10-09 12:20:34,To EUR Savings,0.6,0,EUR,COMPLETED,3002
TRANSFER,Savings,2022-10-09 12:40:36,2022-10-09 12:40:36,To EUR Savings,0.2,0,EUR,COMPLETED,3002.2
TRANSFER,Savings,2022-10-09 12:53:40,2022-10-09 12:53:40,To EUR Savings,1,0,EUR,COMPLETED,3003.2
TRANSFER,Savings,2022-10-10 08:32:07,2022-10-10 08:32:07,To EUR Savings,0.24,0,EUR,COMPLETED,3003.44
TRANSFER,Savings,2022-10-10 20:45:47,2022-10-10 20:45:47,To EUR Savings,20,0,EUR,COMPLETED,3023.44
TRANSFER,Savings,2022-10-13 18:19:47,2022-10-13 18:19:47,To EUR Savings,1,0,EUR,COMPLETED,3024.44
TRANSFER,Savings,2022-10-15 08:18:59,2022-10-15 08:18:59,To EUR Savings,0.65,0,EUR,COMPLETED,3025.09
TRANSFER,Savings,2022-10-15 09:17:30,2022-10-15 09:17:30,To EUR Savings,0.97,0,EUR,COMPLETED,3026.06
TRANSFER,Savings,2022-10-15 13:21:47,2022-10-15 13:21:47,To EUR Savings,0.1,0,EUR,COMPLETED,3026.16
TRANSFER,Savings,2022-10-15 13:30:16,2022-10-15 13:30:16,To EUR Savings,0.7,0,EUR,COMPLETED,3026.86
TRANSFER,Savings,2022-10-16 08:39:18,2022-10-16 08:39:18,To EUR Savings,0.65,0,EUR,COMPLETED,3027.51
TRANSFER,Savings,2022-10-16 09:53:30,2022-10-16 09:53:30,To EUR Savings,0.79,0,EUR,COMPLETED,3028.3
TRANSFER,Savings,2022-10-17 10:06:27,2022-10-17 10:06:27,To EUR Savings,20,0,EUR,COMPLETED,3048.3
TRANSFER,Savings,2022-10-17 21:40:58,2022-10-17 21:40:58,To EUR Savings,0.51,0,EUR,COMPLETED,3048.81
TRANSFER,Savings,2022-10-21 16:46:55,2022-10-21 16:46:55,To EUR Savings,1,0,EUR,COMPLETED,3049.81
TRANSFER,Savings,2022-10-22 08:03:47,2022-10-22 08:03:47,To EUR Savings,0.1,0,EUR,COMPLETED,3049.91
TRANSFER,Savings,2022-10-22 09:08:44,2022-10-22 09:08:44,To EUR Savings,0.68,0,EUR,COMPLETED,3050.59
TRANSFER,Savings,2022-10-22 15:04:43,2022-10-22 15:04:43,To EUR Savings,0.01,0,EUR,COMPLETED,3050.6
TRANSFER,Savings,2022-10-23 08:25:40,2022-10-23 08:25:40,To EUR Savings,0.1,0,EUR,COMPLETED,3050.7
TRANSFER,Savings,2022-10-23 09:51:09,2022-10-23 09:51:09,To EUR Savings,0.04,0,EUR,COMPLETED,3050.74
TRANSFER,Savings,2022-10-23 11:44:13,2022-10-23 11:44:13,To EUR Savings,0.5,0,EUR,COMPLETED,3051.24
TRANSFER,Savings,2022-10-23 11:52:51,2022-10-23 11:52:51,To EUR Savings,0.75,0,EUR,COMPLETED,3051.99
TRANSFER,Savings,2022-10-24 08:13:47,2022-10-24 08:13:47,To EUR Savings,0.35,0,EUR,COMPLETED,3052.34
TRANSFER,Savings,2022-10-24 10:08:25,2022-10-24 10:08:25,To EUR Savings,20,0,EUR,COMPLETED,3072.34
TRANSFER,Savings,2022-10-24 13:23:14,2022-10-24 13:23:14,To EUR Savings,0.01,0,EUR,COMPLETED,3072.35
TRANSFER,Savings,2022-10-25 08:43:59,2022-10-25 08:43:59,To EUR Savings,0.35,0,EUR,COMPLETED,3072.7
TRANSFER,Savings,2022-10-26 08:38:46,2022-10-26 08:38:46,To EUR Savings,0.35,0,EUR,COMPLETED,3073.05
TRANSFER,Savings,2022-10-26 17:53:37,2022-10-26 17:53:37,To EUR Savings,0.8,0,EUR,COMPLETED,3073.85
TRANSFER,Savings,2022-10-26 20:38:43,2022-10-26 20:38:43,To EUR Savings,0.99,0,EUR,COMPLETED,3074.84
TRANSFER,Savings,2022-10-26 23:01:05,2022-10-26 23:01:05,To EUR Savings,0.9,0,EUR,COMPLETED,3075.74
TRANSFER,Savings,2022-10-27 00:33:39,2022-10-27 00:33:39,To EUR Savings,0.51,0,EUR,COMPLETED,3076.25
TRANSFER,Savings,2022-10-27 00:42:24,2022-10-27 00:42:24,To EUR Savings,0.01,0,EUR,COMPLETED,3076.26
TRANSFER,Savings,2022-10-27 08:31:52,2022-10-27 08:31:52,To EUR Savings,0.35,0,EUR,COMPLETED,3076.61
TRANSFER,Savings,2022-10-27 17:45:21,2022-10-27 17:45:21,To EUR Savings,0.48,0,EUR,COMPLETED,3077.09
TRANSFER,Savings,2022-10-28 08:27:40,2022-10-28 08:27:40,To EUR Savings,0.55,0,EUR,COMPLETED,3077.64
TRANSFER,Savings,2022-10-28 14:04:03,2022-10-28 14:04:03,To EUR Savings,0.01,0,EUR,COMPLETED,3077.65
TRANSFER,Savings,2022-10-29 08:34:20,2022-10-29 08:34:20,To EUR Savings,0.1,0,EUR,COMPLETED,3077.75
TRANSFER,Savings,2022-10-29 09:26:13,2022-10-29 09:26:13,To EUR Savings,0.27,0,EUR,COMPLETED,3078.02
TRANSFER,Savings,2022-10-29 12:51:42,2022-10-29 12:51:42,To EUR Savings,0.83,0,EUR,COMPLETED,3078.85
TRANSFER,Savings,2022-10-29 13:02:16,2022-10-29 13:02:16,To EUR Savings,0.45,0,EUR,COMPLETED,3079.3
TRANSFER,Savings,2022-10-29 14:45:41,2022-10-29 14:45:41,To EUR Savings,1,0,EUR,COMPLETED,3080.3
TRANSFER,Savings,2022-10-30 08:28:20,2022-10-30 08:28:20,To EUR Savings,0.1,0,EUR,COMPLETED,3080.4
TRANSFER,Savings,2022-10-30 09:37:24,2022-10-30 09:37:24,To EUR Savings,0.73,0,EUR,COMPLETED,3081.13
TRANSFER,Savings,2022-10-30 09:49:14,2022-10-30 09:49:14,To EUR Savings,0.84,0,EUR,COMPLETED,3081.97
TRANSFER,Savings,2022-10-30 10:10:03,2022-10-30 10:10:03,To EUR Savings,0.66,0,EUR,COMPLETED,3082.63
TRANSFER,Savings,2022-10-30 12:42:55,2022-10-30 12:42:55,To EUR Savings,0.5,0,EUR,COMPLETED,3083.13
TRANSFER,Savings,2022-10-30 12:51:53,2022-10-30 12:51:53,To EUR Savings,0.5,0,EUR,COMPLETED,3083.63
TRANSFER,Savings,2022-10-30 13:21:31,2022-10-30 13:21:31,To EUR Savings,0.5,0,EUR,COMPLETED,3084.13
TRANSFER,Savings,2022-10-31 08:35:39,2022-10-31 08:35:39,To EUR Savings,0.43,0,EUR,COMPLETED,3084.56
TRANSFER,Savings,2022-10-31 14:07:25,2022-10-31 14:07:25,To EUR Savings,20,0,EUR,COMPLETED,3104.56
TRANSFER,Savings,2022-11-01 08:25:15,2022-11-01 08:25:15,To EUR Savings,0.35,0,EUR,COMPLETED,3104.91
TRANSFER,Savings,2022-11-01 10:51:09,2022-11-01 10:51:09,To EUR Savings,0.01,0,EUR,COMPLETED,3104.92
TRANSFER,Savings,2022-11-02 07:19:45,2022-11-02 07:19:45,To EUR Savings,0.5,0,EUR,COMPLETED,3105.42
TRANSFER,Savings,2022-11-02 07:54:31,2022-11-02 07:54:31,To EUR Savings,0.4,0,EUR,COMPLETED,3105.82
TRANSFER,Savings,2022-11-02 09:21:51,2022-11-02 09:21:51,To EUR Savings,0.55,0,EUR,COMPLETED,3106.37
TRANSFER,Savings,2022-11-03 08:59:39,2022-11-03 08:59:39,To EUR Savings,0.35,0,EUR,COMPLETED,3106.72
TRANSFER,Savings,2022-11-04 08:12:18,2022-11-04 08:12:18,To EUR Savings,0.35,0,EUR,COMPLETED,3107.07
TRANSFER,Savings,2022-11-05 07:43:19,2022-11-05 07:43:19,To EUR Savings,0.65,0,EUR,COMPLETED,3107.72
TRANSFER,Savings,2022-11-05 14:03:54,2022-11-05 14:03:54,To EUR Savings,0.6,0,EUR,COMPLETED,3108.32
TRANSFER,Savings,2022-11-05 14:15:09,2022-11-05 14:15:09,To EUR Savings,0.71,0,EUR,COMPLETED,3109.03
TRANSFER,Savings,2022-11-06 07:25:12,2022-11-06 07:25:12,To EUR Savings,0.25,0,EUR,COMPLETED,3109.28
TRANSFER,Savings,2022-11-06 08:21:11,2022-11-06 08:21:11,To EUR Savings,0.18,0,EUR,COMPLETED,3109.46
TRANSFER,Savings,2022-11-06 08:33:01,2022-11-06 08:33:01,To EUR Savings,0.51,0,EUR,COMPLETED,3109.97
TRANSFER,Savings,2022-11-06 17:44:13,2022-11-06 17:44:13,To EUR Savings,0.05,0,EUR,COMPLETED,3110.02
TRANSFER,Savings,2022-11-07 08:33:21,2022-11-07 08:33:21,To EUR Savings,0.35,0,EUR,COMPLETED,3110.37
TRANSFER,Savings,2022-11-07 09:15:41,2022-11-07 09:15:41,To EUR Savings,20,0,EUR,COMPLETED,3130.37
TRANSFER,Savings,2022-11-10 08:42:37,2022-11-10 08:42:37,To EUR Savings,0.35,0,EUR,COMPLETED,3130.72
TRANSFER,Savings,2022-11-11 08:29:10,2022-11-11 08:29:10,To EUR Savings,0.35,0,EUR,COMPLETED,3131.07
TRANSFER,Savings,2022-11-11 18:08:41,2022-11-11 18:08:41,To EUR Savings,0.6,0,EUR,COMPLETED,3131.67
TRANSFER,Savings,2022-11-11 20:50:56,2022-11-11 20:50:56,To EUR Savings,0.4,0,EUR,COMPLETED,3132.07
TRANSFER,Savings,2022-11-12 14:42:58,2022-11-12 14:42:58,To EUR Savings,0.7,0,EUR,COMPLETED,3132.77
TRANSFER,Savings,2022-11-13 20:31:58,2022-11-13 20:31:58,To EUR,-500,0,EUR,COMPLETED,2632.77
TRANSFER,Savings,2022-11-13 20:32:12,2022-11-13 20:32:12,To EUR Rainy day,500,0,EUR,COMPLETED,3132.77
TRANSFER,Savings,2022-11-14 08:21:28,2022-11-14 08:21:28,To EUR Savings,0.35,0,EUR,COMPLETED,3133.12
TRANSFER,Savings,2022-11-14 09:16:19,2022-11-14 09:16:19,To EUR Savings,20,0,EUR,COMPLETED,3153.12
TRANSFER,Savings,2022-11-15 08:46:28,2022-11-15 08:46:28,To EUR Savings,0.55,0,EUR,COMPLETED,3153.67
TRANSFER,Savings,2022-11-16 08:34:51,2022-11-16 08:34:51,To EUR Savings,0.35,0,EUR,COMPLETED,3154.02
TRANSFER,Savings,2022-11-16 18:34:32,2022-11-16 18:34:32,To EUR,-500,0,EUR,COMPLETED,2654.02
TRANSFER,Savings,2022-11-16 20:31:30,2022-11-16 20:31:30,To EUR Rainy day,500,0,EUR,COMPLETED,3154.02
TRANSFER,Savings,2022-11-17 08:25:05,2022-11-17 08:25:05,To EUR Savings,0.5,0,EUR,COMPLETED,3154.52
TRANSFER,Savings,2022-11-17 21:40:58,2022-11-17 21:40:58,To EUR Savings,0.51,0,EUR,COMPLETED,3155.03
TRANSFER,Savings,2022-11-19 08:38:00,2022-11-19 08:38:00,To EUR Savings,0.65,0,EUR,COMPLETED,3155.68
TRANSFER,Savings,2022-11-19 09:51:24,2022-11-19 09:51:24,To EUR Savings,0.09,0,EUR,COMPLETED,3155.77
TRANSFER,Savings,2022-11-19 10:00:47,2022-11-19 10:00:47,To EUR Savings,0.02,0,EUR,COMPLETED,3155.79
TRANSFER,Savings,2022-11-19 14:27:25,2022-11-19 14:27:25,To EUR Savings,0.5,0,EUR,COMPLETED,3156.29
TRANSFER,Savings,2022-11-20 08:07:42,2022-11-20 08:07:42,To EUR Savings,0.1,0,EUR,COMPLETED,3156.39
TRANSFER,Savings,2022-11-20 09:09:38,2022-11-20 09:09:38,To EUR Savings,0.71,0,EUR,COMPLETED,3157.1
TRANSFER,Savings,2022-11-20 10:14:22,2022-11-20 10:14:22,To EUR Savings,0.75,0,EUR,COMPLETED,3157.85
TRANSFER,Savings,2022-11-21 08:40:03,2022-11-21 08:40:03,To EUR Savings,1,0,EUR,COMPLETED,3158.85
TRANSFER,Savings,2022-11-21 09:18:11,2022-11-21 09:18:11,To EUR Savings,20,0,EUR,COMPLETED,3178.85
TRANSFER,Savings,2022-11-23 13:34:53,2022-11-23 13:34:53,To EUR Savings,0.24,0,EUR,COMPLETED,3179.09
TRANSFER,Savings,2022-11-23 17:13:18,2022-11-23 17:13:18,To EUR Savings,0.55,0,EUR,COMPLETED,3179.64
TRANSFER,Savings,2022-11-24 00:17:26,2022-11-24 00:17:26,To EUR Savings,0.75,0,EUR,COMPLETED,3180.39
TRANSFER,Savings,2022-11-24 09:07:53,2022-11-24 09:07:53,To EUR Savings,0.35,0,EUR,COMPLETED,3180.74
TRANSFER,Savings,2022-11-24 18:41:32,2022-11-24 18:41:32,To EUR Savings,0.3,0,EUR,COMPLETED,3181.04
TRANSFER,Savings,2022-11-24 18:45:48,2022-11-24 18:45:48,To EUR Savings,0.63,0,EUR,COMPLETED,3181.67
TRANSFER,Savings,2022-11-24 19:32:31,2022-11-24 19:32:31,To EUR Savings,0.65,0,EUR,COMPLETED,3182.32
TRANSFER,Savings,2022-11-25 08:48:20,2022-11-25 08:48:20,To EUR Savings,0.35,0,EUR,COMPLETED,3182.67
TRANSFER,Savings,2022-11-25 09:34:41,2022-11-25 09:34:41,To EUR Savings,1,0,EUR,COMPLETED,3183.67
TRANSFER,Savings,2022-11-25 20:10:41,2022-11-25 20:10:41,To EUR Savings,0.11,0,EUR,COMPLETED,3183.78
TRANSFER,Savings,2022-11-26 08:33:06,2022-11-26 08:33:06,To EUR Savings,0.1,0,EUR,COMPLETED,3183.88
TRANSFER,Savings,2022-11-26 11:49:59,2022-11-26 11:49:59,To EUR Savings,0.4,0,EUR,COMPLETED,3184.28
TRANSFER,Savings,2022-11-26 16:42:06,2022-11-26 16:42:06,To EUR Savings,0.01,0,EUR,COMPLETED,3184.29
TRANSFER,Savings,2022-11-26 20:49:36,2022-11-26 20:49:36,To EUR Savings,0.5,0,EUR,COMPLETED,3184.79
TRANSFER,Savings,2022-11-27 00:33:13,2022-11-27 00:33:13,To EUR Savings,0.01,0,EUR,COMPLETED,3184.8
TRANSFER,Savings,2022-11-27 00:34:08,2022-11-27 00:34:08,To EUR Savings,0.51,0,EUR,COMPLETED,3185.31
TRANSFER,Savings,2022-11-27 13:57:58,2022-11-27 13:57:58,To EUR Savings,0.3,0,EUR,COMPLETED,3185.61
TRANSFER,Savings,2022-11-28 08:51:49,2022-11-28 08:51:49,To EUR Savings,0.35,0,EUR,COMPLETED,3185.96
TRANSFER,Savings,2022-11-28 09:22:43,2022-11-28 09:22:43,To EUR Savings,20,0,EUR,COMPLETED,3205.96
TRANSFER,Savings,2022-11-28 13:03:48,2022-11-28 13:03:48,To EUR Savings,0.01,0,EUR,COMPLETED,3205.97
TRANSFER,Savings,2022-11-28 13:57:19,2022-11-28 13:57:19,To EUR Savings,0.01,0,EUR,COMPLETED,3205.98
TRANSFER,Savings,2022-11-29 08:34:38,2022-11-29 08:34:38,To EUR Savings,0.35,0,EUR,COMPLETED,3206.33
TRANSFER,Savings,2022-11-29 12:13:16,2022-11-29 12:13:16,To EUR Savings,0.5,0,EUR,COMPLETED,3206.83
TRANSFER,Savings,2022-11-29 12:29:18,2022-11-29 12:29:18,To EUR Savings,1,0,EUR,COMPLETED,3207.83
TRANSFER,Savings,2022-11-30 08:33:08,2022-11-30 08:33:08,To EUR Savings,0.35,0,EUR,COMPLETED,3208.18
TRANSFER,Savings,2022-12-01 08:17:09,2022-12-01 08:17:09,To EUR Savings,0.1,0,EUR,COMPLETED,3208.28
TRANSFER,Savings,2022-12-01 08:41:59,2022-12-01 08:41:59,To EUR Savings,0.78,0,EUR,COMPLETED,3209.06
TRANSFER,Savings,2022-12-01 08:46:12,2022-12-01 08:46:12,To EUR Savings,0.15,0,EUR,COMPLETED,3209.21
TRANSFER,Savings,2022-12-01 13:00:23,2022-12-01 13:00:23,To EUR Savings,0.33,0,EUR,COMPLETED,3209.54
TRANSFER,Savings,2022-12-02 11:17:36,2022-12-02 11:17:36,To EUR Savings,0.76,0,EUR,COMPLETED,3210.3
TRANSFER,Savings,2022-12-02 11:35:40,2022-12-02 11:35:40,To EUR Savings,0.47,0,EUR,COMPLETED,3210.77
TRANSFER,Savings,2022-12-02 12:31:21,2022-12-02 12:31:21,To EUR Savings,0.46,0,EUR,COMPLETED,3211.23
TRANSFER,Savings,2022-12-02 19:30:21,2022-12-02 19:30:21,To EUR Savings,0.81,0,EUR,COMPLETED,3212.04
TRANSFER,Savings,2022-12-03 08:07:24,2022-12-03 08:07:24,To EUR Savings,0.1,0,EUR,COMPLETED,3212.14
TRANSFER,Savings,2022-12-03 08:56:14,2022-12-03 08:56:14,To EUR Savings,0.23,0,EUR,COMPLETED,3212.37
TRANSFER,Savings,2022-12-03 09:08:53,2022-12-03 09:08:53,To EUR Savings,0.9,0,EUR,COMPLETED,3213.27
TRANSFER,Savings,2022-12-03 13:44:18,2022-12-03 13:44:18,To EUR Savings,0.13,0,EUR,COMPLETED,3213.4
TRANSFER,Savings,2022-12-04 08:27:05,2022-12-04 08:27:05,To EUR Savings,0.1,0,EUR,COMPLETED,3213.5
TRANSFER,Savings,2022-12-04 12:02:36,2022-12-04 12:02:36,To EUR Savings,0.54,0,EUR,COMPLETED,3214.04
TRANSFER,Savings,2022-12-05 08:55:49,2022-12-05 08:55:49,To EUR Savings,0.35,0,EUR,COMPLETED,3214.39
TRANSFER,Savings,2022-12-05 09:23:54,2022-12-05 09:23:54,To EUR Savings,20,0,EUR,COMPLETED,3234.39
TRANSFER,Savings,2022-12-06 19:30:29,2022-12-06 19:30:29,To EUR Savings,0.91,0,EUR,COMPLETED,3235.3
TRANSFER,Savings,2022-12-08 08:10:29,2022-12-08 08:10:29,To EUR Savings,0.1,0,EUR,COMPLETED,3235.4
TRANSFER,Savings,2022-12-09 08:40:57,2022-12-09 08:40:57,To EUR Savings,0.35,0,EUR,COMPLETED,3235.75
TRANSFER,Savings,2022-12-09 12:50:48,2022-12-09 12:50:48,To EUR Savings,0.33,0,EUR,COMPLETED,3236.08
TRANSFER,Savings,2022-12-10 09:02:45,2022-12-10 09:02:45,To EUR Savings,0.1,0,EUR,COMPLETED,3236.18
TRANSFER,Savings,2022-12-11 08:35:42,2022-12-11 08:35:42,To EUR Savings,0.1,0,EUR,COMPLETED,3236.28
TRANSFER,Savings,2022-12-11 09:19:40,2022-12-11 09:19:40,To EUR Savings,0.55,0,EUR,COMPLETED,3236.83
TRANSFER,Savings,2022-12-12 07:37:46,2022-12-12 07:37:46,To EUR Savings,0.82,0,EUR,COMPLETED,3237.65
TRANSFER,Savings,2022-12-12 08:34:53,2022-12-12 08:34:53,To EUR Savings,0.9,0,EUR,COMPLETED,3238.55
TRANSFER,Savings,2022-12-12 09:18:29,2022-12-12 09:18:29,To EUR Savings,20,0,EUR,COMPLETED,3258.55
TRANSFER,Savings,2022-12-12 14:24:30,2022-12-12 14:24:30,To EUR Savings,0.2,0,EUR,COMPLETED,3258.75
TRANSFER,Savings,2022-12-12 15:31:19,2022-12-12 15:31:19,To EUR Savings,1,0,EUR,COMPLETED,3259.75
TRANSFER,Savings,2022-12-12 16:23:02,2022-12-12 16:23:02,To EUR Savings,1,0,EUR,COMPLETED,3260.75
TRANSFER,Savings,2022-12-12 16:54:46,2022-12-12 16:54:46,To EUR Savings,0.05,0,EUR,COMPLETED,3260.8
TRANSFER,Savings,2022-12-12 17:01:23,2022-12-12 17:01:23,To EUR Savings,1,0,EUR,COMPLETED,3261.8
TRANSFER,Savings,2022-12-13 08:49:01,2022-12-13 08:49:01,To EUR Savings,0.77,0,EUR,COMPLETED,3262.57
TRANSFER,Savings,2022-12-13 15:32:09,2022-12-13 15:32:09,To EUR Savings,0.33,0,EUR,COMPLETED,3262.9
TRANSFER,Savings,2022-12-14 09:06:38,2022-12-14 09:06:38,To EUR Savings,0.2,0,EUR,COMPLETED,3263.1
TRANSFER,Savings,2022-12-14 15:23:20,2022-12-14 15:23:20,To EUR Savings,0.25,0,EUR,COMPLETED,3263.35
TRANSFER,Savings,2022-12-14 15:39:29,2022-12-14 15:39:29,To EUR Savings,0.86,0,EUR,COMPLETED,3264.21
TRANSFER,Savings,2022-12-15 12:44:13,2022-12-15 12:44:13,To EUR Savings,0.22,0,EUR,COMPLETED,3264.43
TRANSFER,Savings,2022-12-16 15:45:47,2022-12-16 15:45:47,To EUR Savings,0.01,0,EUR,COMPLETED,3264.44
TRANSFER,Savings,2022-12-17 13:14:18,2022-12-17 13:14:18,To EUR Savings,0.92,0,EUR,COMPLETED,3265.36
TRANSFER,Savings,2022-12-17 21:40:58,2022-12-17 21:40:58,To EUR Savings,0.51,0,EUR,COMPLETED,3265.87
TRANSFER,Savings,2022-12-18 08:31:21,2022-12-18 08:31:21,To EUR Savings,0.1,0,EUR,COMPLETED,3265.97
TRANSFER,Savings,2022-12-18 09:00:09,2022-12-18 09:00:09,To EUR Savings,0.19,0,EUR,COMPLETED,3266.16
TRANSFER,Savings,2022-12-19 08:57:24,2022-12-19 08:57:24,To EUR Savings,0.35,0,EUR,COMPLETED,3266.51
TRANSFER,Savings,2022-12-19 09:14:55,2022-12-19 09:14:55,To EUR Savings,20,0,EUR,COMPLETED,3286.51
TRANSFER,Savings,2022-12-21 02:15:43,2022-12-21 02:15:43,To EUR Savings,0.01,0,EUR,COMPLETED,3286.52
TRANSFER,Savings,2022-12-21 14:09:06,2022-12-21 14:09:06,To EUR Savings,0.5,0,EUR,COMPLETED,3287.02
TRANSFER,Savings,2022-12-21 23:54:05,2022-12-21 23:54:05,To EUR Savings,0.5,0,EUR,COMPLETED,3287.52
TRANSFER,Savings,2022-12-22 08:55:36,2022-12-22 08:55:36,To EUR Savings,0.1,0,EUR,COMPLETED,3287.62
TRANSFER,Savings,2022-12-22 15:03:37,2022-12-22 15:03:37,To EUR Savings,0.01,0,EUR,COMPLETED,3287.63
TRANSFER,Savings,2022-12-23 09:18:18,2022-12-23 09:18:18,To EUR Savings,0.35,0,EUR,COMPLETED,3287.98
TRANSFER,Savings,2022-12-23 11:53:55,2022-12-23 11:53:55,To EUR Savings,0.7,0,EUR,COMPLETED,3288.68
TRANSFER,Savings,2022-12-23 14:11:29,2022-12-23 14:11:29,To EUR Savings,0.9,0,EUR,COMPLETED,3289.58
TRANSFER,Savings,2022-12-24 18:36:10,2022-12-24 18:36:10,To EUR Savings,0.29,0,EUR,COMPLETED,3289.87
TRANSFER,Savings,2022-12-26 09:17:32,2022-12-26 09:17:32,To EUR Savings,20,0,EUR,COMPLETED,3309.87
TRANSFER,Savings,2022-12-26 14:18:12,2022-12-26 14:18:12,To EUR Savings,0.95,0,EUR,COMPLETED,3310.82
TRANSFER,Savings,2022-12-26 17:23:51,2022-12-26 17:23:51,To EUR Savings,0.44,0,EUR,COMPLETED,3311.26
TRANSFER,Savings,2022-12-27 00:32:38,2022-12-27 00:32:38,To EUR Savings,0.01,0,EUR,COMPLETED,3311.27
TRANSFER,Savings,2022-12-27 00:36:17,2022-12-27 00:36:17,To EUR Savings,0.51,0,EUR,COMPLETED,3311.78
TRANSFER,Savings,2022-12-27 08:19:51,2022-12-27 08:19:51,To EUR Savings,0.1,0,EUR,COMPLETED,3311.88
TRANSFER,Savings,2022-12-28 08:19:36,2022-12-28 08:19:36,To EUR Savings,0.1,0,EUR,COMPLETED,3311.98
TRANSFER,Savings,2022-12-28 08:53:15,2022-12-28 08:53:15,To EUR Savings,0.13,0,EUR,COMPLETED,3312.11
TRANSFER,Savings,2022-12-28 10:06:58,2022-12-28 10:06:58,To EUR Savings,0.02,0,EUR,COMPLETED,3312.13
TRANSFER,Savings,2022-12-28 11:13:50,2022-12-28 11:13:50,To EUR Savings,0.97,0,EUR,COMPLETED,3313.1
TRANSFER,Savings,2022-12-28 13:03:41,2022-12-28 13:03:41,To EUR Savings,0.01,0,EUR,COMPLETED,3313.11
TRANSFER,Savings,2022-12-28 15:09:14,2022-12-28 15:09:14,To EUR Savings,1,0,EUR,COMPLETED,3314.11
TRANSFER,Savings,2022-12-29 08:11:01,2022-12-29 08:11:01,To EUR Savings,0.1,0,EUR,COMPLETED,3314.21
TRANSFER,Savings,2022-12-29 12:11:03,2022-12-29 12:11:03,To EUR Savings,1,0,EUR,COMPLETED,3315.21
TRANSFER,Savings,2022-12-29 12:23:17,2022-12-29 12:23:17,To EUR Savings,0.33,0,EUR,COMPLETED,3315.54
TRANSFER,Savings,2022-12-29 15:25:11,2022-12-29 15:25:11,To EUR Savings,0.1,0,EUR,COMPLETED,3315.64
TRANSFER,Savings,2022-12-30 08:43:52,2022-12-30 08:43:52,To EUR Savings,0.1,0,EUR,COMPLETED,3315.74
TRANSFER,Savings,2022-12-30 17:01:22,2022-12-30 17:01:22,To EUR Savings,0.07,0,EUR,COMPLETED,3315.81
TRANSFER,Savings,2022-12-30 17:16:14,2022-12-30 17:16:14,To EUR Savings,0.5,0,EUR,COMPLETED,3316.31
TRANSFER,Savings,2022-12-31 08:12:41,2022-12-31 08:12:41,To EUR Savings,0.65,0,EUR,COMPLETED,3316.96
TRANSFER,Savings,2023-01-02 07:54:38,2023-01-02 07:54:38,To EUR Savings,0.65,0,EUR,COMPLETED,3317.61
TRANSFER,Savings,2023-01-02 07:56:15,2023-01-02 07:56:15,To EUR Savings,0.95,0,EUR,COMPLETED,3318.56
TRANSFER,Savings,2023-01-02 08:32:32,2023-01-02 08:32:32,To EUR Savings,0.5,0,EUR,COMPLETED,3319.06
TRANSFER,Savings,2023-01-02 09:19:38,2023-01-02 09:19:38,To EUR Savings,20,0,EUR,COMPLETED,3339.06
TRANSFER,Savings,2023-01-02 09:29:57,2023-01-02 09:29:57,To EUR Savings,1,0,EUR,COMPLETED,3340.06
TRANSFER,Savings,2023-01-02 10:11:52,2023-01-02 10:11:52,To EUR Savings,0.29,0,EUR,COMPLETED,3340.35
TRANSFER,Savings,2023-01-02 12:22:03,2023-01-02 12:22:03,To EUR Savings,0.11,0,EUR,COMPLETED,3340.46
TRANSFER,Savings,2023-01-02 15:18:02,2023-01-02 15:18:02,To EUR Savings,0.01,0,EUR,COMPLETED,3340.47
TRANSFER,Savings,2023-01-05 12:34:42,2023-01-05 12:34:42,To EUR Savings,0.33,0,EUR,COMPLETED,3340.8
TRANSFER,Savings,2023-01-05 19:10:38,2023-01-05 19:10:38,To EUR,-140,0,EUR,COMPLETED,3200.8
TRANSFER,Savings,2023-01-05 19:32:11,2023-01-05 19:32:11,To EUR Savings,0.63,0,EUR,COMPLETED,3201.43
TRANSFER,Savings,2023-01-07 08:26:14,2023-01-07 08:26:14,To EUR Savings,0.1,0,EUR,COMPLETED,3201.53
TRANSFER,Savings,2023-01-08 08:46:00,2023-01-08 08:46:00,To EUR Savings,0.1,0,EUR,COMPLETED,3201.63
TRANSFER,Savings,2023-01-08 09:17:08,2023-01-08 09:17:08,To EUR Savings,0.64,0,EUR,COMPLETED,3202.27
TRANSFER,Savings,2023-01-08 09:35:37,2023-01-08 09:35:37,To EUR Savings,0.2,0,EUR,COMPLETED,3202.47
TRANSFER,Savings,2023-01-08 12:31:25,2023-01-08 12:31:25,To EUR Savings,0.13,0,EUR,COMPLETED,3202.6
TRANSFER,Savings,2023-01-09 09:16:17,2023-01-09 09:16:17,To EUR Savings,20,0,EUR,COMPLETED,3222.6
TRANSFER,Savings,2023-01-11 21:38:08,2023-01-11 21:38:08,To EUR Savings,0.75,0,EUR,COMPLETED,3223.35
TRANSFER,Savings,2023-01-12 09:53:09,2023-01-12 09:53:09,To EUR Savings,0.7,0,EUR,COMPLETED,3224.05
TRANSFER,Savings,2023-01-12 10:57:53,2023-01-12 10:57:53,To EUR Savings,1,0,EUR,COMPLETED,3225.05
TRANSFER,Savings,2023-01-12 11:00:04,2023-01-12 11:00:04,To EUR Savings,1,0,EUR,COMPLETED,3226.05
TRANSFER,Savings,2023-01-12 11:02:17,2023-01-12 11:02:17,To EUR Savings,0.09,0,EUR,COMPLETED,3226.14
TRANSFER,Savings,2023-01-12 11:20:29,2023-01-12 11:20:29,To EUR Savings,1,0,EUR,COMPLETED,3227.14
TRANSFER,Savings,2023-01-12 12:46:26,2023-01-12 12:46:26,To EUR Savings,0.33,0,EUR,COMPLETED,3227.47
TRANSFER,Savings,2023-01-12 13:48:36,2023-01-12 13:48:36,To EUR,-127.47,0,EUR,COMPLETED,3100
TRANSFER,Savings,2023-01-13 19:44:22,2023-01-13 19:44:22,To EUR Savings,0.2,0,EUR,COMPLETED,3100.2
TRANSFER,Savings,2023-01-13 19:47:18,2023-01-13 19:47:18,To EUR Savings,0.7,0,EUR,COMPLETED,3100.9
TRANSFER,Savings,2023-01-13 22:04:52,2023-01-13 22:04:52,To EUR,-100,0,EUR,COMPLETED,3000.9
TRANSFER,Savings,2023-01-14 08:15:50,2023-01-14 08:15:50,To EUR Savings,0.1,0,EUR,COMPLETED,3001
TRANSFER,Savings,2023-01-14 15:29:31,2023-01-14 15:29:31,To EUR Savings,0.02,0,EUR,COMPLETED,3001.02
TRANSFER,Savings,2023-01-14 15:44:46,2023-01-14 15:44:46,To EUR Savings,0.5,0,EUR,COMPLETED,3001.52
TRANSFER,Savings,2023-01-14 20:00:02,2023-01-14 20:00:02,To EUR Savings,0.5,0,EUR,COMPLETED,3002.02
TRANSFER,Savings,2023-01-15 08:17:33,2023-01-15 08:17:33,To EUR Savings,0.1,0,EUR,COMPLETED,3002.12
TRANSFER,Savings,2023-01-15 09:12:29,2023-01-15 09:12:29,To EUR Savings,0.5,0,EUR,COMPLETED,3002.62
TRANSFER,Savings,2023-01-15 12:32:59,2023-01-15 12:32:59,To EUR Savings,0.81,0,EUR,COMPLETED,3003.43
TRANSFER,Savings,2023-01-15 16:30:17,2023-01-15 16:30:17,To EUR,-500,0,EUR,COMPLETED,2503.43
TRANSFER,Savings,2023-01-15 16:33:20,2023-01-15 16:33:20,To EUR Savings,0.65,0,EUR,COMPLETED,2504.08
TRANSFER,Savings,2023-01-15 20:49:13,2023-01-15 20:49:13,To EUR Savings,0.35,0,EUR,COMPLETED,2504.43
TRANSFER,Savings,2023-01-16 09:18:21,2023-01-16 09:18:21,To EUR Savings,20,0,EUR,COMPLETED,2524.43
TRANSFER,Savings,2023-01-17 21:40:58,2023-01-17 21:40:58,To EUR Savings,0.51,0,EUR,COMPLETED,2524.94
TRANSFER,Savings,2023-01-19 12:44:51,2023-01-19 12:44:51,To EUR Savings,0.33,0,EUR,COMPLETED,2525.27
TRANSFER,Savings,2023-01-19 19:41:57,2023-01-19 19:41:57,To EUR Savings,0.01,0,EUR,COMPLETED,2525.28
TRANSFER,Savings,2023-01-21 05:11:33,2023-01-21 05:11:33,To EUR Savings,0.01,0,EUR,COMPLETED,2525.29
TRANSFER,Savings,2023-01-21 08:34:04,2023-01-21 08:34:04,To EUR Savings,0.1,0,EUR,COMPLETED,2525.39
TRANSFER,Savings,2023-01-21 11:30:57,2023-01-21 11:30:57,To EUR Savings,0.8,0,EUR,COMPLETED,2526.19
TRANSFER,Savings,2023-01-21 13:10:58,2023-01-21 13:10:58,To EUR Savings,1,0,EUR,COMPLETED,2527.19
TRANSFER,Savings,2023-01-21 20:20:01,2023-01-21 20:20:01,To EUR Savings,0.9,0,EUR,COMPLETED,2528.09
TRANSFER,Savings,2023-01-22 11:28:07,2023-01-22 11:28:07,To EUR Savings,1,0,EUR,COMPLETED,2529.09
TRANSFER,Savings,2023-01-22 13:48:04,2023-01-22 13:48:04,To EUR Savings,0.1,0,EUR,COMPLETED,2529.19
TRANSFER,Savings,2023-01-22 15:03:08,2023-01-22 15:03:08,To EUR Savings,0.01,0,EUR,COMPLETED,2529.2
TRANSFER,Savings,2023-01-23 09:17:35,2023-01-23 09:17:35,To EUR Savings,20,0,EUR,COMPLETED,2549.2
TRANSFER,Savings,2023-01-26 12:55:26,2023-01-26 12:55:26,To EUR Savings,0.33,0,EUR,COMPLETED,2549.53
TRANSFER,Savings,2023-01-27 00:32:48,2023-01-27 00:32:48,To EUR Savings,0.01,0,EUR,COMPLETED,2549.54
TRANSFER,Savings,2023-01-27 00:33:54,2023-01-27 00:33:54,To EUR Savings,0.51,0,EUR,COMPLETED,2550.05
TRANSFER,Savings,2023-01-28 08:10:55,2023-01-28 08:10:55,To EUR Savings,0.1,0,EUR,COMPLETED,2550.15
TRANSFER,Savings,2023-01-28 08:41:07,2023-01-28 08:41:07,To EUR Savings,0.19,0,EUR,COMPLETED,2550.34
TRANSFER,Savings,2023-01-28 13:03:43,2023-01-28 13:03:43,To EUR Savings,0.01,0,EUR,COMPLETED,2550.35
TRANSFER,Savings,2023-01-29 08:11:16,2023-01-29 08:11:16,To EUR Savings,0.1,0,EUR,COMPLETED,2550.45
TRANSFER,Savings,2023-01-29 09:26:18,2023-01-29 09:26:18,To EUR Savings,0.5,0,EUR,COMPLETED,2550.95
TRANSFER,Savings,2023-01-29 11:21:45,2023-01-29 11:21:45,To EUR Savings,0.54,0,EUR,COMPLETED,2551.49
TRANSFER,Savings,2023-01-29 14:55:37,2023-01-29 14:55:37,To EUR Savings,0.8,0,EUR,COMPLETED,2552.29
TRANSFER,Savings,2023-01-30 09:21:05,2023-01-30 09:21:05,To EUR Savings,20,0,EUR,COMPLETED,2572.29
TRANSFER,Savings,2023-01-31 11:12:48,2023-01-31 11:12:48,To EUR Savings,0.1,0,EUR,COMPLETED,2572.39
TRANSFER,Savings,2023-02-01 19:33:05,2023-02-01 19:33:05,To EUR Savings,0.71,0,EUR,COMPLETED,2573.1
TRANSFER,Savings,2023-02-04 08:26:11,2023-02-04 08:26:11,To EUR Savings,0.5,0,EUR,COMPLETED,2573.6
TRANSFER,Savings,2023-02-05 08:14:49,2023-02-05 08:14:49,To EUR Savings,0.1,0,EUR,COMPLETED,2573.7
TRANSFER,Savings,2023-02-05 08:56:44,2023-02-05 08:56:44,To EUR Savings,0.76,0,EUR,COMPLETED,2574.46
TRANSFER,Savings,2023-02-05 09:14:14,2023-02-05 09:14:14,To EUR Savings,1,0,EUR,COMPLETED,2575.46
TRANSFER,Savings,2023-02-05 09:17:05,2023-02-05 09:17:05,To EUR Savings,0.5,0,EUR,COMPLETED,2575.96
TRANSFER,Savings,2023-02-05 09:32:08,2023-02-05 09:32:08,To EUR Savings,0.14,0,EUR,COMPLETED,2576.1
TRANSFER,Savings,2023-02-05 14:14:03,2023-02-05 14:14:03,To EUR Savings,0.8,0,EUR,COMPLETED,2576.9
TRANSFER,Savings,2023-02-05 19:40:40,2023-02-05 19:40:40,To EUR Savings,0.92,0,EUR,COMPLETED,2577.82
TRANSFER,Savings,2023-02-06 13:47:38,2023-02-06 13:47:38,To EUR Savings,20,0,EUR,COMPLETED,2597.82
TRANSFER,Savings,2023-02-11 07:52:03,2023-02-11 07:52:03,To EUR Savings,0.5,0,EUR,COMPLETED,2598.32
TRANSFER,Savings,2023-02-12 08:08:09,2023-02-12 08:08:09,To EUR Savings,0.1,0,EUR,COMPLETED,2598.42
TRANSFER,Savings,2023-02-12 08:39:20,2023-02-12 08:39:20,To EUR Savings,0.81,0,EUR,COMPLETED,2599.23
TRANSFER,Savings,2023-02-12 09:07:27,2023-02-12 09:07:27,To EUR Savings,0.06,0,EUR,COMPLETED,2599.29
TRANSFER,Savings,2023-02-12 16:35:59,2023-02-12 16:35:59,To EUR Savings,0.01,0,EUR,COMPLETED,2599.3
TRANSFER,Savings,2023-02-12 19:20:12,2023-02-12 19:20:12,To EUR Savings,0.6,0,EUR,COMPLETED,2599.9
TRANSFER,Savings,2023-02-13 09:18:19,2023-02-13 09:18:19,To EUR Savings,20,0,EUR,COMPLETED,2619.9
TRANSFER,Savings,2023-02-13 10:21:37,2023-02-13 10:21:37,To EUR Savings,0.46,0,EUR,COMPLETED,2620.36
TRANSFER,Savings,2023-02-13 11:17:14,2023-02-13 11:17:14,To EUR Savings,1,0,EUR,COMPLETED,2621.36
TRANSFER,Savings,2023-02-13 11:54:20,2023-02-13 11:54:20,To EUR Savings,0.4,0,EUR,COMPLETED,2621.76
TRANSFER,Savings,2023-02-13 12:06:55,2023-02-13 12:06:55,To EUR Savings,0.5,0,EUR,COMPLETED,2622.26
TRANSFER,Savings,2023-02-17 18:31:16,2023-02-17 18:31:16,To EUR Savings,0.84,0,EUR,COMPLETED,2623.1
TRANSFER,Savings,2023-02-17 19:29:22,2023-02-17 19:29:22,To EUR Savings,0.95,0,EUR,COMPLETED,2624.05
TRANSFER,Savings,2023-02-17 21:40:58,2023-02-17 21:40:58,To EUR Savings,0.51,0,EUR,COMPLETED,2624.56
TRANSFER,Savings,2023-02-19 08:16:13,2023-02-19 08:16:13,To EUR Savings,0.1,0,EUR,COMPLETED,2624.66
TRANSFER,Savings,2023-02-19 08:58:07,2023-02-19 08:58:07,To EUR Savings,0.62,0,EUR,COMPLETED,2625.28
TRANSFER,Savings,2023-02-19 09:09:28,2023-02-19 09:09:28,To EUR Savings,0.86,0,EUR,COMPLETED,2626.14
TRANSFER,Savings,2023-02-19 09:58:34,2023-02-19 09:58:34,To EUR Savings,0.45,0,EUR,COMPLETED,2626.59
TRANSFER,Savings,2023-02-20 08:11:04,2023-02-20 08:11:04,To EUR Savings,0.6,0,EUR,COMPLETED,2627.19
TRANSFER,Savings,2023-02-20 09:19:38,2023-02-20 09:19:38,To EUR Savings,1,0,EUR,COMPLETED,2628.19
TRANSFER,Savings,2023-02-20 09:20:21,2023-02-20 09:20:21,To EUR Savings,20,0,EUR,COMPLETED,2648.19
TRANSFER,Savings,2023-02-20 18:49:14,2023-02-20 18:49:14,To EUR Savings,0.2,0,EUR,COMPLETED,2648.39
TRANSFER,Savings,2023-02-21 08:16:23,2023-02-21 08:16:23,To EUR Savings,0.1,0,EUR,COMPLETED,2648.49
TRANSFER,Savings,2023-02-21 09:51:01,2023-02-21 09:51:01,To EUR Savings,0.3,0,EUR,COMPLETED,2648.79
TRANSFER,Savings,2023-02-21 14:11:43,2023-02-21 14:11:43,To EUR Savings,1,0,EUR,COMPLETED,2649.79
TRANSFER,Savings,2023-02-22 15:02:37,2023-02-22 15:02:37,To EUR Savings,0.01,0,EUR,COMPLETED,2649.8
TRANSFER,Savings,2023-02-25 08:09:19,2023-02-25 08:09:19,To EUR Savings,0.1,0,EUR,COMPLETED,2649.9
TRANSFER,Savings,2023-02-26 09:40:08,2023-02-26 09:40:08,To EUR Savings,0.1,0,EUR,COMPLETED,2650
TRANSFER,Savings,2023-02-26 15:55:02,2023-02-26 15:55:02,To EUR Savings,0.81,0,EUR,COMPLETED,2650.81
TRANSFER,Savings,2023-02-26 20:16:40,2023-02-26 20:16:40,To EUR Savings,0.01,0,EUR,COMPLETED,2650.82
TRANSFER,Savings,2023-02-26 20:18:13,2023-02-26 20:18:13,To EUR Savings,0.51,0,EUR,COMPLETED,2651.33
TRANSFER,Savings,2023-02-27 09:20:07,2023-02-27 09:20:07,To EUR Savings,20,0,EUR,COMPLETED,2671.33
TRANSFER,Savings,2023-02-28 13:03:43,2023-02-28 13:03:43,To EUR Savings,0.01,0,EUR,COMPLETED,2671.34
TRANSFER,Savings,2023-02-28 22:16:50,2023-02-28 22:16:50,To EUR Savings,0.2,0,EUR,COMPLETED,2671.54
TRANSFER,Savings,2023-03-02 10:59:56,2023-03-02 10:59:56,To EUR Savings,0.49,0,EUR,COMPLETED,2672.03
TRANSFER,Savings,2023-03-02 12:03:54,2023-03-02 12:03:54,To EUR Savings,1,0,EUR,COMPLETED,2673.03
TRANSFER,Savings,2023-03-02 12:15:53,2023-03-02 12:15:53,To EUR Savings,0.8,0,EUR,COMPLETED,2673.83
TRANSFER,Savings,2023-03-02 12:19:00,2023-03-02 12:19:00,To EUR Savings,0.02,0,EUR,COMPLETED,2673.85
TRANSFER,Savings,2023-03-03 10:20:06,2023-03-03 10:20:06,To EUR Savings,1,0,EUR,COMPLETED,2674.85
TRANSFER,Savings,2023-03-03 18:58:44,2023-03-03 18:58:44,To EUR Savings,1,0,EUR,COMPLETED,2675.85
TRANSFER,Savings,2023-03-04 07:31:00,2023-03-04 07:31:00,To EUR Savings,0.57,0,EUR,COMPLETED,2676.42
TRANSFER,Savings,2023-03-04 07:40:14,2023-03-04 07:40:14,To EUR Savings,0.45,0,EUR,COMPLETED,2676.87
TRANSFER,Savings,2023-03-04 12:22:18,2023-03-04 12:22:18,To EUR Savings,0.5,0,EUR,COMPLETED,2677.37
TRANSFER,Savings,2023-03-04 12:39:41,2023-03-04 12:39:41,To EUR Savings,0.5,0,EUR,COMPLETED,2677.87
TRANSFER,Savings,2023-03-05 08:15:39,2023-03-05 08:15:39,To EUR Savings,0.6,0,EUR,COMPLETED,2678.47
TRANSFER,Savings,2023-03-05 09:32:34,2023-03-05 09:32:34,To EUR Savings,0.51,0,EUR,COMPLETED,2678.98
TRANSFER,Savings,2023-03-06 09:19:40,2023-03-06 09:19:40,To EUR Savings,20,0,EUR,COMPLETED,2698.98
TRANSFER,Savings,2023-03-06 16:30:09,2023-03-06 16:30:09,To EUR Savings,0.56,0,EUR,COMPLETED,2699.54
TRANSFER,Savings,2023-03-06 23:49:17,2023-03-06 23:49:17,To EUR Savings,1,0,EUR,COMPLETED,2700.54
TRANSFER,Savings,2023-03-06 23:50:14,2023-03-06 23:50:14,To EUR Savings,1,0,EUR,COMPLETED,2701.54
TRANSFER,Savings,2023-03-07 15:49:42,2023-03-07 15:49:42,To EUR Savings,1,0,EUR,COMPLETED,2702.54
TRANSFER,Savings,2023-03-07 17:59:38,2023-03-07 17:59:38,To EUR Savings,0.05,0,EUR,COMPLETED,2702.59
TRANSFER,Savings,2023-03-08 01:30:00,2023-03-08 01:30:00,To EUR Savings,1,0,EUR,COMPLETED,2703.59
TRANSFER,Savings,2023-03-09 13:12:25,2023-03-09 13:12:25,To EUR Savings,0.95,0,EUR,COMPLETED,2704.54
TRANSFER,Savings,2023-03-10 19:30:42,2023-03-10 19:30:42,To EUR Savings,0.37,0,EUR,COMPLETED,2704.91
TRANSFER,Savings,2023-03-11 08:00:04,2023-03-11 08:00:04,To EUR Savings,0.45,0,EUR,COMPLETED,2705.36
TRANSFER,Savings,2023-03-11 09:13:20,2023-03-11 09:13:20,To EUR Savings,0.79,0,EUR,COMPLETED,2706.15
TRANSFER,Savings,2023-03-12 08:27:31,2023-03-12 08:27:31,To EUR Savings,0.6,0,EUR,COMPLETED,2706.75
TRANSFER,Savings,2023-03-12 09:05:40,2023-03-12 09:05:40,To EUR Savings,0.62,0,EUR,COMPLETED,2707.37
TRANSFER,Savings,2023-03-12 14:09:39,2023-03-12 14:09:39,To EUR Savings,0.2,0,EUR,COMPLETED,2707.57
TRANSFER,Savings,2023-03-13 09:18:14,2023-03-13 09:18:14,To EUR Savings,20,0,EUR,COMPLETED,2727.57
TRANSFER,Savings,2023-03-14 10:40:47,2023-03-14 10:40:47,To EUR Savings,0.75,0,EUR,COMPLETED,2728.32
TRANSFER,Savings,2023-03-14 10:49:20,2023-03-14 10:49:20,To EUR Savings,0.5,0,EUR,COMPLETED,2728.82
TRANSFER,Savings,2023-03-15 17:13:19,2023-03-15 17:13:19,To EUR Savings,0.81,0,EUR,COMPLETED,2729.63
TRANSFER,Savings,2023-03-15 20:01:20,2023-03-15 20:01:20,To EUR Savings,0.68,0,EUR,COMPLETED,2730.31
TRANSFER,Savings,2023-03-16 13:07:32,2023-03-16 13:07:32,To EUR Savings,0.95,0,EUR,COMPLETED,2731.26
TRANSFER,Savings,2023-03-17 21:40:58,2023-03-17 21:40:58,To EUR Savings,0.51,0,EUR,COMPLETED,2731.77
TRANSFER,Savings,2023-03-18 08:14:20,2023-03-18 08:14:20,To EUR Savings,0.45,0,EUR,COMPLETED,2732.22
TRANSFER,Savings,2023-03-18 15:24:43,2023-03-18 15:24:43,To EUR Savings,1,0,EUR,COMPLETED,2733.22
TRANSFER,Savings,2023-03-18 17:37:47,2023-03-18 17:37:47,To EUR Savings,0.2,0,EUR,COMPLETED,2733.42
TRANSFER,Savings,2023-03-18 20:07:01,2023-03-18 20:07:01,To EUR Savings,0.8,0,EUR,COMPLETED,2734.22
TRANSFER,Savings,2023-03-19 08:04:04,2023-03-19 08:04:04,To EUR Savings,0.1,0,EUR,COMPLETED,2734.32
TRANSFER,Savings,2023-03-19 08:46:07,2023-03-19 08:46:07,To EUR Savings,0.81,0,EUR,COMPLETED,2735.13
TRANSFER,Savings,2023-03-19 09:15:55,2023-03-19 09:15:55,To EUR Savings,0.12,0,EUR,COMPLETED,2735.25
TRANSFER,Savings,2023-03-19 10:47:44,2023-03-19 10:47:44,To EUR Savings,1,0,EUR,COMPLETED,2736.25
TRANSFER,Savings,2023-03-19 11:15:19,2023-03-19 11:15:19,To EUR Savings,0.83,0,EUR,COMPLETED,2737.08
TRANSFER,Savings,2023-03-20 08:32:14,2023-03-20 08:32:14,To EUR Savings,0.68,0,EUR,COMPLETED,2737.76
TRANSFER,Savings,2023-03-20 09:19:11,2023-03-20 09:19:11,To EUR Savings,20,0,EUR,COMPLETED,2757.76
TRANSFER,Savings,2023-03-21 21:00:17,2023-03-21 21:00:17,To EUR Savings,1,0,EUR,COMPLETED,2758.76
TRANSFER,Savings,2023-03-22 14:02:33,2023-03-22 14:02:33,To EUR Savings,0.01,0,EUR,COMPLETED,2758.77
TRANSFER,Savings,2023-03-23 17:04:27,2023-03-23 17:04:27,To EUR Savings,0.05,0,EUR,COMPLETED,2758.82
TRANSFER,Savings,2023-03-25 08:20:09,2023-03-25 08:20:09,To EUR Savings,0.1,0,EUR,COMPLETED,2758.92
TRANSFER,Savings,2023-03-26 08:26:16,2023-03-26 08:26:16,To EUR Savings,0.45,0,EUR,COMPLETED,2759.37
TRANSFER,Savings,2023-03-26 09:15:26,2023-03-26 09:15:26,To EUR Savings,0.94,0,EUR,COMPLETED,2760.31
TRANSFER,Savings,2023-03-26 15:23:19,2023-03-26 15:23:19,To EUR Savings,0.4,0,EUR,COMPLETED,2760.71
TRANSFER,Savings,2023-03-27 00:32:25,2023-03-27 00:32:25,To EUR Savings,0.01,0,EUR,COMPLETED,2760.72
TRANSFER,Savings,2023-03-27 00:33:32,2023-03-27 00:33:32,To EUR Savings,0.51,0,EUR,COMPLETED,2761.23
TRANSFER,Savings,2023-03-27 10:17:52,2023-03-27 10:17:52,To EUR Savings,20,0,EUR,COMPLETED,2781.23
TRANSFER,Savings,2023-03-28 11:29:46,2023-03-28 11:29:46,To EUR Savings,1,0,EUR,COMPLETED,2782.23
TRANSFER,Savings,2023-03-28 14:03:44,2023-03-28 14:03:44,To EUR Savings,0.01,0,EUR,COMPLETED,2782.24
TRANSFER,Savings,2023-03-28 21:58:49,2023-03-28 21:58:49,To EUR Savings,0.01,0,EUR,COMPLETED,2782.25
TRANSFER,Savings,2023-03-29 11:04:31,2023-03-29 11:04:31,To EUR Savings,0.01,0,EUR,COMPLETED,2782.26
TRANSFER,Savings,2023-03-30 13:09:49,2023-03-30 13:09:49,To EUR Savings,1,0,EUR,COMPLETED,2783.26
TRANSFER,Savings,2023-03-31 19:42:44,2023-03-31 19:42:44,To EUR Savings,0.5,0,EUR,COMPLETED,2783.76
TRANSFER,Savings,2023-04-01 08:10:30,2023-04-01 08:10:30,To EUR Savings,0.45,0,EUR,COMPLETED,2784.21
TRANSFER,Savings,2023-04-01 12:46:07,2023-04-01 12:46:07,To EUR Savings,0.95,0,EUR,COMPLETED,2785.16
TRANSFER,Savings,2023-04-02 08:30:36,2023-04-02 08:30:36,To EUR Savings,0.1,0,EUR,COMPLETED,2785.26
TRANSFER,Savings,2023-04-02 09:10:14,2023-04-02 09:10:14,To EUR Savings,0.92,0,EUR,COMPLETED,2786.18
TRANSFER,Savings,2023-04-02 14:49:58,2023-04-02 14:49:58,To EUR Savings,0.5,0,EUR,COMPLETED,2786.68
TRANSFER,Savings,2023-04-03 10:19:53,2023-04-03 10:19:53,To EUR Savings,20,0,EUR,COMPLETED,2806.68
TRANSFER,Savings,2023-04-04 08:53:54,2023-04-04 08:53:54,To EUR Savings,0.66,0,EUR,COMPLETED,2807.34
TRANSFER,Savings,2023-04-04 12:04:57,2023-04-04 12:04:57,To EUR Savings,0.43,0,EUR,COMPLETED,2807.77
TRANSFER,Savings,2023-04-05 08:47:15,2023-04-05 08:47:15,To EUR Savings,0.2,0,EUR,COMPLETED,2807.97
TRANSFER,Savings,2023-04-06 13:55:51,2023-04-06 13:55:51,To EUR,-1028.31,0,EUR,COMPLETED,1779.66
TRANSFER,Savings,2023-04-06 13:58:57,2023-04-06 13:58:57,To EUR Savings,0.69,0,EUR,COMPLETED,1780.35
TRANSFER,Savings,2023-04-06 15:42:19,2023-04-06 15:42:19,To EUR Savings,0.56,0,EUR,COMPLETED,1780.91
TRANSFER,Savings,2023-04-07 00:21:21,2023-04-07 00:21:21,To EUR Savings,0.8,0,EUR,COMPLETED,1781.71
TRANSFER,Savings,2023-04-07 01:04:00,2023-04-07 01:04:00,To EUR Savings,1,0,EUR,COMPLETED,1782.71
TRANSFER,Savings,2023-04-07 01:04:00,2023-04-07 01:04:00,To EUR Savings,1,0,EUR,COMPLETED,1783.71
TRANSFER,Savings,2023-04-07 01:04:00,2023-04-07 01:04:00,To EUR Savings,1,0,EUR,COMPLETED,1784.71
TRANSFER,Savings,2023-04-07 08:19:37,2023-04-07 08:19:37,To EUR Savings,1,0,EUR,COMPLETED,1785.71
TRANSFER,Savings,2023-04-07 08:27:08,2023-04-07 08:27:08,To EUR Savings,0.45,0,EUR,COMPLETED,1786.16
TRANSFER,Savings,2023-04-07 20:24:44,2023-04-07 20:24:44,To EUR Savings,0.31,0,EUR,COMPLETED,1786.47
TRANSFER,Savings,2023-04-08 08:28:49,2023-04-08 08:28:49,To EUR Savings,0.1,0,EUR,COMPLETED,1786.57
TRANSFER,Savings,2023-04-08 09:18:05,2023-04-08 09:18:05,To EUR Savings,0.89,0,EUR,COMPLETED,1787.46
TRANSFER,Savings,2023-04-08 14:51:23,2023-04-08 14:51:23,To EUR Savings,1,0,EUR,COMPLETED,1788.46
TRANSFER,Savings,2023-04-08 15:36:45,2023-04-08 15:36:45,To EUR Savings,0.01,0,EUR,COMPLETED,1788.47
TRANSFER,Savings,2023-04-08 18:22:38,2023-04-08 18:22:38,To EUR Savings,1,0,EUR,COMPLETED,1789.47
TRANSFER,Savings,2023-04-09 08:21:04,2023-04-09 08:21:04,To EUR Savings,0.1,0,EUR,COMPLETED,1789.57
TRANSFER,Savings,2023-04-09 09:01:47,2023-04-09 09:01:47,To EUR Savings,0.01,0,EUR,COMPLETED,1789.58
TRANSFER,Savings,2023-04-09 09:15:53,2023-04-09 09:15:53,To EUR Savings,0.05,0,EUR,COMPLETED,1789.63
TRANSFER,Savings,2023-04-09 09:31:35,2023-04-09 09:31:35,To EUR Savings,0.02,0,EUR,COMPLETED,1789.65
TRANSFER,Savings,2023-04-09 17:16:00,2023-04-09 17:16:00,To EUR Savings,1,0,EUR,COMPLETED,1790.65
TRANSFER,Savings,2023-04-10 10:22:01,2023-04-10 10:22:01,To EUR Savings,20,0,EUR,COMPLETED,1810.65
TRANSFER,Savings,2023-04-13 19:16:06,2023-04-13 19:16:06,To EUR Savings,0.71,0,EUR,COMPLETED,1811.36
TRANSFER,Savings,2023-04-14 13:31:15,2023-04-14 13:31:15,To EUR Savings,0.46,0,EUR,COMPLETED,1811.82
TRANSFER,Savings,2023-04-15 08:04:18,2023-04-15 08:04:18,To EUR Savings,0.45,0,EUR,COMPLETED,1812.27
TRANSFER,Savings,2023-04-15 14:49:53,2023-04-15 14:49:53,To EUR Savings,1,0,EUR,COMPLETED,1813.27
TRANSFER,Savings,2023-04-15 21:06:16,2023-04-15 21:06:16,To EUR Savings,0.7,0,EUR,COMPLETED,1813.97
TRANSFER,Savings,2023-04-16 10:09:03,2023-04-16 10:09:03,To EUR Savings,0.75,0,EUR,COMPLETED,1814.72
TRANSFER,Savings,2023-04-16 10:35:23,2023-04-16 10:35:23,To EUR Savings,1,0,EUR,COMPLETED,1815.72
TRANSFER,Savings,2023-04-16 13:55:28,2023-04-16 13:55:28,To EUR Savings,0.9,0,EUR,COMPLETED,1816.62
TRANSFER,Savings,2023-04-16 16:06:47,2023-04-16 16:06:47,To EUR Savings,1,0,EUR,COMPLETED,1817.62
TRANSFER,Savings,2023-04-16 20:07:37,2023-04-16 20:07:37,To EUR Savings,0.05,0,EUR,COMPLETED,1817.67
TRANSFER,Savings,2023-04-17 10:16:03,2023-04-17 10:16:03,To EUR Savings,20,0,EUR,COMPLETED,1837.67
TRANSFER,Savings,2023-04-17 21:40:58,2023-04-17 21:40:58,To EUR Savings,0.51,0,EUR,COMPLETED,1838.18
TRANSFER,Savings,2023-04-18 16:58:45,2023-04-18 16:58:45,To EUR Savings,1,0,EUR,COMPLETED,1839.18
TRANSFER,Savings,2023-04-19 14:00:09,2023-04-19 14:00:09,To EUR Savings,1,0,EUR,COMPLETED,1840.18
TRANSFER,Savings,2023-04-20 07:41:24,2023-04-20 07:41:24,To EUR Savings,0.45,0,EUR,COMPLETED,1840.63
TRANSFER,Savings,2023-04-20 12:45:44,2023-04-20 12:45:44,To EUR Savings,0.95,0,EUR,COMPLETED,1841.58
TRANSFER,Savings,2023-04-22 08:17:29,2023-04-22 08:17:29,To EUR Savings,0.1,0,EUR,COMPLETED,1841.68
TRANSFER,Savings,2023-04-22 09:10:27,2023-04-22 09:10:27,To EUR Savings,0.55,0,EUR,COMPLETED,1842.23
TRANSFER,Savings,2023-04-22 09:30:50,2023-04-22 09:30:50,To EUR Savings,0.82,0,EUR,COMPLETED,1843.05
TRANSFER,Savings,2023-04-22 13:47:17,2023-04-22 13:47:17,To EUR Savings,1,0,EUR,COMPLETED,1844.05
TRANSFER,Savings,2023-04-22 15:02:42,2023-04-22 15:02:42,To EUR Savings,0.01,0,EUR,COMPLETED,1844.06
TRANSFER,Savings,2023-04-22 15:14:35,2023-04-22 15:14:35,To EUR Savings,0.2,0,EUR,COMPLETED,1844.26
TRANSFER,Savings,2023-04-23 08:29:35,2023-04-23 08:29:35,To EUR Savings,0.1,0,EUR,COMPLETED,1844.36
TRANSFER,Savings,2023-04-24 10:15:51,2023-04-24 10:15:51,To EUR Savings,20,0,EUR,COMPLETED,1864.36
TRANSFER,Savings,2023-04-24 17:59:19,2023-04-24 17:59:19,To EUR Savings,0.46,0,EUR,COMPLETED,1864.82
TRANSFER,Savings,2023-04-25 08:09:41,2023-04-25 08:09:41,To EUR Savings,1,0,EUR,COMPLETED,1865.82
TRANSFER,Savings,2023-04-25 08:14:15,2023-04-25 08:14:15,To EUR Savings,0.45,0,EUR,COMPLETED,1866.27
TRANSFER,Savings,2023-04-25 15:01:27,2023-04-25 15:01:27,To EUR Savings,0.4,0,EUR,COMPLETED,1866.67
TRANSFER,Savings,2023-04-27 00:32:45,2023-04-27 00:32:45,To EUR Savings,0.01,0,EUR,COMPLETED,1866.68
TRANSFER,Savings,2023-04-27 00:33:37,2023-04-27 00:33:37,To EUR Savings,0.51,0,EUR,COMPLETED,1867.19
TRANSFER,Savings,2023-04-27 13:06:45,2023-04-27 13:06:45,To EUR Savings,0.95,0,EUR,COMPLETED,1868.14
TRANSFER,Savings,2023-04-28 13:59:37,2023-04-28 13:59:37,To EUR Savings,0.01,0,EUR,COMPLETED,1868.15
TRANSFER,Savings,2023-04-28 14:03:54,2023-04-28 14:03:54,To EUR Savings,0.01,0,EUR,COMPLETED,1868.16
TRANSFER,Savings,2023-04-29 08:28:40,2023-04-29 08:28:40,To EUR Savings,0.05,0,EUR,COMPLETED,1868.21
TRANSFER,Savings,2023-04-29 11:56:58,2023-04-29 11:56:58,To EUR Savings,0.39,0,EUR,COMPLETED,1868.6
TRANSFER,Savings,2023-04-29 20:43:28,2023-04-29 20:43:28,To EUR Savings,0.35,0,EUR,COMPLETED,1868.95
TRANSFER,Savings,2023-04-30 08:17:44,2023-04-30 08:17:44,To EUR Savings,0.1,0,EUR,COMPLETED,1869.05
TRANSFER,Savings,2023-04-30 19:56:49,2023-04-30 19:56:49,To EUR Savings,0.1,0,EUR,COMPLETED,1869.15
TRANSFER,Savings,2023-05-01 08:16:38,2023-05-01 08:16:38,To EUR Savings,0.1,0,EUR,COMPLETED,1869.25
TRANSFER,Savings,2023-05-01 10:56:05,2023-05-01 10:56:05,To EUR Savings,20,0,EUR,COMPLETED,1889.25
TRANSFER,Savings,2023-05-01 13:07:26,2023-05-01 13:07:26,To EUR Savings,0.4,0,EUR,COMPLETED,1889.65
TRANSFER,Savings,2023-05-01 14:41:01,2023-05-01 14:41:01,To EUR Savings,0.44,0,EUR,COMPLETED,1890.09
TRANSFER,Savings,2023-05-03 09:35:50,2023-05-03 09:35:50,To EUR Savings,0.62,0,EUR,COMPLETED,1890.71
TRANSFER,Savings,2023-05-04 13:05:48,2023-05-04 13:05:48,To EUR Savings,0.46,0,EUR,COMPLETED,1891.17
TRANSFER,Savings,2023-05-05 23:43:02,2023-05-05 23:43:02,To EUR Savings,1,0,EUR,COMPLETED,1892.17
TRANSFER,Savings,2023-05-06 08:28:41,2023-05-06 08:28:41,To EUR Savings,0.45,0,EUR,COMPLETED,1892.62
TRANSFER,Savings,2023-05-06 17:23:32,2023-05-06 17:23:32,To EUR Savings,0.77,0,EUR,COMPLETED,1893.39
TRANSFER,Savings,2023-05-07 08:30:55,2023-05-07 08:30:55,To EUR Savings,0.1,0,EUR,COMPLETED,1893.49
TRANSFER,Savings,2023-05-08 10:17:53,2023-05-08 10:17:53,To EUR Savings,20,0,EUR,COMPLETED,1913.49
TRANSFER,Savings,2023-05-09 13:56:50,2023-05-09 13:56:50,To EUR Savings,0.7,0,EUR,COMPLETED,1914.19
TRANSFER,Savings,2023-05-10 07:51:04,2023-05-10 07:51:04,To EUR Savings,1,0,EUR,COMPLETED,1915.19
TRANSFER,Savings,2023-05-10 08:01:25,2023-05-10 08:01:25,To EUR Savings,0.45,0,EUR,COMPLETED,1915.64
TRANSFER,Savings,2023-05-10 14:41:42,2023-05-10 14:41:42,To EUR Savings,0.1,0,EUR,COMPLETED,1915.74
TRANSFER,Savings,2023-05-12 13:28:57,2023-05-12 13:28:57,To EUR Savings,0.41,0,EUR,COMPLETED,1916.15
TRANSFER,Savings,2023-05-12 19:29:04,2023-05-12 19:29:04,To EUR Savings,0.01,0,EUR,COMPLETED,1916.16
TRANSFER,Savings,2023-05-13 13:04:38,2023-05-13 13:04:38,To EUR Savings,0.86,0,EUR,COMPLETED,1917.02
TRANSFER,Savings,2023-05-13 19:02:12,2023-05-13 19:02:12,To EUR Savings,0.17,0,EUR,COMPLETED,1917.19
TRANSFER,Savings,2023-05-13 20:26:51,2023-05-13 20:26:51,To EUR Savings,0.46,0,EUR,COMPLETED,1917.65
TRANSFER,Savings,2023-05-14 02:56:03,2023-05-14 02:56:03,To EUR Savings,0.78,0,EUR,COMPLETED,1918.43
TRANSFER,Savings,2023-05-14 09:42:24,2023-05-14 09:42:24,To EUR Savings,0.13,0,EUR,COMPLETED,1918.56
TRANSFER,Savings,2023-05-14 10:17:23,2023-05-14 10:17:23,To EUR Savings,0.56,0,EUR,COMPLETED,1919.12
TRANSFER,Savings,2023-05-14 15:03:34,2023-05-14 15:03:34,To EUR Savings,0.77,0,EUR,COMPLETED,1919.89
TRANSFER,Savings,2023-05-15 02:27:08,2023-05-15 02:27:08,To EUR Savings,0.88,0,EUR,COMPLETED,1920.77
TRANSFER,Savings,2023-05-15 09:46:49,2023-05-15 09:46:49,To EUR Savings,0.46,0,EUR,COMPLETED,1921.23
TRANSFER,Savings,2023-05-15 10:21:19,2023-05-15 10:21:19,To EUR Savings,20,0,EUR,COMPLETED,1941.23
TRANSFER,Savings,2023-05-15 19:29:35,2023-05-15 19:29:35,To EUR Savings,0.54,0,EUR,COMPLETED,1941.77
TRANSFER,Savings,2023-05-15 19:38:16,2023-05-15 19:38:16,To EUR Savings,0.52,0,EUR,COMPLETED,1942.29
TRANSFER,Savings,2023-05-16 21:44:05,2023-05-16 21:44:05,To EUR Savings,0.23,0,EUR,COMPLETED,1942.52
TRANSFER,Savings,2023-05-16 21:47:05,2023-05-16 21:47:05,To EUR Savings,0.27,0,EUR,COMPLETED,1942.79
TRANSFER,Savings,2023-05-17 16:09:29,2023-05-17 16:09:29,To EUR Savings,0.4,0,EUR,COMPLETED,1943.19
TRANSFER,Savings,2023-05-17 21:20:13,2023-05-17 21:20:13,To EUR Savings,0.77,0,EUR,COMPLETED,1943.96
TRANSFER,Savings,2023-05-17 21:40:58,2023-05-17 21:40:58,To EUR Savings,0.51,0,EUR,COMPLETED,1944.47
TRANSFER,Savings,2023-05-18 03:12:55,2023-05-18 03:12:55,To EUR Savings,0.98,0,EUR,COMPLETED,1945.45
TRANSFER,Savings,2023-05-18 12:24:55,2023-05-18 12:24:55,To EUR Savings,0.21,0,EUR,COMPLETED,1945.66
TRANSFER,Savings,2023-05-18 15:09:47,2023-05-18 15:09:47,To EUR Savings,0.88,0,EUR,COMPLETED,1946.54
TRANSFER,Savings,2023-05-18 15:10:10,2023-05-18 15:10:10,To EUR Savings,0.39,0,EUR,COMPLETED,1946.93
TRANSFER,Savings,2023-05-18 15:35:06,2023-05-18 15:35:06,To EUR Savings,0.48,0,EUR,COMPLETED,1947.41
TRANSFER,Savings,2023-05-18 16:56:32,2023-05-18 16:56:32,To EUR Savings,0.7,0,EUR,COMPLETED,1948.11
TRANSFER,Savings,2023-05-19 03:16:15,2023-05-19 03:16:15,To EUR Savings,0.66,0,EUR,COMPLETED,1948.77
TRANSFER,Savings,2023-05-19 19:13:54,2023-05-19 19:13:54,To EUR Savings,0.81,0,EUR,COMPLETED,1949.58
TRANSFER,Savings,2023-05-20 07:13:22,2023-05-20 07:13:22,To EUR Savings,1,0,EUR,COMPLETED,1950.58
TRANSFER,Savings,2023-05-20 07:18:56,2023-05-20 07:18:56,To EUR Savings,0.45,0,EUR,COMPLETED,1951.03
TRANSFER,Savings,2023-05-20 09:15:56,2023-05-20 09:15:56,To EUR Savings,0.27,0,EUR,COMPLETED,1951.3
TRANSFER,Savings,2023-05-20 09:32:22,2023-05-20 09:32:22,To EUR Savings,0.05,0,EUR,COMPLETED,1951.35
TRANSFER,Savings,2023-05-20 11:23:39,2023-05-20 11:23:39,To EUR Savings,0.72,0,EUR,COMPLETED,1952.07
TRANSFER,Savings,2023-05-21 08:20:43,2023-05-21 08:20:43,To EUR Savings,0.1,0,EUR,COMPLETED,1952.17
TRANSFER,Savings,2023-05-21 11:07:23,2023-05-21 11:07:23,To EUR,-80,0,EUR,COMPLETED,1872.17
TRANSFER,Savings,2023-05-22 10:15:18,2023-05-22 10:15:18,To EUR Savings,20,0,EUR,COMPLETED,1892.17
TRANSFER,Savings,2023-05-23 08:41:22,2023-05-23 08:41:22,To EUR Savings,0.06,0,EUR,COMPLETED,1892.23
TRANSFER,Savings,2023-05-24 17:42:49,2023-05-24 17:42:49,To EUR Savings,1,0,EUR,COMPLETED,1893.23
TRANSFER,Savings,2023-05-25 12:44:23,2023-05-25 12:44:23,To EUR Savings,0.85,0,EUR,COMPLETED,1894.08
TRANSFER,Savings,2023-05-27 00:33:26,2023-05-27 00:33:26,To EUR Savings,0.01,0,EUR,COMPLETED,1894.09
TRANSFER,Savings,2023-05-27 00:33:47,2023-05-27 00:33:47,To EUR Savings,0.51,0,EUR,COMPLETED,1894.6
TRANSFER,Savings,2023-05-27 08:19:18,2023-05-27 08:19:18,To EUR Savings,0.6,0,EUR,COMPLETED,1895.2
TRANSFER,Savings,2023-05-27 12:42:06,2023-05-27 12:42:06,To EUR Savings,0.04,0,EUR,COMPLETED,1895.24
TRANSFER,Savings,2023-05-28 08:25:42,2023-05-28 08:25:42,To EUR Savings,0.1,0,EUR,COMPLETED,1895.34
TRANSFER,Savings,2023-05-28 13:59:15,2023-05-28 13:59:15,To EUR Savings,0.01,0,EUR,COMPLETED,1895.35
TRANSFER,Savings,2023-05-28 14:03:41,2023-05-28 14:03:41,To EUR Savings,0.01,0,EUR,COMPLETED,1895.36
TRANSFER,Savings,2023-05-29 10:16:21,2023-05-29 10:16:21,To EUR Savings,20,0,EUR,COMPLETED,1915.36
TRANSFER,Savings,2023-05-30 02:54:16,2023-05-30 02:54:16,To EUR Savings,0.05,0,EUR,COMPLETED,1915.41
TRANSFER,Savings,2023-05-30 07:52:20,2023-05-30 07:52:20,To EUR Savings,0.6,0,EUR,COMPLETED,1916.01
TRANSFER,Savings,2023-05-30 09:01:14,2023-05-30 09:01:14,To EUR Savings,1,0,EUR,COMPLETED,1917.01
TRANSFER,Savings,2023-05-30 13:19:26,2023-05-30 13:19:26,To EUR Savings,0.1,0,EUR,COMPLETED,1917.11
TRANSFER,Savings,2023-05-30 20:20:54,2023-05-30 20:20:54,To EUR Savings,0.3,0,EUR,COMPLETED,1917.41
TRANSFER,Savings,2023-06-01 13:01:56,2023-06-01 13:01:56,To EUR Savings,0.85,0,EUR,COMPLETED,1918.26
TRANSFER,Savings,2023-06-01 15:00:00,2023-06-01 15:00:00,To EUR Savings,0.7,0,EUR,COMPLETED,1918.96
TRANSFER,Savings,2023-06-02 12:45:58,2023-06-02 12:45:58,To EUR Savings,0.71,0,EUR,COMPLETED,1919.67
TRANSFER,Savings,2023-06-02 13:00:17,2023-06-02 13:00:17,To EUR Savings,0.69,0,EUR,COMPLETED,1920.36
TRANSFER,Savings,2023-06-02 19:35:25,2023-06-02 19:35:25,To EUR Savings,0.5,0,EUR,COMPLETED,1920.86
TRANSFER,Savings,2023-06-03 08:11:35,2023-06-03 08:11:35,To EUR Savings,0.1,0,EUR,COMPLETED,1920.96
TRANSFER,Savings,2023-06-03 14:39:01,2023-06-03 14:39:01,To EUR Savings,1,0,EUR,COMPLETED,1921.96
TRANSFER,Savings,2023-06-03 14:44:27,2023-06-03 14:44:27,To EUR Savings,0.05,0,EUR,COMPLETED,1922.01
TRANSFER,Savings,2023-06-03 16:50:50,2023-06-03 16:50:50,To EUR Savings,0.61,0,EUR,COMPLETED,1922.62
TRANSFER,Savings,2023-06-03 19:47:07,2023-06-03 19:47:07,To EUR Savings,0.9,0,EUR,COMPLETED,1923.52
TRANSFER,Savings,2023-06-04 15:12:47,2023-06-04 15:12:47,To EUR Savings,1,0,EUR,COMPLETED,1924.52
TRANSFER,Savings,2023-06-04 20:17:15,2023-06-04 20:17:15,To EUR Savings,0.84,0,EUR,COMPLETED,1925.36
TRANSFER,Savings,2023-06-05 10:21:19,2023-06-05 10:21:19,To EUR Savings,20,0,EUR,COMPLETED,1945.36
TRANSFER,Savings,2023-06-08 08:23:57,2023-06-08 08:23:57,To EUR Savings,0.1,0,EUR,COMPLETED,1945.46
TRANSFER,Savings,2023-06-09 12:48:14,2023-06-09 12:48:14,To EUR Savings,0.71,0,EUR,COMPLETED,1946.17
TRANSFER,Savings,2023-06-10 08:11:21,2023-06-10 08:11:21,To EUR Savings,0.1,0,EUR,COMPLETED,1946.27
TRANSFER,Savings,2023-06-10 12:51:39,2023-06-10 12:51:39,To EUR Savings,1,0,EUR,COMPLETED,1947.27
TRANSFER,Savings,2023-06-10 13:36:28,2023-06-10 13:36:28,To EUR Savings,0.7,0,EUR,COMPLETED,1947.97
TRANSFER,Savings,2023-06-10 20:43:17,2023-06-10 20:43:17,To EUR Savings,1,0,EUR,COMPLETED,1948.97
TRANSFER,Savings,2023-06-11 08:35:23,2023-06-11 08:35:23,To EUR Savings,0.1,0,EUR,COMPLETED,1949.07
TRANSFER,Savings,2023-06-11 09:14:41,2023-06-11 09:14:41,To EUR Savings,0.05,0,EUR,COMPLETED,1949.12
TRANSFER,Savings,2023-06-11 16:29:24,2023-06-11 16:29:24,To EUR Savings,1,0,EUR,COMPLETED,1950.12
TRANSFER,Savings,2023-06-12 10:16:14,2023-06-12 10:16:14,To EUR Savings,20,0,EUR,COMPLETED,1970.12
TRANSFER,Savings,2023-06-12 18:46:46,2023-06-12 18:46:46,To EUR Savings,0.89,0,EUR,COMPLETED,1971.01
TRANSFER,Savings,2023-06-13 08:08:22,2023-06-13 08:08:22,To EUR Savings,0.1,0,EUR,COMPLETED,1971.11
TRANSFER,Savings,2023-06-13 19:51:02,2023-06-13 19:51:02,To EUR Savings,0.26,0,EUR,COMPLETED,1971.37
TRANSFER,Savings,2023-06-16 12:57:25,2023-06-16 12:57:25,To EUR Savings,0.58,0,EUR,COMPLETED,1971.95
TRANSFER,Savings,2023-06-17 07:52:23,2023-06-17 07:52:23,To EUR Savings,0.45,0,EUR,COMPLETED,1972.4
TRANSFER,Savings,2023-06-17 09:13:02,2023-06-17 09:13:02,To EUR Savings,0.15,0,EUR,COMPLETED,1972.55
TRANSFER,Savings,2023-06-17 10:10:56,2023-06-17 10:10:56,To EUR,-1151,0,EUR,COMPLETED,821.55
TRANSFER,Savings,2023-06-17 10:13:56,2023-06-17 10:13:56,To EUR Savings,1,0,EUR,COMPLETED,822.55
TRANSFER,Savings,2023-06-17 10:49:44,2023-06-17 10:49:44,To EUR Savings,0.01,0,EUR,COMPLETED,822.56
TRANSFER,Savings,2023-06-17 15:00:39,2023-06-17 15:00:39,To EUR Savings,0.24,0,EUR,COMPLETED,822.8
TRANSFER,Savings,2023-06-17 19:52:03,2023-06-17 19:52:03,To EUR Savings,0.26,0,EUR,COMPLETED,823.06
TRANSFER,Savings,2023-06-17 21:40:58,2023-06-17 21:40:58,To EUR Savings,0.51,0,EUR,COMPLETED,823.57
TRANSFER,Savings,2023-06-18 08:17:45,2023-06-18 08:17:45,To EUR Savings,0.1,0,EUR,COMPLETED,823.67
TRANSFER,Savings,2023-06-18 09:14:49,2023-06-18 09:14:49,To EUR Savings,0.13,0,EUR,COMPLETED,823.8
TRANSFER,Savings,2023-06-18 12:24:19,2023-06-18 12:24:19,To EUR Savings,0.01,0,EUR,COMPLETED,823.81
TRANSFER,Savings,2023-06-19 08:39:46,2023-06-19 08:39:46,To EUR Savings,1,0,EUR,COMPLETED,824.81
TRANSFER,Savings,2023-06-19 08:42:40,2023-06-19 08:42:40,To EUR Savings,0.84,0,EUR,COMPLETED,825.65
TRANSFER,Savings,2023-06-19 10:14:28,2023-06-19 10:14:28,To EUR Savings,20,0,EUR,COMPLETED,845.65
TRANSFER,Savings,2023-06-19 13:24:30,2023-06-19 13:24:30,To EUR Savings,0.8,0,EUR,COMPLETED,846.45
TRANSFER,Savings,2023-06-19 17:49:17,2023-06-19 17:49:17,To EUR Savings,0.8,0,EUR,COMPLETED,847.25
TRANSFER,Savings,2023-06-21 16:14:49,2023-06-21 16:14:49,To EUR Savings,0.28,0,EUR,COMPLETED,847.53
TRANSFER,Savings,2023-06-22 09:09:18,2023-06-22 09:09:18,To EUR Savings,0.33,0,EUR,COMPLETED,847.86
TRANSFER,Savings,2023-06-22 13:04:06,2023-06-22 13:04:06,To EUR Savings,0.46,0,EUR,COMPLETED,848.32
TRANSFER,Savings,2023-06-23 08:23:55,2023-06-23 08:23:55,To EUR Rainy day,2679.31,0,EUR,COMPLETED,3527.63
TRANSFER,Savings,2023-06-23 15:30:40,2023-06-23 15:30:40,To EUR Savings,0.21,0,EUR,COMPLETED,3527.84
TRANSFER,Savings,2023-06-24 08:13:37,2023-06-24 08:13:37,To EUR Savings,0.1,0,EUR,COMPLETED,3527.94
TRANSFER,Savings,2023-06-24 09:34:56,2023-06-24 09:34:56,To EUR Savings,0.14,0,EUR,COMPLETED,3528.08
TRANSFER,Savings,2023-06-24 12:49:14,2023-06-24 12:49:14,To EUR Savings,0.47,0,EUR,COMPLETED,3528.55
TRANSFER,Savings,2023-06-24 19:50:47,2023-06-24 19:50:47,To EUR Savings,0.48,0,EUR,COMPLETED,3529.03
TRANSFER,Savings,2023-06-25 07:23:52,2023-06-25 07:23:52,To EUR Savings,0.05,0,EUR,COMPLETED,3529.08
TRANSFER,Savings,2023-06-25 09:17:12,2023-06-25 09:17:12,To EUR Savings,0.01,0,EUR,COMPLETED,3529.09
TRANSFER,Savings,2023-06-25 21:03:26,2023-06-25 21:03:26,To EUR Savings,1,0,EUR,COMPLETED,3530.09
TRANSFER,Savings,2023-06-26 10:17:46,2023-06-26 10:17:46,To EUR Savings,20,0,EUR,COMPLETED,3550.09
TRANSFER,Savings,2023-06-27 00:33:48,2023-06-27 00:33:48,To EUR Savings,0.51,0,EUR,COMPLETED,3550.6
TRANSFER,Savings,2023-06-27 00:39:38,2023-06-27 00:39:38,To EUR Savings,0.01,0,EUR,COMPLETED,3550.61
TRANSFER,Savings,2023-06-27 07:29:47,2023-06-27 07:29:47,To EUR Savings,0.05,0,EUR,COMPLETED,3550.66
TRANSFER,Savings,2023-06-27 14:23:41,2023-06-27 14:23:41,To EUR Savings,1,0,EUR,COMPLETED,3551.66
TRANSFER,Savings,2023-06-27 17:32:14,2023-06-27 17:32:14,To EUR Savings,0.31,0,EUR,COMPLETED,3551.97
TRANSFER,Savings,2023-06-27 17:40:36,2023-06-27 17:40:36,To EUR Savings,0.32,0,EUR,COMPLETED,3552.29
TRANSFER,Savings,2023-06-28 10:02:03,2023-06-28 10:02:03,To EUR Savings,0.4,0,EUR,COMPLETED,3552.69
TRANSFER,Savings,2023-06-28 12:05:47,2023-06-28 12:05:47,To EUR Savings,0.8,0,EUR,COMPLETED,3553.49
TRANSFER,Savings,2023-06-28 14:03:44,2023-06-28 14:03:44,To EUR Savings,0.01,0,EUR,COMPLETED,3553.5
TRANSFER,Savings,2023-06-29 09:17:06,2023-06-29 09:17:06,To EUR Savings,0.7,0,EUR,COMPLETED,3554.2
TRANSFER,Savings,2023-06-29 09:35:52,2023-06-29 09:35:52,To EUR Savings,0.45,0,EUR,COMPLETED,3554.65
TRANSFER,Savings,2023-06-29 10:28:24,2023-06-29 10:28:24,To EUR Savings,0.76,0,EUR,COMPLETED,3555.41
TRANSFER,Savings,2023-06-29 15:58:01,2023-06-29 15:58:01,To EUR Savings,0.2,0,EUR,COMPLETED,3555.61
TRANSFER,Savings,2023-06-30 02:54:20,2023-06-30 02:54:20,To EUR Savings,0.05,0,EUR,COMPLETED,3555.66
TRANSFER,Savings,2023-06-30 11:21:35,2023-06-30 11:21:35,To EUR Savings,0.7,0,EUR,COMPLETED,3556.36
TRANSFER,Savings,2023-06-30 12:25:08,2023-06-30 12:25:08,To EUR Savings,0.01,0,EUR,COMPLETED,3556.37
TRANSFER,Savings,2023-06-30 12:32:28,2023-06-30 12:32:28,To EUR Savings,0.9,0,EUR,COMPLETED,3557.27
TRANSFER,Savings,2023-06-30 19:30:36,2023-06-30 19:30:36,To EUR Savings,0.8,0,EUR,COMPLETED,3558.07
TRANSFER,Savings,2023-07-01 09:24:47,2023-07-01 09:24:47,To EUR Savings,0.1,0,EUR,COMPLETED,3558.17
TRANSFER,Savings,2023-07-01 13:48:03,2023-07-01 13:48:03,To EUR Savings,0.6,0,EUR,COMPLETED,3558.77
TRANSFER,Savings,2023-07-02 04:41:59,2023-07-02 04:41:59,To EUR Savings,0.91,0,EUR,COMPLETED,3559.68
TRANSFER,Savings,2023-07-02 09:16:26,2023-07-02 09:16:26,To EUR Savings,0.5,0,EUR,COMPLETED,3560.18
TRANSFER,Savings,2023-07-02 10:18:55,2023-07-02 10:18:55,To EUR Savings,0.42,0,EUR,COMPLETED,3560.6
TRANSFER,Savings,2023-07-02 10:34:51,2023-07-02 10:34:51,To EUR Savings,0.9,0,EUR,COMPLETED,3561.5
TRANSFER,Savings,2023-07-03 10:18:35,2023-07-03 10:18:35,To EUR Savings,20,0,EUR,COMPLETED,3581.5
TRANSFER,Savings,2023-07-03 14:40:18,2023-07-03 14:40:18,To EUR Savings,0.75,0,EUR,COMPLETED,3582.25
TRANSFER,Savings,2023-07-05 09:14:08,2023-07-05 09:14:08,To EUR Savings,0.79,0,EUR,COMPLETED,3583.04
TRANSFER,Savings,2023-07-06 12:55:12,2023-07-06 12:55:12,To EUR Savings,0.58,0,EUR,COMPLETED,3583.62
TRANSFER,Savings,2023-07-07 21:10:47,2023-07-07 21:10:47,To EUR Savings,0.85,0,EUR,COMPLETED,3584.47
TRANSFER,Savings,2023-07-08 07:38:41,2023-07-08 07:38:41,To EUR Savings,0.05,0,EUR,COMPLETED,3584.52
TRANSFER,Savings,2023-07-08 13:17:31,2023-07-08 13:17:31,To EUR Savings,0.55,0,EUR,COMPLETED,3585.07
TRANSFER,Savings,2023-07-08 23:41:31,2023-07-08 23:41:31,To EUR Savings,0.5,0,EUR,COMPLETED,3585.57
TRANSFER,Savings,2023-07-09 08:17:52,2023-07-09 08:17:52,To EUR Savings,0.25,0,EUR,COMPLETED,3585.82
TRANSFER,Savings,2023-07-09 09:18:05,2023-07-09 09:18:05,To EUR Savings,0.39,0,EUR,COMPLETED,3586.21
TRANSFER,Savings,2023-07-09 09:40:36,2023-07-09 09:40:36,To EUR Savings,0.61,0,EUR,COMPLETED,3586.82
TRANSFER,Savings,2023-07-09 10:16:46,2023-07-09 10:16:46,To EUR Savings,0.87,0,EUR,COMPLETED,3587.69
TRANSFER,Savings,2023-07-10 10:20:44,2023-07-10 10:20:44,To EUR Savings,20,0,EUR,COMPLETED,3607.69
TRANSFER,Savings,2023-07-12 12:57:41,2023-07-12 12:57:41,To EUR Savings,0.58,0,EUR,COMPLETED,3608.27
TRANSFER,Savings,2023-07-13 20:35:58,2023-07-13 20:35:58,To EUR Savings,0.74,0,EUR,COMPLETED,3609.01
TRANSFER,Savings,2023-07-14 21:00:17,2023-07-14 21:00:17,To EUR Savings,0.32,0,EUR,COMPLETED,3609.33
TRANSFER,Savings,2023-07-15 07:12:22,2023-07-15 07:12:22,To EUR Savings,0.05,0,EUR,COMPLETED,3609.38
TRANSFER,Savings,2023-07-17 10:14:28,2023-07-17 10:14:28,To EUR Savings,20,0,EUR,COMPLETED,3629.38
TRANSFER,Savings,2023-07-17 21:40:58,2023-07-17 21:40:58,To EUR Savings,0.51,0,EUR,COMPLETED,3629.89
TRANSFER,Savings,2023-07-17 21:50:52,2023-07-17 21:50:52,To EUR Savings,1,0,EUR,COMPLETED,3630.89
TRANSFER,Savings,2023-07-19 10:41:59,2023-07-19 10:41:59,To EUR Savings,1,0,EUR,COMPLETED,3631.89
TRANSFER,Savings,2023-07-19 12:55:51,2023-07-19 12:55:51,To EUR Savings,0.05,0,EUR,COMPLETED,3631.94
TRANSFER,Savings,2023-07-21 13:07:32,2023-07-21 13:07:32,To EUR Savings,0.08,0,EUR,COMPLETED,3632.02
TRANSFER,Savings,2023-07-22 07:23:43,2023-07-22 07:23:43,To EUR Savings,0.05,0,EUR,COMPLETED,3632.07
TRANSFER,Savings,2023-07-22 13:58:27,2023-07-22 13:58:27,To EUR Savings,0.81,0,EUR,COMPLETED,3632.88
TRANSFER,Savings,2023-07-22 20:17:31,2023-07-22 20:17:31,To EUR Savings,0.71,0,EUR,COMPLETED,3633.59
TRANSFER,Savings,2023-07-23 08:07:18,2023-07-23 08:07:18,To EUR Savings,0.25,0,EUR,COMPLETED,3633.84
TRANSFER,Savings,2023-07-23 11:24:39,2023-07-23 11:24:39,To EUR Savings,0.21,0,EUR,COMPLETED,3634.05
TRANSFER,Savings,2023-07-23 17:26:19,2023-07-23 17:26:19,To EUR Savings,1,0,EUR,COMPLETED,3635.05
TRANSFER,Savings,2023-07-23 18:08:39,2023-07-23 18:08:39,To EUR Savings,0.05,0,EUR,COMPLETED,3635.1
TRANSFER,Savings,2023-07-24 10:13:52,2023-07-24 10:13:52,To EUR Savings,20,0,EUR,COMPLETED,3655.1
TRANSFER,Savings,2023-07-24 14:45:50,2023-07-24 14:45:50,To EUR Savings,0.01,0,EUR,COMPLETED,3655.11
TRANSFER,Savings,2023-07-26 20:14:08,2023-07-26 20:14:08,To EUR Savings,0.87,0,EUR,COMPLETED,3655.98
TRANSFER,Savings,2023-07-27 00:32:33,2023-07-27 00:32:33,To EUR Savings,0.01,0,EUR,COMPLETED,3655.99
TRANSFER,Savings,2023-07-27 00:35:19,2023-07-27 00:35:19,To EUR Savings,0.51,0,EUR,COMPLETED,3656.5
TRANSFER,Savings,2023-07-27 13:07:20,2023-07-27 13:07:20,To EUR Savings,0.08,0,EUR,COMPLETED,3656.58
TRANSFER,Savings,2023-07-27 20:36:30,2023-07-27 20:36:30,To EUR Savings,0.1,0,EUR,COMPLETED,3656.68
TRANSFER,Savings,2023-07-27 20:39:48,2023-07-27 20:39:48,To EUR Savings,0.5,0,EUR,COMPLETED,3657.18
TRANSFER,Savings,2023-07-27 20:52:03,2023-07-27 20:52:03,To EUR Savings,1,0,EUR,COMPLETED,3658.18
TRANSFER,Savings,2023-07-28 11:58:39,2023-07-28 11:58:39,To EUR Savings,0.01,0,EUR,COMPLETED,3658.19
TRANSFER,Savings,2023-07-28 14:03:44,2023-07-28 14:03:44,To EUR Savings,0.01,0,EUR,COMPLETED,3658.2
TRANSFER,Savings,2023-07-29 08:12:19,2023-07-29 08:12:19,To EUR Savings,0.25,0,EUR,COMPLETED,3658.45
TRANSFER,Savings,2023-07-29 08:52:16,2023-07-29 08:52:16,To EUR Savings,0.51,0,EUR,COMPLETED,3658.96
TRANSFER,Savings,2023-07-29 21:29:01,2023-07-29 21:29:01,To EUR Savings,0.3,0,EUR,COMPLETED,3659.26
TRANSFER,Savings,2023-07-30 02:54:04,2023-07-30 02:54:04,To EUR Savings,0.05,0,EUR,COMPLETED,3659.31
TRANSFER,Savings,2023-07-30 08:19:42,2023-07-30 08:19:42,To EUR Savings,0.25,0,EUR,COMPLETED,3659.56
TRANSFER,Savings,2023-07-30 08:51:13,2023-07-30 08:51:13,To EUR Savings,0.38,0,EUR,COMPLETED,3659.94
TRANSFER,Savings,2023-07-30 20:51:41,2023-07-30 20:51:41,To EUR Savings,0.3,0,EUR,COMPLETED,3660.24
TRANSFER,Savings,2023-07-31 10:19:50,2023-07-31 10:19:50,To EUR Savings,20,0,EUR,COMPLETED,3680.24
TRANSFER,Savings,2023-07-31 11:13:32,2023-07-31 11:13:32,To EUR Savings,0.05,0,EUR,COMPLETED,3680.29
TRANSFER,Savings,2023-07-31 13:08:46,2023-07-31 13:08:46,To EUR Savings,0.3,0,EUR,COMPLETED,3680.59
TRANSFER,Savings,2023-07-31 16:34:45,2023-07-31 16:34:45,To EUR Savings,1,0,EUR,COMPLETED,3681.59
TRANSFER,Savings,2023-07-31 18:27:46,2023-07-31 18:27:46,To EUR Savings,0.52,0,EUR,COMPLETED,3682.11
TRANSFER,Savings,2023-08-01 11:02:28,2023-08-01 11:02:28,To EUR Savings,0.9,0,EUR,COMPLETED,3683.01
TRANSFER,Savings,2023-08-01 14:51:34,2023-08-01 14:51:34,To EUR Savings,0.5,0,EUR,COMPLETED,3683.51
TRANSFER,Savings,2023-08-02 09:19:32,2023-08-02 09:19:32,To EUR Savings,0.25,0,EUR,COMPLETED,3683.76
TRANSFER,Savings,2023-08-02 11:43:32,2023-08-02 11:43:32,To EUR Savings,0.6,0,EUR,COMPLETED,3684.36
TRANSFER,Savings,2023-08-02 19:28:44,2023-08-02 19:28:44,To EUR Savings,0.66,0,EUR,COMPLETED,3685.02
TRANSFER,Savings,2023-08-04 08:47:49,2023-08-04 08:47:49,To EUR Savings,0.01,0,EUR,COMPLETED,3685.03
TRANSFER,Savings,2023-08-04 13:47:30,2023-08-04 13:47:30,To EUR Savings,0.1,0,EUR,COMPLETED,3685.13
TRANSFER,Savings,2023-08-04 19:12:16,2023-08-04 19:12:16,To EUR Savings,0.86,0,EUR,COMPLETED,3685.99
TRANSFER,Savings,2023-08-05 17:43:15,2023-08-05 17:43:15,To EUR Savings,0.9,0,EUR,COMPLETED,3686.89
TRANSFER,Savings,2023-08-06 07:51:37,2023-08-06 07:51:37,To EUR Savings,1,0,EUR,COMPLETED,3687.89
TRANSFER,Savings,2023-08-06 10:13:13,2023-08-06 10:13:13,To EUR Savings,1,0,EUR,COMPLETED,3688.89
TRANSFER,Savings,2023-08-07 10:14:51,2023-08-07 10:14:51,To EUR Savings,20,0,EUR,COMPLETED,3708.89
TRANSFER,Savings,2023-08-07 20:11:42,2023-08-07 20:11:42,To EUR Savings,0.4,0,EUR,COMPLETED,3709.29
TRANSFER,Savings,2023-08-10 12:42:47,2023-08-10 12:42:47,To EUR Savings,0.2,0,EUR,COMPLETED,3709.49
TRANSFER,Savings,2023-08-10 13:12:34,2023-08-10 13:12:34,To EUR Savings,0.1,0,EUR,COMPLETED,3709.59
TRANSFER,Savings,2023-08-10 19:10:08,2023-08-10 19:10:08,To EUR Savings,0.8,0,EUR,COMPLETED,3710.39
TRANSFER,Savings,2023-08-11 21:12:31,2023-08-11 21:12:31,To EUR Savings,0.6,0,EUR,COMPLETED,3710.99
TRANSFER,Savings,2023-08-12 08:33:51,2023-08-12 08:33:51,To EUR Savings,0.25,0,EUR,COMPLETED,3711.24
TRANSFER,Savings,2023-08-12 09:28:40,2023-08-12 09:28:40,To EUR Savings,0.52,0,EUR,COMPLETED,3711.76
TRANSFER,Savings,2023-08-12 09:45:02,2023-08-12 09:45:02,To EUR Savings,0.67,0,EUR,COMPLETED,3712.43
TRANSFER,Savings,2023-08-13 07:32:50,2023-08-13 07:32:50,To EUR Savings,0.05,0,EUR,COMPLETED,3712.48
TRANSFER,Savings,2023-08-13 12:38:44,2023-08-13 12:38:44,To EUR Savings,1,0,EUR,COMPLETED,3713.48
TRANSFER,Savings,2023-08-13 17:10:31,2023-08-13 17:10:31,To EUR Savings,0.9,0,EUR,COMPLETED,3714.38
TRANSFER,Savings,2023-08-14 10:12:54,2023-08-14 10:12:54,To EUR Savings,20,0,EUR,COMPLETED,3734.38
TRANSFER,Savings,2023-08-14 20:38:14,2023-08-14 20:38:14,To EUR Savings,0.24,0,EUR,COMPLETED,3734.62
TRANSFER,Savings,2023-08-14 20:43:18,2023-08-14 20:43:18,To EUR Savings,0.4,0,EUR,COMPLETED,3735.02
TRANSFER,Savings,2023-08-15 19:06:11,2023-08-15 19:06:11,To EUR Savings,0.5,0,EUR,COMPLETED,3735.52
TRANSFER,Savings,2023-08-16 13:10:11,2023-08-16 13:10:11,To EUR Savings,0.27,0,EUR,COMPLETED,3735.79
TRANSFER,Savings,2023-08-17 13:03:39,2023-08-17 13:03:39,To EUR Savings,0.16,0,EUR,COMPLETED,3735.95
TRANSFER,Savings,2023-08-17 21:40:58,2023-08-17 21:40:58,To EUR Savings,0.51,0,EUR,COMPLETED,3736.46
TRANSFER,Savings,2023-08-19 08:07:36,2023-08-19 08:07:36,To EUR Savings,0.1,0,EUR,COMPLETED,3736.56
TRANSFER,Savings,2023-08-19 13:28:04,2023-08-19 13:28:04,To EUR Savings,0.5,0,EUR,COMPLETED,3737.06
TRANSFER,Savings,2023-08-19 13:36:20,2023-08-19 13:36:20,To EUR Savings,0.2,0,EUR,COMPLETED,3737.26
TRANSFER,Savings,2023-08-19 13:39:51,2023-08-19 13:39:51,To EUR Savings,1,0,EUR,COMPLETED,3738.26
TRANSFER,Savings,2023-08-19 14:09:40,2023-08-19 14:09:40,To EUR Savings,1,0,EUR,COMPLETED,3739.26
TRANSFER,Savings,2023-08-20 08:09:09,2023-08-20 08:09:09,To EUR Savings,0.1,0,EUR,COMPLETED,3739.36
TRANSFER,Savings,2023-08-20 09:27:15,2023-08-20 09:27:15,To EUR Savings,0.03,0,EUR,COMPLETED,3739.39
TRANSFER,Savings,2023-08-20 09:42:12,2023-08-20 09:42:12,To EUR Savings,0.19,0,EUR,COMPLETED,3739.58
TRANSFER,Savings,2023-08-20 13:16:34,2023-08-20 13:16:34,To EUR Savings,0.06,0,EUR,COMPLETED,3739.64
TRANSFER,Savings,2023-08-21 07:51:23,2023-08-21 07:51:23,To EUR Savings,1,0,EUR,COMPLETED,3740.64
TRANSFER,Savings,2023-08-21 10:12:48,2023-08-21 10:12:48,To EUR Savings,20,0,EUR,COMPLETED,3760.64
TRANSFER,Savings,2023-08-23 09:14:49,2023-08-23 09:14:49,To EUR Savings,0.05,0,EUR,COMPLETED,3760.69
TRANSFER,Savings,2023-08-23 09:55:26,2023-08-23 09:55:26,To EUR Savings,0.65,0,EUR,COMPLETED,3761.34
TRANSFER,Savings,2023-08-24 08:11:03,2023-08-24 08:11:03,To EUR Savings,0.25,0,EUR,COMPLETED,3761.59
TRANSFER,Savings,2023-08-24 12:39:55,2023-08-24 12:39:55,To EUR Savings,0.08,0,EUR,COMPLETED,3761.67
TRANSFER,Savings,2023-08-24 19:11:04,2023-08-24 19:11:04,To EUR Savings,0.5,0,EUR,COMPLETED,3762.17
TRANSFER,Savings,2023-08-25 08:04:28,2023-08-25 08:04:28,To EUR Savings,0.25,0,EUR,COMPLETED,3762.42
TRANSFER,Savings,2023-08-25 21:17:37,2023-08-25 21:17:37,To EUR Savings,0.78,0,EUR,COMPLETED,3763.2
TRANSFER,Savings,2023-08-25 23:58:42,2023-08-25 23:58:42,To EUR Savings,0.76,0,EUR,COMPLETED,3763.96
TRANSFER,Savings,2023-08-26 07:50:54,2023-08-26 07:50:54,To EUR Savings,0.05,0,EUR,COMPLETED,3764.01
TRANSFER,Savings,2023-08-26 11:31:11,2023-08-26 11:31:11,To EUR Savings,0.31,0,EUR,COMPLETED,3764.32
TRANSFER,Savings,2023-08-27 00:32:23,2023-08-27 00:32:23,To EUR Savings,0.01,0,EUR,COMPLETED,3764.33
TRANSFER,Savings,2023-08-27 00:34:07,2023-08-27 00:34:07,To EUR Savings,0.51,0,EUR,COMPLETED,3764.84
TRANSFER,Savings,2023-08-27 08:24:24,2023-08-27 08:24:24,To EUR Savings,0.25,0,EUR,COMPLETED,3765.09
TRANSFER,Savings,2023-08-27 08:57:03,2023-08-27 08:57:03,To EUR Savings,0.52,0,EUR,COMPLETED,3765.61
TRANSFER,Savings,2023-08-27 09:06:15,2023-08-27 09:06:15,To EUR Savings,0.64,0,EUR,COMPLETED,3766.25
TRANSFER,Savings,2023-08-27 13:08:35,2023-08-27 13:08:35,To EUR Savings,0.93,0,EUR,COMPLETED,3767.18
TRANSFER,Savings,2023-08-27 13:18:54,2023-08-27 13:18:54,To EUR Savings,0.44,0,EUR,COMPLETED,3767.62
TRANSFER,Savings,2023-08-27 22:59:48,2023-08-27 22:59:48,To EUR Savings,0.74,0,EUR,COMPLETED,3768.36
TRANSFER,Savings,2023-08-27 23:04:00,2023-08-27 23:04:00,To EUR Savings,0.74,0,EUR,COMPLETED,3769.1
TRANSFER,Savings,2023-08-27 23:08:01,2023-08-27 23:08:01,To EUR Savings,0.64,0,EUR,COMPLETED,3769.74
TRANSFER,Savings,2023-08-28 10:17:03,2023-08-28 10:17:03,To EUR Savings,20,0,EUR,COMPLETED,3789.74
TRANSFER,Savings,2023-08-28 14:04:16,2023-08-28 14:04:16,To EUR Savings,0.01,0,EUR,COMPLETED,3789.75
TRANSFER,Savings,2023-08-30 02:53:41,2023-08-30 02:53:41,To EUR Savings,0.05,0,EUR,COMPLETED,3789.8
TRANSFER,Savings,2023-08-31 12:37:55,2023-08-31 12:37:55,To EUR Savings,0.08,0,EUR,COMPLETED,3789.88
TRANSFER,Savings,2023-09-01 21:56:20,2023-09-01 21:56:20,To EUR Savings,0.93,0,EUR,COMPLETED,3790.81
TRANSFER,Savings,2023-09-02 07:39:50,2023-09-02 07:39:50,To EUR Savings,0.05,0,EUR,COMPLETED,3790.86
TRANSFER,Savings,2023-09-02 11:26:55,2023-09-02 11:26:55,To EUR Savings,0.18,0,EUR,COMPLETED,3791.04
TRANSFER,Savings,2023-09-03 08:05:01,2023-09-03 08:05:01,To EUR Savings,0.25,0,EUR,COMPLETED,3791.29
TRANSFER,Savings,2023-09-03 09:54:30,2023-09-03 09:54:30,To EUR Savings,0.2,0,EUR,COMPLETED,3791.49
TRANSFER,Savings,2023-09-03 10:15:35,2023-09-03 10:15:35,To EUR Savings,0.32,0,EUR,COMPLETED,3791.81
TRANSFER,Savings,2023-09-04 10:15:14,2023-09-04 10:15:14,To EUR Savings,20,0,EUR,COMPLETED,3811.81
TRANSFER,Savings,2023-09-04 20:15:40,2023-09-04 20:15:40,To EUR Savings,0.36,0,EUR,COMPLETED,3812.17
TRANSFER,Savings,2023-09-05 17:43:24,2023-09-05 17:43:24,To EUR Savings,0.66,0,EUR,COMPLETED,3812.83
TRANSFER,Savings,2023-09-07 12:52:39,2023-09-07 12:52:39,To EUR Savings,0.83,0,EUR,COMPLETED,3813.66
TRANSFER,Savings,2023-09-08 14:03:03,2023-09-08 14:03:03,To EUR Savings,1,0,EUR,COMPLETED,3814.66
TRANSFER,Savings,2023-09-08 19:27:06,2023-09-08 19:27:06,To EUR Savings,0.5,0,EUR,COMPLETED,3815.16
TRANSFER,Savings,2023-09-09 08:26:43,2023-09-09 08:26:43,To EUR Savings,0.1,0,EUR,COMPLETED,3815.26
TRANSFER,Savings,2023-09-10 08:27:00,2023-09-10 08:27:00,To EUR Savings,0.1,0,EUR,COMPLETED,3815.36
TRANSFER,Savings,2023-09-10 12:07:24,2023-09-10 12:07:24,To EUR Savings,0.03,0,EUR,COMPLETED,3815.39
TRANSFER,Savings,2023-09-11 10:14:09,2023-09-11 10:14:09,To EUR Savings,20,0,EUR,COMPLETED,3835.39
TRANSFER,Savings,2023-09-12 12:51:34,2023-09-12 12:51:34,To EUR Savings,0.94,0,EUR,COMPLETED,3836.33
TRANSFER,Savings,2023-09-13 20:23:58,2023-09-13 20:23:58,To EUR Savings,0.02,0,EUR,COMPLETED,3836.35
TRANSFER,Savings,2023-09-14 12:43:38,2023-09-14 12:43:38,To EUR Savings,0.72,0,EUR,COMPLETED,3837.07
TRANSFER,Savings,2023-09-16 08:40:25,2023-09-16 08:40:25,To EUR Savings,0.05,0,EUR,COMPLETED,3837.12
TRANSFER,Savings,2023-09-17 08:23:28,2023-09-17 08:23:28,To EUR Savings,0.1,0,EUR,COMPLETED,3837.22
TRANSFER,Savings,2023-09-17 09:07:44,2023-09-17 09:07:44,To EUR Savings,0.8,0,EUR,COMPLETED,3838.02
TRANSFER,Savings,2023-09-17 12:29:46,2023-09-17 12:29:46,To EUR Savings,0.95,0,EUR,COMPLETED,3838.97
TRANSFER,Savings,2023-09-17 13:34:52,2023-09-17 13:34:52,To EUR Savings,0.01,0,EUR,COMPLETED,3838.98
TRANSFER,Savings,2023-09-17 21:40:59,2023-09-17 21:40:59,To EUR Savings,0.51,0,EUR,COMPLETED,3839.49
TRANSFER,Savings,2023-09-18 10:12:50,2023-09-18 10:12:50,To EUR Savings,20,0,EUR,COMPLETED,3859.49
TRANSFER,Savings,2023-09-18 20:05:36,2023-09-18 20:05:36,To EUR Savings,0.15,0,EUR,COMPLETED,3859.64
TRANSFER,Savings,2023-09-21 13:09:59,2023-09-21 13:09:59,To EUR Savings,0.3,0,EUR,COMPLETED,3859.94
TRANSFER,Savings,2023-09-21 13:11:12,2023-09-21 13:11:12,To EUR Savings,0.3,0,EUR,COMPLETED,3860.24
TRANSFER,Savings,2023-09-23 08:25:10,2023-09-23 08:25:10,To EUR Savings,0.1,0,EUR,COMPLETED,3860.34
TRANSFER,Savings,2023-09-23 21:43:16,2023-09-23 21:43:16,To EUR Savings,0.01,0,EUR,COMPLETED,3860.35
TRANSFER,Savings,2023-09-24 08:08:17,2023-09-24 08:08:17,To EUR Savings,0.1,0,EUR,COMPLETED,3860.45
TRANSFER,Savings,2023-09-24 09:06:41,2023-09-24 09:06:41,To EUR Savings,0.45,0,EUR,COMPLETED,3860.9
TRANSFER,Savings,2023-09-25 10:15:51,2023-09-25 10:15:51,To EUR Savings,20,0,EUR,COMPLETED,3880.9
TRANSFER,Savings,2023-09-27 00:32:34,2023-09-27 00:32:34,To EUR Savings,0.01,0,EUR,COMPLETED,3880.91
TRANSFER,Savings,2023-09-27 00:34:14,2023-09-27 00:34:14,To EUR Savings,0.51,0,EUR,COMPLETED,3881.42
TRANSFER,Savings,2023-09-28 12:57:52,2023-09-28 12:57:52,To EUR Savings,0.2,0,EUR,COMPLETED,3881.62
TRANSFER,Savings,2023-09-28 14:03:43,2023-09-28 14:03:43,To EUR Savings,0.01,0,EUR,COMPLETED,3881.63
TRANSFER,Savings,2023-09-29 18:08:27,2023-09-29 18:08:27,To EUR Savings,0.26,0,EUR,COMPLETED,3881.89
TRANSFER,Savings,2023-09-29 20:22:12,2023-09-29 20:22:12,To EUR Savings,0.91,0,EUR,COMPLETED,3882.8
TRANSFER,Savings,2023-09-29 22:44:00,2023-09-29 22:44:00,To EUR Savings,0.01,0,EUR,COMPLETED,3882.81
TRANSFER,Savings,2023-09-30 02:54:16,2023-09-30 02:54:16,To EUR Savings,0.05,0,EUR,COMPLETED,3882.86
TRANSFER,Savings,2023-09-30 08:06:58,2023-09-30 08:06:58,To EUR Savings,0.1,0,EUR,COMPLETED,3882.96
TRANSFER,Savings,2023-09-30 09:14:41,2023-09-30 09:14:41,To EUR Savings,0.14,0,EUR,COMPLETED,3883.1
TRANSFER,Savings,2023-10-01 08:13:59,2023-10-01 08:13:59,To EUR Savings,0.1,0,EUR,COMPLETED,3883.2
TRANSFER,Savings,2023-10-01 12:51:41,2023-10-01 12:51:41,To EUR Savings,0.1,0,EUR,COMPLETED,3883.3
TRANSFER,Savings,2023-10-01 12:52:46,2023-10-01 12:52:46,To EUR Savings,0.1,0,EUR,COMPLETED,3883.4
TRANSFER,Savings,2023-10-01 13:00:57,2023-10-01 13:00:57,To EUR Savings,0.5,0,EUR,COMPLETED,3883.9
TRANSFER,Savings,2023-10-01 13:39:53,2023-10-01 13:39:53,To EUR Savings,1,0,EUR,COMPLETED,3884.9
TRANSFER,Savings,2023-10-01 14:21:10,2023-10-01 14:21:10,To EUR Savings,0.01,0,EUR,COMPLETED,3884.91
TRANSFER,Savings,2023-10-01 19:38:16,2023-10-01 19:38:16,To EUR Savings,0.5,0,EUR,COMPLETED,3885.41
TRANSFER,Savings,2023-10-02 10:17:33,2023-10-02 10:17:33,To EUR Savings,20,0,EUR,COMPLETED,3905.41
TRANSFER,Savings,2023-10-05 08:16:10,2023-10-05 08:16:10,To EUR Savings,0.1,0,EUR,COMPLETED,3905.51
TRANSFER,Savings,2023-10-05 11:34:16,2023-10-05 11:34:16,To EUR Savings,0.56,0,EUR,COMPLETED,3906.07
TRANSFER,Savings,2023-10-05 11:36:27,2023-10-05 11:36:27,To EUR Savings,0.27,0,EUR,COMPLETED,3906.34
TRANSFER,Savings,2023-10-05 17:58:16,2023-10-05 17:58:16,To EUR Savings,0.48,0,EUR,COMPLETED,3906.82
TRANSFER,Savings,2023-10-06 12:51:27,2023-10-06 12:51:27,To EUR Savings,0.2,0,EUR,COMPLETED,3907.02
TRANSFER,Savings,2023-10-07 08:13:48,2023-10-07 08:13:48,To EUR Savings,0.1,0,EUR,COMPLETED,3907.12
TRANSFER,Savings,2023-10-07 09:39:48,2023-10-07 09:39:48,To EUR Savings,0.65,0,EUR,COMPLETED,3907.77
TRANSFER,Savings,2023-10-07 13:14:41,2023-10-07 13:14:41,To EUR Savings,1,0,EUR,COMPLETED,3908.77
TRANSFER,Savings,2023-10-08 08:19:40,2023-10-08 08:19:40,To EUR Savings,0.1,0,EUR,COMPLETED,3908.87
TRANSFER,Savings,2023-10-08 09:13:19,2023-10-08 09:13:19,To EUR Savings,0.23,0,EUR,COMPLETED,3909.1
TRANSFER,Savings,2023-10-09 10:12:31,2023-10-09 10:12:31,To EUR Savings,20,0,EUR,COMPLETED,3929.1
TRANSFER,Savings,2023-10-12 12:41:33,2023-10-12 12:41:33,To EUR Savings,0.7,0,EUR,COMPLETED,3929.8
TRANSFER,Savings,2023-10-14 08:15:44,2023-10-14 08:15:44,To EUR Savings,0.1,0,EUR,COMPLETED,3929.9
TRANSFER,Savings,2023-10-14 15:27:07,2023-10-14 15:27:07,To EUR Savings,0.1,0,EUR,COMPLETED,3930
TRANSFER,Savings,2023-10-14 16:08:38,2023-10-14 16:08:38,To EUR Savings,1,0,EUR,COMPLETED,3931
TRANSFER,Savings,2023-10-15 08:20:20,2023-10-15 08:20:20,To EUR Savings,0.1,0,EUR,COMPLETED,3931.1
TRANSFER,Savings,2023-10-15 09:05:17,2023-10-15 09:05:17,To EUR Savings,0.45,0,EUR,COMPLETED,3931.55
TRANSFER,Savings,2023-10-15 13:08:42,2023-10-15 13:08:42,To EUR Savings,0.11,0,EUR,COMPLETED,3931.66
TRANSFER,Savings,2023-10-16 10:14:37,2023-10-16 10:14:37,To EUR Savings,20,0,EUR,COMPLETED,3951.66
TRANSFER,Savings,2023-10-17 05:36:07,2023-10-17 05:36:07,To EUR Savings,0.01,0,EUR,COMPLETED,3951.67
TRANSFER,Savings,2023-10-17 21:40:58,2023-10-17 21:40:58,To EUR Savings,0.51,0,EUR,COMPLETED,3952.18
TRANSFER,Savings,2023-10-20 13:04:34,2023-10-20 13:04:34,To EUR Savings,0.2,0,EUR,COMPLETED,3952.38
TRANSFER,Savings,2023-10-20 13:10:03,2023-10-20 13:10:03,To EUR Savings,0.01,0,EUR,COMPLETED,3952.39
TRANSFER,Savings,2023-10-21 08:12:07,2023-10-21 08:12:07,To EUR Savings,0.1,0,EUR,COMPLETED,3952.49
TRANSFER,Savings,2023-10-21 10:47:13,2023-10-21 10:47:13,To EUR Savings,1,0,EUR,COMPLETED,3953.49
TRANSFER,Savings,2023-10-21 15:26:35,2023-10-21 15:26:35,To EUR Savings,0.1,0,EUR,COMPLETED,3953.59
TRANSFER,Savings,2023-10-22 08:33:13,2023-10-22 08:33:13,To EUR Savings,0.05,0,EUR,COMPLETED,3953.64
TRANSFER,Savings,2023-10-23 10:11:44,2023-10-23 10:11:44,To EUR Savings,20,0,EUR,COMPLETED,3973.64
TRANSFER,Savings,2023-10-23 12:56:08,2023-10-23 12:56:08,To EUR Savings,0.01,0,EUR,COMPLETED,3973.65
TRANSFER,Savings,2023-10-24 13:23:13,2023-10-24 13:23:13,To EUR Savings,0.01,0,EUR,COMPLETED,3973.66
TRANSFER,Savings,2023-10-25 19:07:47,2023-10-25 19:07:47,To EUR Savings,1,0,EUR,COMPLETED,3974.66
TRANSFER,Savings,2023-10-25 19:41:15,2023-10-25 19:41:15,To EUR Savings,0.2,0,EUR,COMPLETED,3974.86
TRANSFER,Savings,2023-10-26 12:55:43,2023-10-26 12:55:43,To EUR Savings,0.2,0,EUR,COMPLETED,3975.06
TRANSFER,Savings,2023-10-27 00:32:43,2023-10-27 00:32:43,To EUR Savings,0.01,0,EUR,COMPLETED,3975.07
TRANSFER,Savings,2023-10-27 00:35:04,2023-10-27 00:35:04,To EUR Savings,0.51,0,EUR,COMPLETED,3975.58
TRANSFER,Savings,2023-10-27 14:29:34,2023-10-27 14:29:34,To EUR Savings,0.6,0,EUR,COMPLETED,3976.18
TRANSFER,Savings,2023-10-28 08:08:46,2023-10-28 08:08:46,To EUR Savings,0.1,0,EUR,COMPLETED,3976.28
TRANSFER,Savings,2023-10-28 09:00:32,2023-10-28 09:00:32,To EUR Savings,0.02,0,EUR,COMPLETED,3976.3
TRANSFER,Savings,2023-10-28 14:03:43,2023-10-28 14:03:43,To EUR Savings,0.01,0,EUR,COMPLETED,3976.31
TRANSFER,Savings,2023-10-28 17:48:28,2023-10-28 17:48:28,To EUR Savings,0.5,0,EUR,COMPLETED,3976.81
TRANSFER,Savings,2023-10-28 21:18:57,2023-10-28 21:18:57,To EUR Savings,0.1,0,EUR,COMPLETED,3976.91
TRANSFER,Savings,2023-10-29 07:47:21,2023-10-29 07:47:21,To EUR Savings,1,0,EUR,COMPLETED,3977.91
TRANSFER,Savings,2023-10-29 08:05:46,2023-10-29 08:05:46,To EUR Savings,0.05,0,EUR,COMPLETED,3977.96
TRANSFER,Savings,2023-10-29 09:21:38,2023-10-29 09:21:38,To EUR Savings,1,0,EUR,COMPLETED,3978.96
TRANSFER,Savings,2023-10-29 11:37:57,2023-10-29 11:37:57,To EUR Savings,1,0,EUR,COMPLETED,3979.96
TRANSFER,Savings,2023-10-29 12:41:27,2023-10-29 12:41:27,To EUR Savings,0.3,0,EUR,COMPLETED,3980.26
EXCHANGE,Savings,2023-10-29 14:08:53,2023-10-29 14:08:53,Exchange to EUR,0.45,0,EUR,COMPLETED,3980.71
TRANSFER,Savings,2023-10-29 15:08:17,2023-10-29 15:08:17,To EUR Savings,0.87,0,EUR,COMPLETED,3981.58
TRANSFER,Savings,2023-10-29 20:19:03,2023-10-29 20:19:03,To EUR Savings,0.8,0,EUR,COMPLETED,3982.38
TRANSFER,Savings,2023-10-30 01:53:57,2023-10-30 01:53:57,To EUR Savings,0.05,0,EUR,COMPLETED,3982.43
TRANSFER,Savings,2023-10-30 08:28:18,2023-10-30 08:28:18,To EUR Savings,1,0,EUR,COMPLETED,3983.43
TRANSFER,Savings,2023-10-30 09:14:06,2023-10-30 09:14:06,To EUR Savings,20,0,EUR,COMPLETED,4003.43
TRANSFER,Savings,2023-10-30 09:56:31,2023-10-30 09:56:31,To EUR Savings,0.25,0,EUR,COMPLETED,4003.68
TRANSFER,Savings,2023-10-30 11:04:56,2023-10-30 11:04:56,To EUR Savings,0.8,0,EUR,COMPLETED,4004.48
TRANSFER,Savings,2023-10-30 11:15:09,2023-10-30 11:15:09,To EUR Savings,0.1,0,EUR,COMPLETED,4004.58
TRANSFER,Savings,2023-10-30 13:46:15,2023-10-30 13:46:15,To EUR Savings,0.2,0,EUR,COMPLETED,4004.78
TRANSFER,Savings,2023-10-30 13:52:37,2023-10-30 13:52:37,To EUR Savings,0.84,0,EUR,COMPLETED,4005.62
TRANSFER,Savings,2023-10-30 15:16:46,2023-10-30 15:16:46,To EUR Savings,1,0,EUR,COMPLETED,4006.62
TRANSFER,Savings,2023-10-30 16:02:09,2023-10-30 16:02:09,To EUR Savings,0.67,0,EUR,COMPLETED,4007.29
TRANSFER,Savings,2023-10-30 16:14:02,2023-10-30 16:14:02,To EUR Savings,1,0,EUR,COMPLETED,4008.29
TRANSFER,Savings,2023-10-30 16:21:57,2023-10-30 16:21:57,To EUR Savings,0.9,0,EUR,COMPLETED,4009.19
TRANSFER,Savings,2023-10-30 18:27:41,2023-10-30 18:27:41,To EUR Savings,0.25,0,EUR,COMPLETED,4009.44
TRANSFER,Savings,2023-11-01 09:40:32,2023-11-01 09:40:32,To EUR Savings,0.05,0,EUR,COMPLETED,4009.49
TRANSFER,Savings,2023-11-01 13:25:35,2023-11-01 13:25:35,To EUR Savings,0.01,0,EUR,COMPLETED,4009.5
TRANSFER,Savings,2023-11-02 12:49:40,2023-11-02 12:49:40,To EUR Savings,0.2,0,EUR,COMPLETED,4009.7
TRANSFER,Savings,2023-11-03 11:58:47,2023-11-03 11:58:47,To EUR Savings,0.1,0,EUR,COMPLETED,4009.8
TRANSFER,Savings,2023-11-04 08:15:02,2023-11-04 08:15:02,To EUR Savings,0.1,0,EUR,COMPLETED,4009.9
TRANSFER,Savings,2023-11-04 08:39:56,2023-11-04 08:39:56,To EUR Savings,0.65,0,EUR,COMPLETED,4010.55
TRANSFER,Savings,2023-11-04 09:20:00,2023-11-04 09:20:00,To EUR Savings,0.24,0,EUR,COMPLETED,4010.79
TRANSFER,Savings,2023-11-05 08:13:45,2023-11-05 08:13:45,To EUR Savings,0.1,0,EUR,COMPLETED,4010.89
TRANSFER,Savings,2023-11-05 20:22:46,2023-11-05 20:22:46,To EUR Savings,0.51,0,EUR,COMPLETED,4011.4
TRANSFER,Savings,2023-11-06 09:10:30,2023-11-06 09:10:30,To EUR Savings,20,0,EUR,COMPLETED,4031.4
TRANSFER,Savings,2023-11-07 12:43:18,2023-11-07 12:43:18,To EUR Savings,0.16,0,EUR,COMPLETED,4031.56
TRANSFER,Savings,2023-11-09 12:51:33,2023-11-09 12:51:33,To EUR Savings,0.2,0,EUR,COMPLETED,4031.76
TRANSFER,Savings,2023-11-09 21:00:10,2023-11-09 21:00:10,To EUR Savings,0.17,0,EUR,COMPLETED,4031.93
TRANSFER,Savings,2023-11-11 08:14:20,2023-11-11 08:14:20,To EUR Savings,0.1,0,EUR,COMPLETED,4032.03
TRANSFER,Savings,2023-11-12 08:10:28,2023-11-12 08:10:28,To EUR Savings,0.1,0,EUR,COMPLETED,4032.13
TRANSFER,Savings,2023-11-12 09:12:11,2023-11-12 09:12:11,To EUR Savings,0.67,0,EUR,COMPLETED,4032.8
TRANSFER,Savings,2023-11-12 09:46:59,2023-11-12 09:46:59,To EUR Savings,0.71,0,EUR,COMPLETED,4033.51
TRANSFER,Savings,2023-11-12 14:29:37,2023-11-12 14:29:37,To EUR Savings,0.5,0,EUR,COMPLETED,4034.01
TRANSFER,Savings,2023-11-12 18:10:28,2023-11-12 18:10:28,To EUR Savings,0.62,0,EUR,COMPLETED,4034.63
TRANSFER,Savings,2023-11-13 09:07:00,2023-11-13 09:07:00,To EUR Savings,20,0,EUR,COMPLETED,4054.63
TRANSFER,Savings,2023-11-14 10:59:08,2023-11-14 10:59:08,To EUR Savings,0.32,0,EUR,COMPLETED,4054.95
TRANSFER,Savings,2023-11-16 13:01:14,2023-11-16 13:01:14,To EUR Savings,0.2,0,EUR,COMPLETED,4055.15
TRANSFER,Savings,2023-11-16 19:36:16,2023-11-16 19:36:16,To EUR Savings,0.35,0,EUR,COMPLETED,4055.5
TRANSFER,Savings,2023-11-17 05:36:42,2023-11-17 05:36:42,To EUR Savings,0.01,0,EUR,COMPLETED,4055.51
TRANSFER,Savings,2023-11-17 21:40:58,2023-11-17 21:40:58,To EUR Savings,0.51,0,EUR,COMPLETED,4056.02
TRANSFER,Savings,2023-11-17 23:00:41,2023-11-17 23:00:41,To EUR Savings,1,0,EUR,COMPLETED,4057.02
TRANSFER,Savings,2023-11-18 08:11:08,2023-11-18 08:11:08,To EUR Savings,0.1,0,EUR,COMPLETED,4057.12
TRANSFER,Savings,2023-11-18 14:56:07,2023-11-18 14:56:07,To EUR Savings,0.85,0,EUR,COMPLETED,4057.97
TRANSFER,Savings,2023-11-19 08:13:55,2023-11-19 08:13:55,To EUR Savings,0.1,0,EUR,COMPLETED,4058.07
TRANSFER,Savings,2023-11-19 09:14:48,2023-11-19 09:14:48,To EUR Savings,0.07,0,EUR,COMPLETED,4058.14
TRANSFER,Savings,2023-11-19 12:59:53,2023-11-19 12:59:53,To EUR Savings,0.08,0,EUR,COMPLETED,4058.22
TRANSFER,Savings,2023-11-20 09:07:47,2023-11-20 09:07:47,To EUR Savings,20,0,EUR,COMPLETED,4078.22
TRANSFER,Savings,2023-11-20 12:10:03,2023-11-20 12:10:03,To EUR Savings,0.01,0,EUR,COMPLETED,4078.23
TRANSFER,Savings,2023-11-21 08:36:29,2023-11-21 08:36:29,To EUR Rainy day,1000,0,EUR,COMPLETED,5078.23
TRANSFER,Savings,2023-11-23 18:36:31,2023-11-23 18:36:31,To EUR Savings,0.05,0,EUR,COMPLETED,5078.28
TRANSFER,Savings,2023-11-24 12:48:13,2023-11-24 12:48:13,To EUR Savings,0.2,0,EUR,COMPLETED,5078.48
TRANSFER,Savings,2023-11-25 08:26:42,2023-11-25 08:26:42,To EUR Savings,0.1,0,EUR,COMPLETED,5078.58
TRANSFER,Savings,2023-11-25 08:49:48,2023-11-25 08:49:48,To EUR Savings,0.65,0,EUR,COMPLETED,5079.23
TRANSFER,Savings,2023-11-25 09:12:58,2023-11-25 09:12:58,To EUR Savings,0.62,0,EUR,COMPLETED,5079.85
TRANSFER,Savings,2023-11-25 09:39:08,2023-11-25 09:39:08,To EUR Savings,0.9,0,EUR,COMPLETED,5080.75
TRANSFER,Savings,2023-11-25 10:22:38,2023-11-25 10:22:38,To EUR Savings,0.05,0,EUR,COMPLETED,5080.8
TRANSFER,Savings,2023-11-25 13:26:52,2023-11-25 13:26:52,To EUR Savings,0.5,0,EUR,COMPLETED,5081.3
TRANSFER,Savings,2023-11-25 20:45:20,2023-11-25 20:45:20,To EUR Savings,0.7,0,EUR,COMPLETED,5082
TRANSFER,Savings,2023-11-26 08:20:49,2023-11-26 08:20:49,To EUR Savings,0.1,0,EUR,COMPLETED,5082.1
TRANSFER,Savings,2023-11-26 09:12:35,2023-11-26 09:12:35,To EUR Savings,0.51,0,EUR,COMPLETED,5082.61
TRANSFER,Savings,2023-11-26 09:25:29,2023-11-26 09:25:29,To EUR Savings,0.51,0,EUR,COMPLETED,5083.12
TRANSFER,Savings,2023-11-27 09:07:22,2023-11-27 09:07:22,To EUR Savings,20,0,EUR,COMPLETED,5103.12
TRANSFER,Savings,2023-11-27 09:44:45,2023-11-27 09:44:45,To EUR Savings,1,0,EUR,COMPLETED,5104.12
TRANSFER,Savings,2023-11-28 13:06:16,2023-11-28 13:06:16,To EUR Savings,0.01,0,EUR,COMPLETED,5104.13
TRANSFER,Savings,2023-11-29 20:21:26,2023-11-29 20:21:26,To EUR Savings,0.49,0,EUR,COMPLETED,5104.62
TRANSFER,Savings,2023-11-30 13:25:30,2023-11-30 13:25:30,To EUR Savings,0.76,0,EUR,COMPLETED,5105.38
TRANSFER,Savings,2023-12-01 08:13:12,2023-12-01 08:13:12,To EUR Savings,0.1,0,EUR,COMPLETED,5105.48
TRANSFER,Savings,2023-12-01 13:20:11,2023-12-01 13:20:11,To EUR Savings,0.26,0,EUR,COMPLETED,5105.74
TRANSFER,Savings,2023-12-02 08:33:26,2023-12-02 08:33:26,To EUR Savings,0.1,0,EUR,COMPLETED,5105.84
TRANSFER,Savings,2023-12-02 09:02:06,2023-12-02 09:02:06,To EUR Savings,0.53,0,EUR,COMPLETED,5106.37
TRANSFER,Savings,2023-12-02 09:18:24,2023-12-02 09:18:24,To EUR Savings,0.71,0,EUR,COMPLETED,5107.08
TRANSFER,Savings,2023-12-02 15:05:27,2023-12-02 15:05:27,To EUR Savings,0.86,0,EUR,COMPLETED,5107.94
TRANSFER,Savings,2023-12-02 16:21:59,2023-12-02 16:21:59,To EUR Savings,1,0,EUR,COMPLETED,5108.94
TRANSFER,Savings,2023-12-03 08:37:11,2023-12-03 08:37:11,To EUR Savings,0.1,0,EUR,COMPLETED,5109.04
TRANSFER,Savings,2023-12-04 09:06:24,2023-12-04 09:06:24,To EUR Savings,20,0,EUR,COMPLETED,5129.04
TRANSFER,Savings,2023-12-04 18:53:49,2023-12-04 18:53:49,To EUR Savings,0.01,0,EUR,COMPLETED,5129.05
TRANSFER,Savings,2023-12-04 22:21:48,2023-12-04 22:21:48,To EUR Savings,0.01,0,EUR,COMPLETED,5129.06
TRANSFER,Savings,2023-12-05 20:39:50,2023-12-05 20:39:50,To EUR Savings,0.2,0,EUR,COMPLETED,5129.26
TRANSFER,Savings,2023-12-06 21:22:34,2023-12-06 21:22:34,To EUR Savings,0.8,0,EUR,COMPLETED,5130.06
TRANSFER,Savings,2023-12-07 08:43:27,2023-12-07 08:43:27,To EUR Savings,0.09,0,EUR,COMPLETED,5130.15
TRANSFER,Savings,2023-12-07 11:16:09,2023-12-07 11:16:09,To EUR Savings,0.2,0,EUR,COMPLETED,5130.35
TRANSFER,Savings,2023-12-07 12:45:21,2023-12-07 12:45:21,To EUR Savings,0.67,0,EUR,COMPLETED,5131.02
TRANSFER,Savings,2023-12-07 21:05:28,2023-12-07 21:05:28,To EUR Savings,0.9,0,EUR,COMPLETED,5131.92
TRANSFER,Savings,2023-12-08 08:05:41,2023-12-08 08:05:41,To EUR Savings,0.1,0,EUR,COMPLETED,5132.02
TRANSFER,Savings,2023-12-08 08:24:53,2023-12-08 08:24:53,To EUR Savings,0.1,0,EUR,COMPLETED,5132.12
TRANSFER,Savings,2023-12-08 13:16:22,2023-12-08 13:16:22,To EUR Savings,0.2,0,EUR,COMPLETED,5132.32
TRANSFER,Savings,2023-12-09 08:21:27,2023-12-09 08:21:27,To EUR Savings,0.1,0,EUR,COMPLETED,5132.42
TRANSFER,Savings,2023-12-09 14:56:02,2023-12-09 14:56:02,To EUR Savings,0.01,0,EUR,COMPLETED,5132.43
TRANSFER,Savings,2023-12-10 08:30:56,2023-12-10 08:30:56,To EUR Savings,0.1,0,EUR,COMPLETED,5132.53
TRANSFER,Savings,2023-12-10 10:09:02,2023-12-10 10:09:02,To EUR Savings,0.01,0,EUR,COMPLETED,5132.54
TRANSFER,Savings,2023-12-10 12:30:49,2023-12-10 12:30:49,To EUR Savings,0.5,0,EUR,COMPLETED,5133.04
TRANSFER,Savings,2023-12-10 20:22:50,2023-12-10 20:22:50,To EUR Savings,0.38,0,EUR,COMPLETED,5133.42
TRANSFER,Savings,2023-12-11 09:05:09,2023-12-11 09:05:09,To EUR Savings,20,0,EUR,COMPLETED,5153.42
TRANSFER,Savings,2023-12-11 11:35:03,2023-12-11 11:35:03,To EUR Savings,0.7,0,EUR,COMPLETED,5154.12
TRANSFER,Savings,2023-12-11 11:45:22,2023-12-11 11:45:22,To EUR Savings,1,0,EUR,COMPLETED,5155.12
TRANSFER,Savings,2023-12-11 11:48:28,2023-12-11 11:48:28,To EUR Savings,0.6,0,EUR,COMPLETED,5155.72
TRANSFER,Savings,2023-12-11 17:01:04,2023-12-11 17:01:04,To EUR Savings,0.14,0,EUR,COMPLETED,5155.86
TRANSFER,Savings,2023-12-11 21:42:57,2023-12-11 21:42:57,To EUR Savings,0.5,0,EUR,COMPLETED,5156.36
TRANSFER,Savings,2023-12-12 00:03:51,2023-12-12 00:03:51,To EUR Savings,1,0,EUR,COMPLETED,5157.36
TRANSFER,Savings,2023-12-12 10:04:53,2023-12-12 10:04:53,To EUR Savings,0.8,0,EUR,COMPLETED,5158.16
TRANSFER,Savings,2023-12-12 13:21:55,2023-12-12 13:21:55,To EUR Savings,0.2,0,EUR,COMPLETED,5158.36
TRANSFER,Savings,2023-12-12 18:18:29,2023-12-12 18:18:29,To EUR Savings,0.71,0,EUR,COMPLETED,5159.07
TRANSFER,Savings,2023-12-12 22:25:37,2023-12-12 22:25:37,To EUR Savings,0.5,0,EUR,COMPLETED,5159.57
TRANSFER,Savings,2023-12-13 09:58:59,2023-12-13 09:58:59,To EUR Savings,0.5,0,EUR,COMPLETED,5160.07
TRANSFER,Savings,2023-12-13 11:24:39,2023-12-13 11:24:39,To EUR Savings,0.5,0,EUR,COMPLETED,5160.57
TRANSFER,Savings,2023-12-13 11:42:28,2023-12-13 11:42:28,To EUR Savings,0.5,0,EUR,COMPLETED,5161.07
TRANSFER,Savings,2023-12-13 17:29:00,2023-12-13 17:29:00,To EUR Savings,0.8,0,EUR,COMPLETED,5161.87
TRANSFER,Savings,2023-12-14 12:52:58,2023-12-14 12:52:58,To EUR Savings,0.8,0,EUR,COMPLETED,5162.67
TRANSFER,Savings,2023-12-14 13:02:33,2023-12-14 13:02:33,To EUR Savings,0.42,0,EUR,COMPLETED,5163.09
TRANSFER,Savings,2023-12-16 08:20:07,2023-12-16 08:20:07,To EUR Savings,0.1,0,EUR,COMPLETED,5163.19
TRANSFER,Savings,2023-12-16 08:48:48,2023-12-16 08:48:48,To EUR Savings,0.52,0,EUR,COMPLETED,5163.71
TRANSFER,Savings,2023-12-16 09:11:31,2023-12-16 09:11:31,To EUR Savings,0.15,0,EUR,COMPLETED,5163.86
TRANSFER,Savings,2023-12-16 13:10:54,2023-12-16 13:10:54,To EUR Savings,0.5,0,EUR,COMPLETED,5164.36
TRANSFER,Savings,2023-12-16 13:18:48,2023-12-16 13:18:48,To EUR Savings,1,0,EUR,COMPLETED,5165.36
TRANSFER,Savings,2023-12-16 13:47:44,2023-12-16 13:47:44,To EUR Savings,1,0,EUR,COMPLETED,5166.36
TRANSFER,Savings,2023-12-17 05:34:52,2023-12-17 05:34:52,To EUR Savings,0.01,0,EUR,COMPLETED,5166.37
TRANSFER,Savings,2023-12-17 08:37:19,2023-12-17 08:37:19,To EUR Savings,0.1,0,EUR,COMPLETED,5166.47
TRANSFER,Savings,2023-12-17 09:43:00,2023-12-17 09:43:00,To EUR Savings,0.33,0,EUR,COMPLETED,5166.8
TRANSFER,Savings,2023-12-17 21:40:58,2023-12-17 21:40:58,To EUR Savings,0.51,0,EUR,COMPLETED,5167.31
TRANSFER,Savings,2023-12-18 13:33:26,2023-12-18 13:33:26,To EUR Savings,20,0,EUR,COMPLETED,5187.31
TRANSFER,Savings,2023-12-20 12:10:03,2023-12-20 12:10:03,To EUR Savings,0.01,0,EUR,COMPLETED,5187.32
TRANSFER,Savings,2023-12-20 19:26:14,2023-12-20 19:26:14,To EUR Savings,0.09,0,EUR,COMPLETED,5187.41
TRANSFER,Savings,2023-12-20 22:12:44,2023-12-20 22:12:44,To EUR Savings,1,0,EUR,COMPLETED,5188.41
TRANSFER,Savings,2023-12-20 22:30:08,2023-12-20 22:30:08,To EUR Savings,0.71,0,EUR,COMPLETED,5189.12
TRANSFER,Savings,2023-12-21 08:54:50,2023-12-21 08:54:50,To EUR Savings,0.1,0,EUR,COMPLETED,5189.22
TRANSFER,Savings,2023-12-21 12:38:50,2023-12-21 12:38:50,To EUR Savings,0.76,0,EUR,COMPLETED,5189.98
TRANSFER,Savings,2023-12-21 15:56:54,2023-12-21 15:56:54,To EUR Savings,0.06,0,EUR,COMPLETED,5190.04
TRANSFER,Savings,2023-12-21 16:05:18,2023-12-21 16:05:18,To EUR Savings,1,0,EUR,COMPLETED,5191.04
TRANSFER,Savings,2023-12-21 17:07:58,2023-12-21 17:07:58,To EUR Savings,0.3,0,EUR,COMPLETED,5191.34
TRANSFER,Savings,2023-12-22 08:34:29,2023-12-22 08:34:29,To EUR Savings,0.1,0,EUR,COMPLETED,5191.44
TRANSFER,Savings,2023-12-22 10:43:15,2023-12-22 10:43:15,To EUR Savings,0.26,0,EUR,COMPLETED,5191.7
TRANSFER,Savings,2023-12-22 17:44:17,2023-12-22 17:44:17,To EUR Savings,0.2,0,EUR,COMPLETED,5191.9
TRANSFER,Savings,2023-12-23 08:31:12,2023-12-23 08:31:12,To EUR Savings,0.1,0,EUR,COMPLETED,5192
TRANSFER,Savings,2023-12-23 11:56:10,2023-12-23 11:56:10,To EUR Savings,0.85,0,EUR,COMPLETED,5192.85
TRANSFER,Savings,2023-12-23 13:01:57,2023-12-23 13:01:57,To EUR Savings,0.8,0,EUR,COMPLETED,5193.65
TRANSFER,Savings,2023-12-23 17:31:53,2023-12-23 17:31:53,To EUR Savings,0.61,0,EUR,COMPLETED,5194.26
TRANSFER,Savings,2023-12-23 19:33:42,2023-12-23 19:33:42,To EUR Savings,0.5,0,EUR,COMPLETED,5194.76
TRANSFER,Savings,2023-12-24 08:32:19,2023-12-24 08:32:19,To EUR Savings,0.1,0,EUR,COMPLETED,5194.86
TRANSFER,Savings,2023-12-24 09:14:48,2023-12-24 09:14:48,To EUR Savings,0.64,0,EUR,COMPLETED,5195.5
TRANSFER,Savings,2023-12-24 14:42:53,2023-12-24 14:42:53,To EUR Savings,0.9,0,EUR,COMPLETED,5196.4
TRANSFER,Savings,2023-12-25 09:05:40,2023-12-25 09:05:40,To EUR Savings,20,0,EUR,COMPLETED,5216.4
TRANSFER,Savings,2023-12-25 12:58:21,2023-12-25 12:58:21,To EUR Savings,0.05,0,EUR,COMPLETED,5216.45
TRANSFER,Savings,2023-12-25 12:58:49,2023-12-25 12:58:49,To EUR Savings,1,0,EUR,COMPLETED,5217.45
TRANSFER,Savings,2023-12-25 13:39:18,2023-12-25 13:39:18,To EUR Savings,0.4,0,EUR,COMPLETED,5217.85
TRANSFER,Savings,2023-12-26 13:00:15,2023-12-26 13:00:15,To EUR Savings,0.8,0,EUR,COMPLETED,5218.65
TRANSFER,Savings,2023-12-26 14:28:25,2023-12-26 14:28:25,To EUR Savings,0.15,0,EUR,COMPLETED,5218.8
TRANSFER,Savings,2023-12-26 15:32:18,2023-12-26 15:32:18,To EUR Savings,0.3,0,EUR,COMPLETED,5219.1
TRANSFER,Savings,2023-12-27 10:38:34,2023-12-27 10:38:34,To EUR Savings,0.01,0,EUR,COMPLETED,5219.11
TRANSFER,Savings,2023-12-28 11:12:53,2023-12-28 11:12:53,To EUR Savings,0.01,0,EUR,COMPLETED,5219.12
TRANSFER,Savings,2023-12-28 12:29:13,2023-12-28 12:29:13,To EUR Savings,0.2,0,EUR,COMPLETED,5219.32
TRANSFER,Savings,2023-12-28 13:03:55,2023-12-28 13:03:55,To EUR Savings,0.01,0,EUR,COMPLETED,5219.33
TRANSFER,Savings,2023-12-28 15:07:35,2023-12-28 15:07:35,To EUR Savings,0.51,0,EUR,COMPLETED,5219.84
TRANSFER,Savings,2023-12-28 15:40:46,2023-12-28 15:40:46,To EUR Savings,1,0,EUR,COMPLETED,5220.84
TRANSFER,Savings,2023-12-29 08:19:19,2023-12-29 08:19:19,To EUR Savings,0.1,0,EUR,COMPLETED,5220.94
TRANSFER,Savings,2023-12-29 08:36:53,2023-12-29 08:36:53,To EUR Savings,0.52,0,EUR,COMPLETED,5221.46
TRANSFER,Savings,2023-12-29 08:56:17,2023-12-29 08:56:17,To EUR Savings,0.7,0,EUR,COMPLETED,5222.16
TRANSFER,Savings,2023-12-29 13:11:19,2023-12-29 13:11:19,To EUR Savings,0.57,0,EUR,COMPLETED,5222.73
TRANSFER,Savings,2023-12-30 02:53:45,2023-12-30 02:53:45,To EUR Savings,0.05,0,EUR,COMPLETED,5222.78
TRANSFER,Savings,2023-12-30 08:36:00,2023-12-30 08:36:00,To EUR Savings,0.1,0,EUR,COMPLETED,5222.88
TRANSFER,Savings,2023-12-30 09:04:23,2023-12-30 09:04:23,To EUR Savings,0.16,0,EUR,COMPLETED,5223.04
TRANSFER,Savings,2023-12-31 08:38:37,2023-12-31 08:38:37,To EUR Savings,0.1,0,EUR,COMPLETED,5223.14
TRANSFER,Savings,2023-12-31 09:23:30,2023-12-31 09:23:30,To EUR Savings,0.01,0,EUR,COMPLETED,5223.15
TRANSFER,Savings,2024-01-01 09:42:59,2024-01-01 09:42:59,To EUR Savings,20,0,EUR,COMPLETED,5243.15
TRANSFER,Savings,2024-01-02 08:30:08,2024-01-02 08:30:08,To EUR Savings,0.1,0,EUR,COMPLETED,5243.25
TRANSFER,Savings,2024-01-02 10:14:46,2024-01-02 10:14:46,To EUR Savings,0.05,0,EUR,COMPLETED,5243.3
TRANSFER,Savings,2024-01-02 10:29:40,2024-01-02 10:29:40,To EUR Savings,0.53,0,EUR,COMPLETED,5243.83
TRANSFER,Savings,2024-01-03 08:24:45,2024-01-03 08:24:45,To EUR Savings,0.1,0,EUR,COMPLETED,5243.93
TRANSFER,Savings,2024-01-04 12:51:10,2024-01-04 12:51:10,To EUR Savings,0.2,0,EUR,COMPLETED,5244.13
TRANSFER,Savings,2024-01-05 12:33:29,2024-01-05 12:33:29,To EUR Savings,0.8,0,EUR,COMPLETED,5244.93
TRANSFER,Savings,2024-01-06 09:09:16,2024-01-06 09:09:16,To EUR Savings,0.81,0,EUR,COMPLETED,5245.74
TRANSFER,Savings,2024-01-06 09:46:13,2024-01-06 09:46:13,To EUR Savings,0.77,0,EUR,COMPLETED,5246.51
TRANSFER,Savings,2024-01-07 08:40:06,2024-01-07 08:40:06,To EUR Savings,0.1,0,EUR,COMPLETED,5246.61
TRANSFER,Savings,2024-01-07 08:58:08,2024-01-07 08:58:08,To EUR Savings,0.52,0,EUR,COMPLETED,5247.13
TRANSFER,Savings,2024-01-07 14:43:20,2024-01-07 14:43:20,To EUR Savings,1,0,EUR,COMPLETED,5248.13
TRANSFER,Savings,2024-01-08 09:04:05,2024-01-08 09:04:05,To EUR Savings,20,0,EUR,COMPLETED,5268.13
TRANSFER,Savings,2024-01-10 07:46:45,2024-01-10 07:46:45,To EUR Savings,0.01,0,EUR,COMPLETED,5268.14
TRANSFER,Savings,2024-01-10 09:48:46,2024-01-10 09:48:46,To EUR Savings,1,0,EUR,COMPLETED,5269.14
TRANSFER,Savings,2024-01-11 12:52:43,2024-01-11 12:52:43,To EUR Savings,0.2,0,EUR,COMPLETED,5269.34
TRANSFER,Savings,2024-01-13 10:06:07,2024-01-13 10:06:07,To EUR Savings,1,0,EUR,COMPLETED,5270.34
TRANSFER,Savings,2024-01-13 10:08:36,2024-01-13 10:08:36,To EUR Savings,0.3,0,EUR,COMPLETED,5270.64
TRANSFER,Savings,2024-01-13 11:09:29,2024-01-13 11:09:29,To EUR Savings,0.2,0,EUR,COMPLETED,5270.84
TRANSFER,Savings,2024-01-14 12:05:22,2024-01-14 12:05:22,To EUR Savings,1,0,EUR,COMPLETED,5271.84
TRANSFER,Savings,2024-01-14 12:15:15,2024-01-14 12:15:15,To EUR Savings,0.9,0,EUR,COMPLETED,5272.74
TRANSFER,Savings,2024-01-14 14:04:03,2024-01-14 14:04:03,To EUR Savings,0.46,0,EUR,COMPLETED,5273.2
TRANSFER,Savings,2024-01-14 18:37:16,2024-01-14 18:37:16,To EUR Savings,0.8,0,EUR,COMPLETED,5274
TRANSFER,Savings,2024-01-15 09:08:40,2024-01-15 09:08:40,To EUR Savings,20,0,EUR,COMPLETED,5294
TRANSFER,Savings,2024-01-15 09:40:40,2024-01-15 09:40:40,To EUR Savings,0.54,0,EUR,COMPLETED,5294.54
TRANSFER,Savings,2024-01-15 17:26:37,2024-01-15 17:26:37,To EUR Savings,0.32,0,EUR,COMPLETED,5294.86
TRANSFER,Savings,2024-01-17 21:40:58,2024-01-17 21:40:58,To EUR Savings,0.51,0,EUR,COMPLETED,5295.37
TRANSFER,Savings,2024-01-20 08:43:23,2024-01-20 08:43:23,To EUR Savings,0.01,0,EUR,COMPLETED,5295.38
TRANSFER,Savings,2024-01-20 10:27:33,2024-01-20 10:27:33,To EUR Savings,0.79,0,EUR,COMPLETED,5296.17
TRANSFER,Savings,2024-01-20 12:15:57,2024-01-20 12:15:57,To EUR Savings,0.01,0,EUR,COMPLETED,5296.18
TRANSFER,Savings,2024-01-21 08:29:09,2024-01-21 08:29:09,To EUR Savings,0.25,0,EUR,COMPLETED,5296.43
TRANSFER,Savings,2024-01-21 10:00:47,2024-01-21 10:00:47,To EUR Savings,1,0,EUR,COMPLETED,5297.43
TRANSFER,Savings,2024-01-21 12:24:33,2024-01-21 12:24:33,To EUR Savings,0.2,0,EUR,COMPLETED,5297.63
TRANSFER,Savings,2024-01-21 13:01:35,2024-01-21 13:01:35,To EUR Savings,0.47,0,EUR,COMPLETED,5298.1
TRANSFER,Savings,2024-01-22 09:01:54,2024-01-22 09:01:54,To EUR Savings,20,0,EUR,COMPLETED,5318.1
TRANSFER,Savings,2024-01-25 12:42:06,2024-01-25 12:42:06,To EUR Savings,0.3,0,EUR,COMPLETED,5318.4
TRANSFER,Savings,2024-01-27 08:45:59,2024-01-27 08:45:59,To EUR Savings,0.5,0,EUR,COMPLETED,5318.9
TRANSFER,Savings,2024-01-27 10:11:01,2024-01-27 10:11:01,To EUR Savings,0.16,0,EUR,COMPLETED,5319.06
TRANSFER,Savings,2024-01-27 15:17:01,2024-01-27 15:17:01,To EUR Savings,0.03,0,EUR,COMPLETED,5319.09
TRANSFER,Savings,2024-01-28 08:46:11,2024-01-28 08:46:11,To EUR Savings,0.5,0,EUR,COMPLETED,5319.59
TRANSFER,Savings,2024-01-28 11:15:52,2024-01-28 11:15:52,To EUR Savings,0.01,0,EUR,COMPLETED,5319.6
TRANSFER,Savings,2024-01-28 13:03:45,2024-01-28 13:03:45,To EUR Savings,0.01,0,EUR,COMPLETED,5319.61
TRANSFER,Savings,2024-01-28 14:23:41,2024-01-28 14:23:41,To EUR Savings,0.75,0,EUR,COMPLETED,5320.36
TRANSFER,Savings,2024-01-28 18:02:43,2024-01-28 18:02:43,To EUR Savings,0.7,0,EUR,COMPLETED,5321.06
TRANSFER,Savings,2024-01-28 21:05:16,2024-01-28 21:05:16,To EUR Savings,0.1,0,EUR,COMPLETED,5321.16
TRANSFER,Savings,2024-01-29 09:03:36,2024-01-29 09:03:36,To EUR Savings,20,0,EUR,COMPLETED,5341.16
TRANSFER,Savings,2024-01-30 02:54:03,2024-01-30 02:54:03,To EUR Savings,0.05,0,EUR,COMPLETED,5341.21
TRANSFER,Savings,2024-01-31 13:21:35,2024-01-31 13:21:35,To EUR Savings,0.7,0,EUR,COMPLETED,5341.91
TRANSFER,Savings,2024-02-01 12:37:45,2024-02-01 12:37:45,To EUR Savings,0.2,0,EUR,COMPLETED,5342.11
TRANSFER,Savings,2024-02-02 10:28:19,2024-02-02 10:28:19,To EUR Savings,0.11,0,EUR,COMPLETED,5342.22
TRANSFER,Savings,2024-02-03 08:40:31,2024-02-03 08:40:31,To EUR Savings,0.05,0,EUR,COMPLETED,5342.27
TRANSFER,Savings,2024-02-03 09:57:59,2024-02-03 09:57:59,To EUR Savings,0.15,0,EUR,COMPLETED,5342.42
TRANSFER,Savings,2024-02-04 08:41:22,2024-02-04 08:41:22,To EUR Savings,0.5,0,EUR,COMPLETED,5342.92
TRANSFER,Savings,2024-02-04 09:54:22,2024-02-04 09:54:22,To EUR Savings,0.53,0,EUR,COMPLETED,5343.45
TRANSFER,Savings,2024-02-05 09:08:27,2024-02-05 09:08:27,To EUR Savings,20,0,EUR,COMPLETED,5363.45
TRANSFER,Savings,2024-02-06 15:59:33,2024-02-06 15:59:33,To EUR Savings,0.62,0,EUR,COMPLETED,5364.07
TRANSFER,Savings,2024-02-08 12:26:19,2024-02-08 12:26:19,To EUR Savings,0.2,0,EUR,COMPLETED,5364.27
TRANSFER,Savings,2024-02-08 17:39:05,2024-02-08 17:39:05,To EUR Savings,0.84,0,EUR,COMPLETED,5365.11
TRANSFER,Savings,2024-02-09 17:32:27,2024-02-09 17:32:27,To EUR Savings,1,0,EUR,COMPLETED,5366.11
TRANSFER,Savings,2024-02-10 08:42:23,2024-02-10 08:42:23,To EUR Savings,0.5,0,EUR,COMPLETED,5366.61
TRANSFER,Savings,2024-02-10 09:24:39,2024-02-10 09:24:39,To EUR Savings,0.93,0,EUR,COMPLETED,5367.54
TRANSFER,Savings,2024-02-10 10:42:55,2024-02-10 10:42:55,To EUR Savings,0.1,0,EUR,COMPLETED,5367.64
TRANSFER,Savings,2024-02-11 09:25:37,2024-02-11 09:25:37,To EUR Savings,0.35,0,EUR,COMPLETED,5367.99
TRANSFER,Savings,2024-02-11 10:28:57,2024-02-11 10:28:57,To EUR Savings,0.52,0,EUR,COMPLETED,5368.51
TRANSFER,Savings,2024-02-11 12:43:11,2024-02-11 12:43:11,To EUR Savings,0.4,0,EUR,COMPLETED,5368.91
TRANSFER,Savings,2024-02-12 09:03:09,2024-02-12 09:03:09,To EUR Savings,20,0,EUR,COMPLETED,5388.91
TRANSFER,Savings,2024-02-12 11:01:45,2024-02-12 11:01:45,To EUR Savings,0.01,0,EUR,COMPLETED,5388.92
TRANSFER,Savings,2024-02-12 21:00:14,2024-02-12 21:00:14,To EUR Savings,0.65,0,EUR,COMPLETED,5389.57
TRANSFER,Savings,2024-02-14 14:04:01,2024-02-14 14:04:01,To EUR Savings,0.98,0,EUR,COMPLETED,5390.55
TRANSFER,Savings,2024-02-15 12:46:07,2024-02-15 12:46:07,To EUR Savings,0.1,0,EUR,COMPLETED,5390.65
TRANSFER,Savings,2024-02-15 14:46:29,2024-02-15 14:46:29,To EUR Savings,0.12,0,EUR,COMPLETED,5390.77
TRANSFER,Savings,2024-02-17 08:34:51,2024-02-17 08:34:51,To EUR Savings,0.5,0,EUR,COMPLETED,5391.27
TRANSFER,Savings,2024-02-17 13:02:01,2024-02-17 13:02:01,To EUR Savings,0.5,0,EUR,COMPLETED,5391.77
TRANSFER,Savings,2024-02-17 13:13:11,2024-02-17 13:13:11,To EUR Savings,1,0,EUR,COMPLETED,5392.77
TRANSFER,Savings,2024-02-17 21:40:58,2024-02-17 21:40:58,To EUR Savings,0.51,0,EUR,COMPLETED,5393.28
TRANSFER,Savings,2024-02-18 08:22:33,2024-02-18 08:22:33,To EUR Savings,0.5,0,EUR,COMPLETED,5393.78
TRANSFER,Savings,2024-02-18 09:21:58,2024-02-18 09:21:58,To EUR Savings,0.71,0,EUR,COMPLETED,5394.49
TRANSFER,Savings,2024-02-18 09:36:58,2024-02-18 09:36:58,To EUR Savings,0.4,0,EUR,COMPLETED,5394.89
EXCHANGE,Savings,2024-02-18 10:58:51,2024-02-18 10:58:51,Exchange to EUR,0.33,0,EUR,COMPLETED,5395.22
EXCHANGE,Savings,2024-02-18 12:11:52,2024-02-18 12:11:52,Exchange to EUR,0.64,0.01,EUR,COMPLETED,5395.85
TRANSFER,Savings,2024-02-19 09:00:21,2024-02-19 09:00:21,To EUR Savings,20,0,EUR,COMPLETED,5415.85
TRANSFER,Savings,2024-02-19 12:45:38,2024-02-19 12:45:38,To EUR Savings,0.8,0,EUR,COMPLETED,5416.65
TRANSFER,Savings,2024-02-19 18:28:31,2024-02-19 18:28:31,To EUR Savings,0.56,0,EUR,COMPLETED,5417.21
TRANSFER,Savings,2024-02-20 12:10:03,2024-02-20 12:10:03,To EUR Savings,0.01,0,EUR,COMPLETED,5417.22
TRANSFER,Savings,2024-02-22 11:27:57,2024-02-22 11:27:57,To EUR Savings,0.31,0,EUR,COMPLETED,5417.53
TRANSFER,Savings,2024-02-22 13:01:47,2024-02-22 13:01:47,To EUR Savings,0.2,0,EUR,COMPLETED,5417.73
TRANSFER,Savings,2024-02-23 11:41:30,2024-02-23 11:41:30,To EUR Savings,1,0,EUR,COMPLETED,5418.73
TRANSFER,Savings,2024-02-23 12:51:35,2024-02-23 12:51:35,To EUR Savings,0.87,0,EUR,COMPLETED,5419.6
TRANSFER,Savings,2024-02-23 13:09:07,2024-02-23 13:09:07,To EUR Savings,0.5,0,EUR,COMPLETED,5420.1
TRANSFER,Savings,2024-02-23 15:06:38,2024-02-23 15:06:38,To EUR Savings,0.45,0,EUR,COMPLETED,5420.55
TRANSFER,Savings,2024-02-23 16:34:26,2024-02-23 16:34:26,To EUR Savings,1,0,EUR,COMPLETED,5421.55
TRANSFER,Savings,2024-02-24 08:27:26,2024-02-24 08:27:26,To EUR Savings,0.5,0,EUR,COMPLETED,5422.05
TRANSFER,Savings,2024-02-24 13:36:25,2024-02-24 13:36:25,To EUR Savings,0.5,0,EUR,COMPLETED,5422.55
TRANSFER,Savings,2024-02-24 13:43:19,2024-02-24 13:43:19,To EUR Savings,1,0,EUR,COMPLETED,5423.55
TRANSFER,Savings,2024-02-24 14:35:04,2024-02-24 14:35:04,To EUR Savings,0.5,0,EUR,COMPLETED,5424.05
TRANSFER,Savings,2024-02-25 08:27:04,2024-02-25 08:27:04,To EUR Savings,0.5,0,EUR,COMPLETED,5424.55
TRANSFER,Savings,2024-02-25 09:09:32,2024-02-25 09:09:32,To EUR Savings,0.31,0,EUR,COMPLETED,5424.86
TRANSFER,Savings,2024-02-25 09:22:06,2024-02-25 09:22:06,To EUR Savings,0.58,0,EUR,COMPLETED,5425.44
TRANSFER,Savings,2024-02-25 11:04:48,2024-02-25 11:04:48,To EUR Savings,0.2,0,EUR,COMPLETED,5425.64
TRANSFER,Savings,2024-02-25 16:27:39,2024-02-25 16:27:39,To EUR Savings,0.9,0,EUR,COMPLETED,5426.54
TRANSFER,Savings,2024-02-26 09:04:09,2024-02-26 09:04:09,To EUR Savings,20,0,EUR,COMPLETED,5446.54
TRANSFER,Savings,2024-02-26 13:26:15,2024-02-26 13:26:15,To EUR Savings,0.28,0,EUR,COMPLETED,5446.82
TRANSFER,Savings,2024-02-28 11:13:19,2024-02-28 11:13:19,To EUR Savings,0.35,0,EUR,COMPLETED,5447.17
TRANSFER,Savings,2024-02-28 11:15:55,2024-02-28 11:15:55,To EUR Savings,0.01,0,EUR,COMPLETED,5447.18
TRANSFER,Savings,2024-02-28 13:03:44,2024-02-28 13:03:44,To EUR Savings,0.01,0,EUR,COMPLETED,5447.19
TRANSFER,Savings,2024-02-28 14:29:16,2024-02-28 14:29:16,To EUR Savings,1,0,EUR,COMPLETED,5448.19
TRANSFER,Savings,2024-02-28 20:20:27,2024-02-28 20:20:27,To EUR Savings,0.4,0,EUR,COMPLETED,5448.59
TRANSFER,Savings,2024-02-29 05:53:31,2024-02-29 05:53:31,To EUR Savings,0.51,0,EUR,COMPLETED,5449.1
TRANSFER,Savings,2024-02-29 09:36:07,2024-02-29 09:36:07,To EUR Savings,0.5,0,EUR,COMPLETED,5449.6
TRANSFER,Savings,2024-03-01 12:48:19,2024-03-01 12:48:19,To EUR Savings,0.2,0,EUR,COMPLETED,5449.8
TRANSFER,Savings,2024-03-02 08:42:53,2024-03-02 08:42:53,To EUR Savings,0.5,0,EUR,COMPLETED,5450.3
TRANSFER,Savings,2024-03-03 08:56:52,2024-03-03 08:56:52,To EUR Savings,0.23,0,EUR,COMPLETED,5450.53
TRANSFER,Savings,2024-03-03 16:27:45,2024-03-03 16:27:45,To EUR Savings,0.6,0,EUR,COMPLETED,5451.13
TRANSFER,Savings,2024-03-04 09:02:38,2024-03-04 09:02:38,To EUR Savings,20,0,EUR,COMPLETED,5471.13
TRANSFER,Savings,2024-03-05 00:00:38,2024-03-05 00:00:38,To EUR Savings,0.02,0,EUR,COMPLETED,5471.15
TRANSFER,Savings,2024-03-05 15:44:48,2024-03-05 15:44:48,To EUR Savings,0.01,0,EUR,COMPLETED,5471.16
TRANSFER,Savings,2024-03-05 16:13:56,2024-03-05 16:13:56,To EUR Savings,0.01,0,EUR,COMPLETED,5471.17
TRANSFER,Savings,2024-03-06 08:11:40,2024-03-06 08:11:40,To EUR Savings,0.77,0,EUR,COMPLETED,5471.94
TRANSFER,Savings,2024-03-07 04:40:02,2024-03-07 04:40:02,To EUR Savings,0.18,0,EUR,COMPLETED,5472.12
TRANSFER,Savings,2024-03-07 12:43:03,2024-03-07 12:43:03,To EUR Savings,0.1,0,EUR,COMPLETED,5472.22
TRANSFER,Savings,2024-03-08 12:52:46,2024-03-08 12:52:46,To EUR Savings,0.8,0,EUR,COMPLETED,5473.02
TRANSFER,Savings,2024-03-09 09:01:45,2024-03-09 09:01:45,To EUR Savings,0.8,0,EUR,COMPLETED,5473.82
TRANSFER,Savings,2024-03-09 14:47:09,2024-03-09 14:47:09,To EUR Savings,0.8,0,EUR,COMPLETED,5474.62
TRANSFER,Savings,2024-03-10 08:21:09,2024-03-10 08:21:09,To EUR Savings,0.5,0,EUR,COMPLETED,5475.12
TRANSFER,Savings,2024-03-10 12:40:44,2024-03-10 12:40:44,To EUR Savings,0.9,0,EUR,COMPLETED,5476.02
TRANSFER,Savings,2024-03-10 14:05:42,2024-03-10 14:05:42,To EUR Savings,0.9,0,EUR,COMPLETED,5476.92
TRANSFER,Savings,2024-03-10 15:33:07,2024-03-10 15:33:07,To EUR Savings,0.2,0,EUR,COMPLETED,5477.12
TRANSFER,Savings,2024-03-10 15:38:12,2024-03-10 15:38:12,To EUR Savings,0.1,0,EUR,COMPLETED,5477.22
TRANSFER,Savings,2024-03-10 16:15:24,2024-03-10 16:15:24,To EUR Savings,0.5,0,EUR,COMPLETED,5477.72
TRANSFER,Savings,2024-03-10 16:22:37,2024-03-10 16:22:37,To EUR Savings,0.2,0,EUR,COMPLETED,5477.92
TRANSFER,Savings,2024-03-11 09:01:43,2024-03-11 09:01:43,To EUR Savings,20,0,EUR,COMPLETED,5497.92
TRANSFER,Savings,2024-03-12 11:16:25,2024-03-12 11:16:25,To EUR Savings,0.15,0,EUR,COMPLETED,5498.07
TRANSFER,Savings,2024-03-12 18:09:36,2024-03-12 18:09:36,To EUR Savings,0.1,0,EUR,COMPLETED,5498.17
TRANSFER,Savings,2024-03-12 20:55:15,2024-03-12 20:55:15,To EUR Savings,0.4,0,EUR,COMPLETED,5498.57
TRANSFER,Savings,2024-03-14 13:02:57,2024-03-14 13:02:57,To EUR Savings,0.1,0,EUR,COMPLETED,5498.67
TRANSFER,Savings,2024-03-14 14:04:05,2024-03-14 14:04:05,To EUR Savings,0.4,0,EUR,COMPLETED,5499.07
TRANSFER,Savings,2024-03-16 08:24:24,2024-03-16 08:24:24,To EUR Savings,0.5,0,EUR,COMPLETED,5499.57
TRANSFER,Savings,2024-03-16 08:31:45,2024-03-16 08:31:45,To EUR Savings,1,0,EUR,COMPLETED,5500.57
TRANSFER,Savings,2024-03-16 09:23:05,2024-03-16 09:23:05,To EUR Savings,0.33,0,EUR,COMPLETED,5500.9
TRANSFER,Savings,2024-03-16 10:44:36,2024-03-16 10:44:36,To EUR Savings,0.11,0,EUR,COMPLETED,5501.01
TRANSFER,Savings,2024-03-16 11:29:06,2024-03-16 11:29:06,To EUR Savings,0.32,0,EUR,COMPLETED,5501.33
TRANSFER,Savings,2024-03-16 12:52:21,2024-03-16 12:52:21,To EUR Savings,0.32,0,EUR,COMPLETED,5501.65
TRANSFER,Savings,2024-03-17 08:29:19,2024-03-17 08:29:19,To EUR Savings,0.52,0,EUR,COMPLETED,5502.17
TRANSFER,Savings,2024-03-17 08:46:03,2024-03-17 08:46:03,To EUR Savings,0.5,0,EUR,COMPLETED,5502.67
TRANSFER,Savings,2024-03-17 21:40:58,2024-03-17 21:40:58,To EUR Savings,0.51,0,EUR,COMPLETED,5503.18
TRANSFER,Savings,2024-03-18 09:00:13,2024-03-18 09:00:13,To EUR Savings,20,0,EUR,COMPLETED,5523.18
TRANSFER,Savings,2024-03-18 14:05:46,2024-03-18 14:05:46,To EUR Savings,1,0,EUR,COMPLETED,5524.18
TRANSFER,Savings,2024-03-18 14:07:54,2024-03-18 14:07:54,To EUR Savings,1,0,EUR,COMPLETED,5525.18
TRANSFER,Savings,2024-03-19 10:46:16,2024-03-19 10:46:16,To EUR Savings,0.26,0,EUR,COMPLETED,5525.44
TRANSFER,Savings,2024-03-20 12:10:03,2024-03-20 12:10:03,To EUR Savings,0.01,0,EUR,COMPLETED,5525.45
TRANSFER,Savings,2024-03-21 12:43:36,2024-03-21 12:43:36,To EUR Savings,0.3,0,EUR,COMPLETED,5525.75
TRANSFER,Savings,2024-03-21 23:20:39,2024-03-21 23:20:39,To EUR Savings,0.01,0,EUR,COMPLETED,5525.76
TRANSFER,Savings,2024-03-22 19:01:05,2024-03-22 19:01:05,To EUR Savings,0.2,0,EUR,COMPLETED,5525.96
TRANSFER,Savings,2024-03-22 20:20:50,2024-03-22 20:20:50,To EUR Savings,0.99,0,EUR,COMPLETED,5526.95
TRANSFER,Savings,2024-03-23 08:09:09,2024-03-23 08:09:09,To EUR Savings,0.5,0,EUR,COMPLETED,5527.45
EXCHANGE,Savings,2024-03-23 09:35:44,2024-03-23 09:35:44,Exchange to EUR,0.88,0.01,EUR,COMPLETED,5528.32
TRANSFER,Savings,2024-03-23 18:00:38,2024-03-23 18:00:38,To EUR Savings,0.53,0,EUR,COMPLETED,5528.85
TRANSFER,Savings,2024-03-24 08:13:12,2024-03-24 08:13:12,To EUR Savings,0.1,0,EUR,COMPLETED,5528.95
TRANSFER,Savings,2024-03-24 13:15:38,2024-03-24 13:15:38,To EUR Savings,0.82,0,EUR,COMPLETED,5529.77
TRANSFER,Savings,2024-03-24 17:09:01,2024-03-24 17:09:01,To EUR Savings,0.66,0,EUR,COMPLETED,5530.43
TRANSFER,Savings,2024-03-25 09:03:14,2024-03-25 09:03:14,To EUR Savings,20,0,EUR,COMPLETED,5550.43
TRANSFER,Savings,2024-03-25 11:42:20,2024-03-25 11:42:20,To EUR Savings,0.95,0,EUR,COMPLETED,5551.38
TRANSFER,Savings,2024-03-25 13:53:00,2024-03-25 13:53:00,To EUR Savings,0.23,0,EUR,COMPLETED,5551.61
TRANSFER,Savings,2024-03-26 16:24:12,2024-03-26 16:24:12,To EUR Savings,0.48,0,EUR,COMPLETED,5552.09
TRANSFER,Savings,2024-03-27 12:14:11,2024-03-27 12:14:11,To EUR Savings,1,0,EUR,COMPLETED,5553.09
TRANSFER,Savings,2024-03-27 19:36:37,2024-03-27 19:36:37,To EUR Savings,0.37,0,EUR,COMPLETED,5553.46
TRANSFER,Savings,2024-03-27 19:52:29,2024-03-27 19:52:29,To EUR Savings,1,0,EUR,COMPLETED,5554.46
TRANSFER,Savings,2024-03-27 22:44:58,2024-03-27 22:44:58,To EUR Savings,1,0,EUR,COMPLETED,5555.46
TRANSFER,Savings,2024-03-27 23:29:08,2024-03-27 23:29:08,To EUR Savings,0.5,0,EUR,COMPLETED,5555.96
TRANSFER,Savings,2024-03-27 23:44:37,2024-03-27 23:44:37,To EUR Savings,1,0,EUR,COMPLETED,5556.96
TRANSFER,Savings,2024-03-28 11:15:44,2024-03-28 11:15:44,To EUR Savings,0.01,0,EUR,COMPLETED,5556.97
TRANSFER,Savings,2024-03-28 11:19:40,2024-03-28 11:19:40,To EUR Savings,0.33,0,EUR,COMPLETED,5557.3
TRANSFER,Savings,2024-03-28 13:03:44,2024-03-28 13:03:44,To EUR Savings,0.01,0,EUR,COMPLETED,5557.31
TRANSFER,Savings,2024-03-29 04:56:03,2024-03-29 04:56:03,To EUR Savings,0.51,0,EUR,COMPLETED,5557.82
TRANSFER,Savings,2024-03-29 08:02:14,2024-03-29 08:02:14,To EUR Savings,0.5,0,EUR,COMPLETED,5558.32
TRANSFER,Savings,2024-03-29 12:35:42,2024-03-29 12:35:42,To EUR Savings,0.32,0,EUR,COMPLETED,5558.64
TRANSFER,Savings,2024-03-30 08:50:56,2024-03-30 08:50:56,To EUR Savings,0.5,0,EUR,COMPLETED,5559.14
TRANSFER,Savings,2024-03-30 09:53:12,2024-03-30 09:53:12,To EUR Savings,0.01,0,EUR,COMPLETED,5559.15
TRANSFER,Savings,2024-03-30 14:29:10,2024-03-30 14:29:10,To EUR Savings,0.01,0,EUR,COMPLETED,5559.16
TRANSFER,Savings,2024-03-30 17:28:17,2024-03-30 17:28:17,To EUR Savings,0.33,0,EUR,COMPLETED,5559.49
TRANSFER,Savings,2024-03-30 17:34:40,2024-03-30 17:34:40,To EUR Savings,0.52,0,EUR,COMPLETED,5560.01
TRANSFER,Savings,2024-03-31 08:43:22,2024-03-31 08:43:22,To EUR Savings,0.5,0,EUR,COMPLETED,5560.51
TRANSFER,Savings,2024-03-31 09:25:54,2024-03-31 09:25:54,To EUR Savings,0.54,0,EUR,COMPLETED,5561.05
TRANSFER,Savings,2024-03-31 12:32:48,2024-03-31 12:32:48,To EUR Savings,0.4,0,EUR,COMPLETED,5561.45
TRANSFER,Savings,2024-04-01 10:41:55,2024-04-01 10:41:55,To EUR Savings,20,0,EUR,COMPLETED,5581.45
TRANSFER,Savings,2024-04-02 12:45:22,2024-04-02 12:45:22,To EUR Savings,0.8,0,EUR,COMPLETED,5582.25
TRANSFER,Savings,2024-04-04 12:44:16,2024-04-04 12:44:16,To EUR Savings,0.2,0,EUR,COMPLETED,5582.45
TRANSFER,Savings,2024-04-06 08:30:11,2024-04-06 08:30:11,To EUR Savings,0.5,0,EUR,COMPLETED,5582.95
TRANSFER,Savings,2024-04-06 11:23:00,2024-04-06 11:23:00,To EUR Savings,0.27,0,EUR,COMPLETED,5583.22
TRANSFER,Savings,2024-04-06 18:12:15,2024-04-06 18:12:15,To EUR Savings,0.74,0,EUR,COMPLETED,5583.96
TRANSFER,Savings,2024-04-07 08:44:01,2024-04-07 08:44:01,To EUR Savings,0.5,0,EUR,COMPLETED,5584.46
TRANSFER,Savings,2024-04-07 09:23:48,2024-04-07 09:23:48,To EUR Savings,0.52,0,EUR,COMPLETED,5584.98
TRANSFER,Savings,2024-04-07 12:44:28,2024-04-07 12:44:28,To EUR Savings,0.4,0,EUR,COMPLETED,5585.38
TRANSFER,Savings,2024-04-07 15:24:48,2024-04-07 15:24:48,To EUR Savings,0.03,0,EUR,COMPLETED,5585.41
TRANSFER,Savings,2024-04-08 10:01:20,2024-04-08 10:01:20,To EUR Savings,20,0,EUR,COMPLETED,5605.41
TRANSFER,Savings,2024-04-08 15:36:45,2024-04-08 15:36:45,To EUR Savings,0.01,0,EUR,COMPLETED,5605.42
TRANSFER,Savings,2024-04-10 12:03:23,2024-04-10 12:03:23,To EUR Savings,0.2,0,EUR,COMPLETED,5605.62
TRANSFER,Savings,2024-04-11 20:25:33,2024-04-11 20:25:33,To EUR Savings,0.6,0,EUR,COMPLETED,5606.22
TRANSFER,Savings,2024-04-12 16:12:45,2024-04-12 16:12:45,To EUR Savings,0.01,0,EUR,COMPLETED,5606.23
TRANSFER,Savings,2024-04-13 08:28:57,2024-04-13 08:28:57,To EUR Savings,0.5,0,EUR,COMPLETED,5606.73
TRANSFER,Savings,2024-04-13 09:55:39,2024-04-13 09:55:39,To EUR Savings,0.82,0,EUR,COMPLETED,5607.55
TRANSFER,Savings,2024-04-14 08:40:39,2024-04-14 08:40:39,To EUR Savings,0.5,0,EUR,COMPLETED,5608.05
TRANSFER,Savings,2024-04-15 10:05:19,2024-04-15 10:05:19,To EUR Savings,20,0,EUR,COMPLETED,5628.05
TRANSFER,Savings,2024-04-17 21:40:58,2024-04-17 21:40:58,To EUR Savings,0.51,0,EUR,COMPLETED,5628.56
TRANSFER,Savings,2024-04-18 12:47:59,2024-04-18 12:47:59,To EUR Savings,0.2,0,EUR,COMPLETED,5628.76
TRANSFER,Savings,2024-04-19 12:45:15,2024-04-19 12:45:15,To EUR Savings,0.85,0,EUR,COMPLETED,5629.61
TRANSFER,Savings,2024-04-20 07:42:33,2024-04-20 07:42:33,To EUR Savings,0.5,0,EUR,COMPLETED,5630.11
TRANSFER,Savings,2024-04-20 13:10:03,2024-04-20 13:10:03,To EUR Savings,0.01,0,EUR,COMPLETED,5630.12
TRANSFER,Savings,2024-04-21 08:35:03,2024-04-21 08:35:03,To EUR Savings,0.5,0,EUR,COMPLETED,5630.62
TRANSFER,Savings,2024-04-21 09:48:36,2024-04-21 09:48:36,To EUR Savings,0.1,0,EUR,COMPLETED,5630.72
TRANSFER,Savings,2024-04-21 12:34:23,2024-04-21 12:34:23,To EUR Savings,0.85,0,EUR,COMPLETED,5631.57
TRANSFER,Savings,2024-04-22 09:57:49,2024-04-22 09:57:49,To EUR Savings,20,0,EUR,COMPLETED,5651.57
TRANSFER,Savings,2024-04-22 22:01:43,2024-04-22 22:01:43,To EUR Savings,0.01,0,EUR,COMPLETED,5651.58
TRANSFER,Savings,2024-04-24 07:35:39,2024-04-24 07:35:39,To EUR Savings,1,0,EUR,COMPLETED,5652.58
TRANSFER,Savings,2024-04-25 08:54:43,2024-04-25 08:54:43,To EUR Savings,0.5,0,EUR,COMPLETED,5653.08
TRANSFER,Savings,2024-04-25 12:53:12,2024-04-25 12:53:12,To EUR Savings,0.8,0,EUR,COMPLETED,5653.88
TRANSFER,Savings,2024-04-25 13:43:57,2024-04-25 13:43:57,To EUR Savings,0.33,0,EUR,COMPLETED,5654.21
TRANSFER,Savings,2024-04-25 14:38:58,2024-04-25 14:38:58,To EUR Savings,0.64,0,EUR,COMPLETED,5654.85
TRANSFER,Savings,2024-04-25 15:27:14,2024-04-25 15:27:14,To EUR Savings,1,0,EUR,COMPLETED,5655.85
TRANSFER,Savings,2024-04-25 18:33:33,2024-04-25 18:33:33,To EUR Savings,0.81,0,EUR,COMPLETED,5656.66
TRANSFER,Savings,2024-04-26 12:40:54,2024-04-26 12:40:54,To EUR Savings,0.5,0,EUR,COMPLETED,5657.16
TRANSFER,Savings,2024-04-26 18:24:57,2024-04-26 18:24:57,To EUR Savings,0.26,0,EUR,COMPLETED,5657.42
TRANSFER,Savings,2024-04-27 12:42:39,2024-04-27 12:42:39,To EUR Savings,0.8,0,EUR,COMPLETED,5658.22
TRANSFER,Savings,2024-04-28 12:15:52,2024-04-28 12:15:52,To EUR Savings,0.01,0,EUR,COMPLETED,5658.23
TRANSFER,Savings,2024-04-28 13:16:07,2024-04-28 13:16:07,To EUR Savings,0.01,0,EUR,COMPLETED,5658.24
TRANSFER,Savings,2024-04-28 14:03:47,2024-04-28 14:03:47,To EUR Savings,0.01,0,EUR,COMPLETED,5658.25
TRANSFER,Savings,2024-04-29 09:59:53,2024-04-29 09:59:53,To EUR Savings,20,0,EUR,COMPLETED,5678.25
TRANSFER,Savings,2024-04-29 19:04:46,2024-04-29 19:04:46,To EUR Savings,1,0,EUR,COMPLETED,5679.25
TRANSFER,Savings,2024-04-29 20:19:15,2024-04-29 20:19:15,To EUR Savings,0.21,0,EUR,COMPLETED,5679.46
TRANSFER,Savings,2024-04-29 23:23:53,2024-04-29 23:23:53,To EUR Savings,0.16,0,EUR,COMPLETED,5679.62
TRANSFER,Savings,2024-04-30 17:18:38,2024-04-30 17:18:38,To EUR Savings,0.13,0,EUR,COMPLETED,5679.75
TRANSFER,Savings,2024-05-01 10:25:22,2024-05-01 10:25:22,To EUR Savings,0.3,0,EUR,COMPLETED,5680.05
TRANSFER,Savings,2024-05-01 22:19:04,2024-05-01 22:19:04,To EUR Savings,0.01,0,EUR,COMPLETED,5680.06
TRANSFER,Savings,2024-05-02 12:49:24,2024-05-02 12:49:24,To EUR Savings,0.39,0,EUR,COMPLETED,5680.45
TRANSFER,Savings,2024-05-03 12:23:37,2024-05-03 12:23:37,To EUR Savings,0.01,0,EUR,COMPLETED,5680.46
TRANSFER,Savings,2024-05-04 07:54:20,2024-05-04 07:54:20,To EUR Savings,0.5,0,EUR,COMPLETED,5680.96
TRANSFER,Savings,2024-05-04 12:36:58,2024-05-04 12:36:58,To EUR Savings,0.9,0,EUR,COMPLETED,5681.86
TRANSFER,Savings,2024-05-05 08:25:36,2024-05-05 08:25:36,To EUR Savings,0.5,0,EUR,COMPLETED,5682.36
TRANSFER,Savings,2024-05-05 09:59:14,2024-05-05 09:59:14,To EUR Savings,0.06,0,EUR,COMPLETED,5682.42
TRANSFER,Savings,2024-05-06 09:58:27,2024-05-06 09:58:27,To EUR Savings,20,0,EUR,COMPLETED,5702.42
TRANSFER,Savings,2024-05-06 11:24:39,2024-05-06 11:24:39,To EUR Savings,0.32,0,EUR,COMPLETED,5702.74
TRANSFER,Savings,2024-05-06 18:06:00,2024-05-06 18:06:00,To EUR Savings,0.7,0,EUR,COMPLETED,5703.44
TRANSFER,Savings,2024-05-08 22:36:14,2024-05-08 22:36:14,To EUR Savings,0.77,0,EUR,COMPLETED,5704.21
TRANSFER,Savings,2024-05-09 09:15:51,2024-05-09 09:15:51,To EUR Savings,0.4,0,EUR,COMPLETED,5704.61
TRANSFER,Savings,2024-05-09 12:40:39,2024-05-09 12:40:39,To EUR Savings,0.2,0,EUR,COMPLETED,5704.81
TRANSFER,Savings,2024-05-11 07:29:44,2024-05-11 07:29:44,To EUR Savings,0.5,0,EUR,COMPLETED,5705.31
TRANSFER,Savings,2024-05-11 12:40:29,2024-05-11 12:40:29,To EUR Savings,0.8,0,EUR,COMPLETED,5706.11
TRANSFER,Savings,2024-05-12 08:09:47,2024-05-12 08:09:47,To EUR Savings,0.5,0,EUR,COMPLETED,5706.61
TRANSFER,Savings,2024-05-12 09:01:31,2024-05-12 09:01:31,To EUR Savings,0.13,0,EUR,COMPLETED,5706.74
TRANSFER,Savings,2024-05-12 14:52:06,2024-05-12 14:52:06,To EUR Savings,1,0,EUR,COMPLETED,5707.74
TRANSFER,Savings,2024-05-13 09:55:57,2024-05-13 09:55:57,To EUR Savings,20,0,EUR,COMPLETED,5727.74
TRANSFER,Savings,2024-05-14 14:00:11,2024-05-14 14:00:11,To EUR Savings,0.05,0,EUR,COMPLETED,5727.79
TRANSFER,Savings,2024-05-16 12:48:29,2024-05-16 12:48:29,To EUR Savings,0.3,0,EUR,COMPLETED,5728.09
TRANSFER,Savings,2024-05-17 21:40:58,2024-05-17 21:40:58,To EUR Savings,0.51,0,EUR,COMPLETED,5728.6
TRANSFER,Savings,2024-05-18 07:43:03,2024-05-18 07:43:03,To EUR Savings,0.5,0,EUR,COMPLETED,5729.1
TRANSFER,Savings,2024-05-18 12:07:27,2024-05-18 12:07:27,To EUR Savings,0.74,0,EUR,COMPLETED,5729.84
TRANSFER,Savings,2024-05-19 08:32:31,2024-05-19 08:32:31,To EUR Savings,0.5,0,EUR,COMPLETED,5730.34
TRANSFER,Savings,2024-05-19 09:32:07,2024-05-19 09:32:07,To EUR Savings,0.17,0,EUR,COMPLETED,5730.51
TRANSFER,Savings,2024-05-19 12:45:56,2024-05-19 12:45:56,To EUR Savings,0.28,0,EUR,COMPLETED,5730.79
TRANSFER,Savings,2024-05-19 15:48:04,2024-05-19 15:48:04,To EUR Savings,1,0,EUR,COMPLETED,5731.79
TRANSFER,Savings,2024-05-20 09:57:02,2024-05-20 09:57:02,To EUR Savings,20,0,EUR,COMPLETED,5751.79
TRANSFER,Savings,2024-05-20 13:10:03,2024-05-20 13:10:03,To EUR Savings,0.01,0,EUR,COMPLETED,5751.8
TRANSFER,Savings,2024-05-20 17:52:22,2024-05-20 17:52:22,To EUR Savings,0.1,0,EUR,COMPLETED,5751.9
TRANSFER,Savings,2024-05-21 14:31:28,2024-05-21 14:31:28,To EUR Savings,0.64,0,EUR,COMPLETED,5752.54
TRANSFER,Savings,2024-05-22 13:02:54,2024-05-22 13:02:54,To EUR Savings,0.2,0,EUR,COMPLETED,5752.74
TRANSFER,Savings,2024-05-22 19:52:50,2024-05-22 19:52:50,To EUR Savings,0.05,0,EUR,COMPLETED,5752.79
TRANSFER,Savings,2024-05-23 12:40:07,2024-05-23 12:40:07,To EUR Savings,0.1,0,EUR,COMPLETED,5752.89
TRANSFER,Savings,2024-05-25 08:27:32,2024-05-25 08:27:32,To EUR Savings,0.5,0,EUR,COMPLETED,5753.39
TRANSFER,Savings,2024-05-25 09:19:23,2024-05-25 09:19:23,To EUR Savings,0.91,0,EUR,COMPLETED,5754.3
TRANSFER,Savings,2024-05-25 16:19:29,2024-05-25 16:19:29,To EUR Savings,0.01,0,EUR,COMPLETED,5754.31
TRANSFER,Savings,2024-05-26 07:57:32,2024-05-26 07:57:32,To EUR Savings,0.5,0,EUR,COMPLETED,5754.81
TRANSFER,Savings,2024-05-26 13:24:03,2024-05-26 13:24:03,To EUR Savings,0.8,0,EUR,COMPLETED,5755.61
TRANSFER,Savings,2024-05-27 09:56:40,2024-05-27 09:56:40,To EUR Savings,20,0,EUR,COMPLETED,5775.61
TRANSFER,Savings,2024-05-27 12:23:35,2024-05-27 12:23:35,To EUR Savings,0.53,0,EUR,COMPLETED,5776.14
TRANSFER,Savings,2024-05-27 17:30:48,2024-05-27 17:30:48,To EUR Savings,0.51,0,EUR,COMPLETED,5776.65
TRANSFER,Savings,2024-05-28 12:15:53,2024-05-28 12:15:53,To EUR Savings,0.01,0,EUR,COMPLETED,5776.66
TRANSFER,Savings,2024-05-28 14:03:44,2024-05-28 14:03:44,To EUR Savings,0.01,0,EUR,COMPLETED,5776.67
TRANSFER,Savings,2024-05-29 05:52:12,2024-05-29 05:52:12,To EUR Savings,0.51,0,EUR,COMPLETED,5777.18
TRANSFER,Savings,2024-05-29 12:45:55,2024-05-29 12:45:55,To EUR Savings,0.2,0,EUR,COMPLETED,5777.38
TRANSFER,Savings,2024-05-30 08:18:21,2024-05-30 08:18:21,To EUR Savings,0.5,0,EUR,COMPLETED,5777.88
TRANSFER,Savings,2024-05-30 09:01:21,2024-05-30 09:01:21,To EUR Savings,0.01,0,EUR,COMPLETED,5777.89
TRANSFER,Savings,2024-05-30 16:29:17,2024-05-30 16:29:17,To EUR Savings,0.5,0,EUR,COMPLETED,5778.39
TRANSFER,Savings,2024-05-31 13:18:46,2024-05-31 13:18:46,To EUR Savings,0.95,0,EUR,COMPLETED,5779.34
TRANSFER,Savings,2024-06-01 07:45:09,2024-06-01 07:45:09,To EUR Savings,0.5,0,EUR,COMPLETED,5779.84
TRANSFER,Savings,2024-06-01 08:28:12,2024-06-01 08:28:12,To EUR Rainy day,50,0,EUR,COMPLETED,5829.84
TRANSFER,Savings,2024-06-01 10:06:14,2024-06-01 10:06:14,To EUR Savings,0.7,0,EUR,COMPLETED,5830.54
TRANSFER,Savings,2024-06-01 10:16:09,2024-06-01 10:16:09,To EUR Savings,0.52,0,EUR,COMPLETED,5831.06
TRANSFER,Savings,2024-06-01 12:03:13,2024-06-01 12:03:13,To EUR Savings,0.3,0,EUR,COMPLETED,5831.36
TRANSFER,Savings,2024-06-01 14:19:43,2024-06-01 14:19:43,To EUR Savings,0.11,0,EUR,COMPLETED,5831.47
TRANSFER,Savings,2024-06-02 08:02:36,2024-06-02 08:02:36,To EUR Savings,0.5,0,EUR,COMPLETED,5831.97
TRANSFER,Savings,2024-06-02 09:02:52,2024-06-02 09:02:52,To EUR Savings,0.6,0,EUR,COMPLETED,5832.57
TRANSFER,Savings,2024-06-03 09:58:24,2024-06-03 09:58:24,To EUR Savings,20,0,EUR,COMPLETED,5852.57
TRANSFER,Savings,2024-06-04 09:23:08,2024-06-04 09:23:08,To EUR Savings,0.89,0,EUR,COMPLETED,5853.46
TRANSFER,Savings,2024-06-05 18:41:23,2024-06-05 18:41:23,To EUR Savings,0.35,0,EUR,COMPLETED,5853.81
TRANSFER,Savings,2024-06-05 18:53:45,2024-06-05 18:53:45,To EUR Savings,0.77,0,EUR,COMPLETED,5854.58
TRANSFER,Savings,2024-06-05 23:55:06,2024-06-05 23:55:06,To EUR Savings,0.41,0,EUR,COMPLETED,5854.99
TRANSFER,Savings,2024-06-06 12:25:44,2024-06-06 12:25:44,To EUR Savings,0.47,0,EUR,COMPLETED,5855.46
TRANSFER,Savings,2024-06-06 12:46:08,2024-06-06 12:46:08,To EUR Savings,0.65,0,EUR,COMPLETED,5856.11
TRANSFER,Savings,2024-06-06 22:39:02,2024-06-06 22:39:02,To EUR Savings,0.65,0,EUR,COMPLETED,5856.76
TRANSFER,Savings,2024-06-07 19:06:23,2024-06-07 19:06:23,To EUR Savings,0.2,0,EUR,COMPLETED,5856.96
TRANSFER,Savings,2024-06-07 21:59:21,2024-06-07 21:59:21,To EUR Savings,1,0,EUR,COMPLETED,5857.96
TRANSFER,Savings,2024-06-08 08:25:07,2024-06-08 08:25:07,To EUR Savings,0.5,0,EUR,COMPLETED,5858.46
TRANSFER,Savings,2024-06-08 13:05:19,2024-06-08 13:05:19,To EUR Savings,0.8,0,EUR,COMPLETED,5859.26
TRANSFER,Savings,2024-06-09 08:34:41,2024-06-09 08:34:41,To EUR Savings,0.5,0,EUR,COMPLETED,5859.76
TRANSFER,Savings,2024-06-10 08:30:49,2024-06-10 08:30:49,To EUR Savings,0.5,0,EUR,COMPLETED,5860.26
TRANSFER,Savings,2024-06-10 09:36:55,2024-06-10 09:36:55,To EUR Savings,0.14,0,EUR,COMPLETED,5860.4
TRANSFER,Savings,2024-06-10 09:59:37,2024-06-10 09:59:37,To EUR Savings,20,0,EUR,COMPLETED,5880.4
TRANSFER,Savings,2024-06-10 12:39:10,2024-06-10 12:39:10,To EUR Savings,0.07,0,EUR,COMPLETED,5880.47
TRANSFER,Savings,2024-06-11 08:41:03,2024-06-11 08:41:03,To EUR Savings,0.5,0,EUR,COMPLETED,5880.97
TRANSFER,Savings,2024-06-11 13:01:15,2024-06-11 13:01:15,To EUR Savings,0.2,0,EUR,COMPLETED,5881.17
TRANSFER,Savings,2024-06-11 21:14:19,2024-06-11 21:14:19,To EUR Savings,0.06,0,EUR,COMPLETED,5881.23
TRANSFER,Savings,2024-06-12 07:57:24,2024-06-12 07:57:24,To EUR Savings,0.5,0,EUR,COMPLETED,5881.73
TRANSFER,Savings,2024-06-12 12:48:32,2024-06-12 12:48:32,To EUR Savings,0.91,0,EUR,COMPLETED,5882.64
TRANSFER,Savings,2024-06-13 07:55:32,2024-06-13 07:55:32,To EUR Savings,0.5,0,EUR,COMPLETED,5883.14
TRANSFER,Savings,2024-06-13 10:57:32,2024-06-13 10:57:32,To EUR Savings,1,0,EUR,COMPLETED,5884.14
TRANSFER,Savings,2024-06-13 11:01:54,2024-06-13 11:01:54,To EUR Savings,0.5,0,EUR,COMPLETED,5884.64
TRANSFER,Savings,2024-06-13 11:02:28,2024-06-13 11:02:28,To EUR Savings,0.65,0,EUR,COMPLETED,5885.29
TRANSFER,Savings,2024-06-13 14:03:53,2024-06-13 14:03:53,To EUR Savings,0.4,0,EUR,COMPLETED,5885.69
TRANSFER,Savings,2024-06-13 18:16:18,2024-06-13 18:16:18,To EUR Savings,0.39,0,EUR,COMPLETED,5886.08
TRANSFER,Savings,2024-06-14 11:06:12,2024-06-14 11:06:12,To EUR Savings,1,0,EUR,COMPLETED,5887.08
TRANSFER,Savings,2024-06-14 14:42:26,2024-06-14 14:42:26,To EUR Savings,1,0,EUR,COMPLETED,5888.08
TRANSFER,Savings,2024-06-14 15:01:43,2024-06-14 15:01:43,To EUR Savings,0.5,0,EUR,COMPLETED,5888.58
TRANSFER,Savings,2024-06-15 07:58:17,2024-06-15 07:58:17,To EUR Savings,0.5,0,EUR,COMPLETED,5889.08
TRANSFER,Savings,2024-06-16 08:38:02,2024-06-16 08:38:02,To EUR Savings,0.91,0,EUR,COMPLETED,5889.99
TRANSFER,Savings,2024-06-16 09:57:22,2024-06-16 09:57:22,To EUR Savings,0.6,0,EUR,COMPLETED,5890.59
TRANSFER,Savings,2024-06-16 10:22:55,2024-06-16 10:22:55,To EUR Savings,0.76,0,EUR,COMPLETED,5891.35
TRANSFER,Savings,2024-06-16 14:29:52,2024-06-16 14:29:52,To EUR Savings,0.48,0,EUR,COMPLETED,5891.83
TRANSFER,Savings,2024-06-16 16:18:12,2024-06-16 16:18:12,To EUR Savings,0.68,0,EUR,COMPLETED,5892.51
TRANSFER,Savings,2024-06-16 16:38:12,2024-06-16 16:38:12,To EUR Savings,0.31,0,EUR,COMPLETED,5892.82
TRANSFER,Savings,2024-06-16 19:54:38,2024-06-16 19:54:38,To EUR Savings,0.13,0,EUR,COMPLETED,5892.95
TRANSFER,Savings,2024-06-16 19:59:10,2024-06-16 19:59:10,To EUR Savings,0.81,0,EUR,COMPLETED,5893.76
TRANSFER,Savings,2024-06-16 20:22:02,2024-06-16 20:22:02,To EUR Savings,0.78,0,EUR,COMPLETED,5894.54
TRANSFER,Savings,2024-06-17 02:46:20,2024-06-17 02:46:20,To EUR Savings,0.67,0,EUR,COMPLETED,5895.21
TRANSFER,Savings,2024-06-17 13:00:57,2024-06-17 13:00:57,To EUR Savings,0.62,0,EUR,COMPLETED,5895.83
TRANSFER,Savings,2024-06-17 15:03:00,2024-06-17 15:03:00,To EUR Savings,20,0,EUR,COMPLETED,5915.83
TRANSFER,Savings,2024-06-17 19:58:18,2024-06-17 19:58:18,To EUR Savings,0.04,0,EUR,COMPLETED,5915.87
TRANSFER,Savings,2024-06-17 21:40:57,2024-06-17 21:40:57,To EUR Savings,0.51,0,EUR,COMPLETED,5916.38
TRANSFER,Savings,2024-06-18 19:22:10,2024-06-18 19:22:10,To EUR Savings,0.32,0,EUR,COMPLETED,5916.7
TRANSFER,Savings,2024-06-18 21:31:31,2024-06-18 21:31:31,To EUR Savings,0.32,0,EUR,COMPLETED,5917.02
TRANSFER,Savings,2024-06-19 10:16:18,2024-06-19 10:16:18,To EUR Savings,0.78,0,EUR,COMPLETED,5917.8
TRANSFER,Savings,2024-06-19 12:45:31,2024-06-19 12:45:31,To EUR Savings,0.05,0,EUR,COMPLETED,5917.85
TRANSFER,Savings,2024-06-19 17:54:11,2024-06-19 17:54:11,To EUR Savings,0.16,0,EUR,COMPLETED,5918.01
TRANSFER,Savings,2024-06-19 18:00:08,2024-06-19 18:00:08,To EUR Savings,0.48,0,EUR,COMPLETED,5918.49
TRANSFER,Savings,2024-06-20 02:47:18,2024-06-20 02:47:18,To EUR Savings,0.36,0,EUR,COMPLETED,5918.85
TRANSFER,Savings,2024-06-20 11:16:26,2024-06-20 11:16:26,To EUR Savings,0.44,0,EUR,COMPLETED,5919.29
TRANSFER,Savings,2024-06-20 12:43:16,2024-06-20 12:43:16,To EUR Savings,0.2,0,EUR,COMPLETED,5919.49
TRANSFER,Savings,2024-06-20 13:10:03,2024-06-20 13:10:03,To EUR Savings,0.01,0,EUR,COMPLETED,5919.5
TRANSFER,Savings,2024-06-22 08:16:20,2024-06-22 08:16:20,To EUR Savings,0.5,0,EUR,COMPLETED,5920
TRANSFER,Savings,2024-06-22 09:35:03,2024-06-22 09:35:03,To EUR Savings,0.06,0,EUR,COMPLETED,5920.06
EXCHANGE,Savings,2024-06-22 21:01:00,2024-06-22 21:01:00,Exchange to EUR,0.92,0.01,EUR,COMPLETED,5920.97
TRANSFER,Savings,2024-06-22 21:03:00,2024-06-22 21:03:00,To EUR Savings,0.14,0,EUR,COMPLETED,5921.11
TRANSFER,Savings,2024-06-23 08:29:11,2024-06-23 08:29:11,To EUR Savings,0.5,0,EUR,COMPLETED,5921.61
TRANSFER,Savings,2024-06-23 10:18:57,2024-06-23 10:18:57,To EUR Savings,0.02,0,EUR,COMPLETED,5921.63
TRANSFER,Savings,2024-06-24 15:33:49,2024-06-24 15:33:49,To EUR Savings,20,0,EUR,COMPLETED,5941.63
TRANSFER,Savings,2024-06-24 23:58:20,2024-06-24 23:58:20,To EUR Savings,0.6,0,EUR,COMPLETED,5942.23
TRANSFER,Savings,2024-06-26 14:37:40,2024-06-26 14:37:40,To EUR Savings,0.87,0,EUR,COMPLETED,5943.1
TRANSFER,Savings,2024-06-26 17:52:39,2024-06-26 17:52:39,To EUR Savings,0.85,0,EUR,COMPLETED,5943.95
TRANSFER,Savings,2024-06-26 17:58:11,2024-06-26 17:58:11,To EUR Savings,0.05,0,EUR,COMPLETED,5944
TRANSFER,Savings,2024-06-26 20:09:59,2024-06-26 20:09:59,To EUR Savings,0.2,0,EUR,COMPLETED,5944.2
TRANSFER,Savings,2024-06-27 18:22:59,2024-06-27 18:22:59,To EUR Savings,0.65,0,EUR,COMPLETED,5944.85
TRANSFER,Savings,2024-06-28 12:15:57,2024-06-28 12:15:57,To EUR Savings,0.01,0,EUR,COMPLETED,5944.86
TRANSFER,Savings,2024-06-28 12:37:10,2024-06-28 12:37:10,To EUR Savings,0.2,0,EUR,COMPLETED,5945.06
TRANSFER,Savings,2024-06-28 14:03:47,2024-06-28 14:03:47,To EUR Savings,0.01,0,EUR,COMPLETED,5945.07
TRANSFER,Savings,2024-06-29 08:16:14,2024-06-29 08:16:14,To EUR Savings,0.5,0,EUR,COMPLETED,5945.57
TRANSFER,Savings,2024-06-29 12:27:24,2024-06-29 12:27:24,To EUR Savings,0.5,0,EUR,COMPLETED,5946.07
TRANSFER,Savings,2024-06-29 14:06:24,2024-06-29 14:06:24,To EUR Savings,1,0,EUR,COMPLETED,5947.07
TRANSFER,Savings,2024-06-29 14:06:30,2024-06-29 14:06:30,To EUR Savings,1,0,EUR,COMPLETED,5948.07
TRANSFER,Savings,2024-06-29 15:35:21,2024-06-29 15:35:21,To EUR Savings,0.8,0,EUR,COMPLETED,5948.87
TRANSFER,Savings,2024-06-29 17:22:07,2024-06-29 17:22:07,To EUR Savings,0.26,0,EUR,COMPLETED,5949.13
TRANSFER,Savings,2024-06-30 15:04:50,2024-06-30 15:04:50,To EUR Savings,1,0,EUR,COMPLETED,5950.13
TRANSFER,Savings,2024-06-30 15:36:39,2024-06-30 15:36:39,To EUR Savings,0.52,0,EUR,COMPLETED,5950.65
TRANSFER,Savings,2024-07-01 10:31:42,2024-07-01 10:31:42,To EUR Rainy day,50,0,EUR,COMPLETED,6000.65
TRANSFER,Savings,2024-07-01 10:31:42,2024-07-01 10:31:42,To EUR Savings,20,0,EUR,COMPLETED,6020.65
TRANSFER,Savings,2024-07-01 10:58:15,2024-07-01 10:58:15,To EUR Savings,0.93,0,EUR,COMPLETED,6021.58
TRANSFER,Savings,2024-07-01 17:27:48,2024-07-01 17:27:48,To EUR Savings,1,0,EUR,COMPLETED,6022.58
TRANSFER,Savings,2024-07-02 21:51:40,2024-07-02 21:51:40,To EUR Savings,1,0,EUR,COMPLETED,6023.58
TRANSFER,Savings,2024-07-03 12:55:43,2024-07-03 12:55:43,To EUR Savings,1,0,EUR,COMPLETED,6024.58
TRANSFER,Savings,2024-07-03 18:44:53,2024-07-03 18:44:53,To EUR Savings,0.52,0,EUR,COMPLETED,6025.1
TRANSFER,Savings,2024-07-03 20:15:50,2024-07-03 20:15:50,To EUR Savings,0.2,0,EUR,COMPLETED,6025.3
TRANSFER,Savings,2024-07-04 21:43:37,2024-07-04 21:43:37,To EUR Savings,0.8,0,EUR,COMPLETED,6026.1
TRANSFER,Savings,2024-07-05 12:55:27,2024-07-05 12:55:27,To EUR Savings,1,0,EUR,COMPLETED,6027.1
TRANSFER,Savings,2024-07-05 15:46:20,2024-07-05 15:46:20,To EUR Savings,0.2,0,EUR,COMPLETED,6027.3
TRANSFER,Savings,2024-07-06 15:04:39,2024-07-06 15:04:39,To EUR Savings,0.1,0,EUR,COMPLETED,6027.4
TRANSFER,Savings,2024-07-06 18:21:56,2024-07-06 18:21:56,To EUR Savings,0.74,0,EUR,COMPLETED,6028.14
TRANSFER,Savings,2024-07-07 14:03:46,2024-07-07 14:03:46,To EUR Savings,0.3,0,EUR,COMPLETED,6028.44
TRANSFER,Savings,2024-07-07 16:50:23,2024-07-07 16:50:23,To EUR Savings,1,0,EUR,COMPLETED,6029.44
TRANSFER,Savings,2024-07-08 08:11:07,2024-07-08 08:11:07,To EUR Savings,0.5,0,EUR,COMPLETED,6029.94
TRANSFER,Savings,2024-07-08 11:07:28,2024-07-08 11:07:28,To EUR Savings,0.01,0,EUR,COMPLETED,6029.95
TRANSFER,Savings,2024-07-08 13:42:10,2024-07-08 13:42:10,To EUR Savings,0.01,0,EUR,COMPLETED,6029.96
TRANSFER,Savings,2024-07-08 15:40:50,2024-07-08 15:40:50,To EUR Savings,0.91,0,EUR,COMPLETED,6030.87
TRANSFER,Savings,2024-07-08 15:52:21,2024-07-08 15:52:21,To EUR Savings,20,0,EUR,COMPLETED,6050.87
TRANSFER,Savings,2024-07-08 17:52:26,2024-07-08 17:52:26,To EUR Savings,0.5,0,EUR,COMPLETED,6051.37
TRANSFER,Savings,2024-07-09 08:28:28,2024-07-09 08:28:28,To EUR Savings,0.5,0,EUR,COMPLETED,6051.87
TRANSFER,Savings,2024-07-09 11:23:29,2024-07-09 11:23:29,To EUR Savings,0.1,0,EUR,COMPLETED,6051.97
TRANSFER,Savings,2024-07-09 11:46:21,2024-07-09 11:46:21,To EUR Savings,0.93,0,EUR,COMPLETED,6052.9
TRANSFER,Savings,2024-07-09 12:05:46,2024-07-09 12:05:46,To EUR Savings,0.05,0,EUR,COMPLETED,6052.95
TRANSFER,Savings,2024-07-09 12:23:32,2024-07-09 12:23:32,To EUR Savings,0.11,0,EUR,COMPLETED,6053.06
TRANSFER,Savings,2024-07-09 16:28:05,2024-07-09 16:28:05,To EUR Savings,0.56,0,EUR,COMPLETED,6053.62
TRANSFER,Savings,2024-07-09 21:35:39,2024-07-09 21:35:39,To EUR Savings,0.81,0,EUR,COMPLETED,6054.43
TRANSFER,Savings,2024-07-10 08:30:53,2024-07-10 08:30:53,To EUR Savings,0.5,0,EUR,COMPLETED,6054.93
TRANSFER,Savings,2024-07-10 10:54:43,2024-07-10 10:54:43,To EUR Savings,0.29,0,EUR,COMPLETED,6055.22
TRANSFER,Savings,2024-07-10 14:26:25,2024-07-10 14:26:25,To EUR Savings,0.76,0,EUR,COMPLETED,6055.98
TRANSFER,Savings,2024-07-10 19:19:37,2024-07-10 19:19:37,To EUR Savings,0.23,0,EUR,COMPLETED,6056.21
TRANSFER,Savings,2024-07-10 19:47:44,2024-07-10 19:47:44,To EUR Savings,1,0,EUR,COMPLETED,6057.21
TRANSFER,Savings,2024-07-10 22:56:26,2024-07-10 22:56:26,To EUR Savings,0.77,0,EUR,COMPLETED,6057.98
TRANSFER,Savings,2024-07-10 22:57:55,2024-07-10 22:57:55,To EUR Savings,0.34,0,EUR,COMPLETED,6058.32
TRANSFER,Savings,2024-07-10 23:10:12,2024-07-10 23:10:12,To EUR Savings,0.45,0,EUR,COMPLETED,6058.77
TRANSFER,Savings,2024-07-11 12:40:43,2024-07-11 12:40:43,To EUR Savings,0.3,0,EUR,COMPLETED,6059.07
TRANSFER,Savings,2024-07-12 08:30:31,2024-07-12 08:30:31,To EUR Savings,0.5,0,EUR,COMPLETED,6059.57
TRANSFER,Savings,2024-07-12 13:05:20,2024-07-12 13:05:20,To EUR Savings,0.8,0,EUR,COMPLETED,6060.37
TRANSFER,Savings,2024-07-12 20:13:47,2024-07-12 20:13:47,To EUR Savings,0.38,0,EUR,COMPLETED,6060.75
TRANSFER,Savings,2024-07-13 07:56:30,2024-07-13 07:56:30,To EUR Savings,0.5,0,EUR,COMPLETED,6061.25
TRANSFER,Savings,2024-07-13 09:04:40,2024-07-13 09:04:40,To EUR Savings,1,0,EUR,COMPLETED,6062.25
TRANSFER,Savings,2024-07-13 10:25:30,2024-07-13 10:25:30,To EUR Savings,0.5,0,EUR,COMPLETED,6062.75
TRANSFER,Savings,2024-07-13 11:08:02,2024-07-13 11:08:02,To EUR Savings,0.5,0,EUR,COMPLETED,6063.25
TRANSFER,Savings,2024-07-13 12:22:37,2024-07-13 12:22:37,To EUR Savings,0.85,0,EUR,COMPLETED,6064.1
TRANSFER,Savings,2024-07-14 08:27:31,2024-07-14 08:27:31,To EUR Savings,0.5,0,EUR,COMPLETED,6064.6
TRANSFER,Savings,2024-07-14 15:15:01,2024-07-14 15:15:01,To EUR Savings,0.01,0,EUR,COMPLETED,6064.61
TRANSFER,Savings,2024-07-14 20:03:11,2024-07-14 20:03:11,To EUR Savings,0.5,0,EUR,COMPLETED,6065.11
TRANSFER,Savings,2024-07-15 09:56:26,2024-07-15 09:56:26,To EUR Savings,20,0,EUR,COMPLETED,6085.11
TRANSFER,Savings,2024-07-17 11:47:43,2024-07-17 11:47:43,To EUR Savings,0.03,0,EUR,COMPLETED,6085.14
TRANSFER,Savings,2024-07-17 11:49:46,2024-07-17 11:49:46,To EUR Savings,0.84,0,EUR,COMPLETED,6085.98
TRANSFER,Savings,2024-07-17 17:25:27,2024-07-17 17:25:27,To EUR Savings,0.95,0,EUR,COMPLETED,6086.93
TRANSFER,Savings,2024-07-17 17:51:28,2024-07-17 17:51:28,To EUR Savings,0.46,0,EUR,COMPLETED,6087.39
TRANSFER,Savings,2024-07-17 18:16:32,2024-07-17 18:16:32,To EUR Savings,0.56,0,EUR,COMPLETED,6087.95
TRANSFER,Savings,2024-07-17 21:40:57,2024-07-17 21:40:57,To EUR Savings,0.51,0,EUR,COMPLETED,6088.46
TRANSFER,Savings,2024-07-18 08:14:32,2024-07-18 08:14:32,To EUR Savings,0.21,0,EUR,COMPLETED,6088.67
TRANSFER,Savings,2024-07-18 10:15:28,2024-07-18 10:15:28,To EUR Savings,0.82,0,EUR,COMPLETED,6089.49
TRANSFER,Savings,2024-07-18 12:47:04,2024-07-18 12:47:04,To EUR Savings,0.2,0,EUR,COMPLETED,6089.69
TRANSFER,Savings,2024-07-18 14:15:09,2024-07-18 14:15:09,To EUR Savings,1,0,EUR,COMPLETED,6090.69
TRANSFER,Savings,2024-07-18 20:42:12,2024-07-18 20:42:12,To EUR Savings,0.67,0,EUR,COMPLETED,6091.36
TRANSFER,Savings,2024-07-19 12:46:47,2024-07-19 12:46:47,To EUR Savings,0.34,0,EUR,COMPLETED,6091.7
TRANSFER,Savings,2024-07-20 08:21:43,2024-07-20 08:21:43,To EUR Savings,0.5,0,EUR,COMPLETED,6092.2
TRANSFER,Savings,2024-07-20 13:10:03,2024-07-20 13:10:03,To EUR Savings,0.01,0,EUR,COMPLETED,6092.21
TRANSFER,Savings,2024-07-20 15:35:26,2024-07-20 15:35:26,To EUR Savings,0.75,0,EUR,COMPLETED,6092.96
TRANSFER,Savings,2024-07-21 08:29:11,2024-07-21 08:29:11,To EUR Savings,0.5,0,EUR,COMPLETED,6093.46
TRANSFER,Savings,2024-07-21 11:31:08,2024-07-21 11:31:08,To EUR Savings,0.2,0,EUR,COMPLETED,6093.66
TRANSFER,Savings,2024-07-21 12:47:17,2024-07-21 12:47:17,To EUR Savings,0.25,0,EUR,COMPLETED,6093.91
TRANSFER,Savings,2024-07-22 09:49:44,2024-07-22 09:49:44,To EUR Savings,20,0,EUR,COMPLETED,6113.91
TRANSFER,Savings,2024-07-22 13:02:57,2024-07-22 13:02:57,To EUR Savings,0.8,0,EUR,COMPLETED,6114.71
TRANSFER,Savings,2024-07-23 19:28:27,2024-07-23 19:28:27,To EUR Savings,0.66,0,EUR,COMPLETED,6115.37
TRANSFER,Savings,2024-07-24 13:08:03,2024-07-24 13:08:03,To EUR Savings,0.95,0,EUR,COMPLETED,6116.32
TRANSFER,Savings,2024-07-24 14:24:40,2024-07-24 14:24:40,To EUR Savings,0.01,0,EUR,COMPLETED,6116.33
TRANSFER,Savings,2024-07-24 18:59:12,2024-07-24 18:59:12,To EUR Savings,0.64,0,EUR,COMPLETED,6116.97
TRANSFER,Savings,2024-07-25 08:35:18,2024-07-25 08:35:18,To EUR Savings,0.68,0,EUR,COMPLETED,6117.65
TRANSFER,Savings,2024-07-25 12:35:43,2024-07-25 12:35:43,To EUR Savings,0.2,0,EUR,COMPLETED,6117.85
TRANSFER,Savings,2024-07-25 15:27:48,2024-07-25 15:27:48,To EUR Savings,0.76,0,EUR,COMPLETED,6118.61
TRANSFER,Savings,2024-07-27 07:36:32,2024-07-27 07:36:32,To EUR Savings,0.5,0,EUR,COMPLETED,6119.11
TRANSFER,Savings,2024-07-27 12:07:33,2024-07-27 12:07:33,To EUR Savings,0.2,0,EUR,COMPLETED,6119.31
TRANSFER,Savings,2024-07-27 12:39:35,2024-07-27 12:39:35,To EUR Savings,1,0,EUR,COMPLETED,6120.31
TRANSFER,Savings,2024-07-27 13:21:50,2024-07-27 13:21:50,To EUR Savings,0.53,0,EUR,COMPLETED,6120.84
TRANSFER,Savings,2024-07-27 14:51:01,2024-07-27 14:51:01,To EUR Savings,0.1,0,EUR,COMPLETED,6120.94
TRANSFER,Savings,2024-07-27 20:12:08,2024-07-27 20:12:08,To EUR Savings,0.3,0,EUR,COMPLETED,6121.24
TRANSFER,Savings,2024-07-28 09:16:09,2024-07-28 09:16:09,To EUR Savings,0.5,0,EUR,COMPLETED,6121.74
TRANSFER,Savings,2024-07-28 11:42:01,2024-07-28 11:42:01,To EUR Savings,0.01,0,EUR,COMPLETED,6121.75
TRANSFER,Savings,2024-07-28 12:15:51,2024-07-28 12:15:51,To EUR Savings,0.01,0,EUR,COMPLETED,6121.76
TRANSFER,Savings,2024-07-28 20:32:01,2024-07-28 20:32:01,To EUR Savings,0.8,0,EUR,COMPLETED,6122.56
TRANSFER,Savings,2024-07-29 09:51:45,2024-07-29 09:51:45,To EUR Savings,20,0,EUR,COMPLETED,6142.56
TRANSFER,Savings,2024-07-29 22:17:43,2024-07-29 22:17:43,To EUR Savings,1,0,EUR,COMPLETED,6143.56
TRANSFER,Savings,2024-07-30 18:12:38,2024-07-30 18:12:38,To EUR Savings,0.2,0,EUR,COMPLETED,6143.76
TRANSFER,Savings,2024-07-31 18:08:36,2024-07-31 18:08:36,To EUR Savings,0.9,0,EUR,COMPLETED,6144.66
TRANSFER,Savings,2024-07-31 19:58:50,2024-07-31 19:58:50,To EUR Savings,0.5,0,EUR,COMPLETED,6145.16
TRANSFER,Savings,2024-07-31 20:33:20,2024-07-31 20:33:20,To EUR Savings,1,0,EUR,COMPLETED,6146.16
TRANSFER,Savings,2024-08-01 08:35:51,2024-08-01 08:35:51,To EUR Rainy day,50,0,EUR,COMPLETED,6196.16
TRANSFER,Savings,2024-08-01 13:00:56,2024-08-01 13:00:56,To EUR Savings,0.38,0,EUR,COMPLETED,6196.54
TRANSFER,Savings,2024-08-02 20:56:34,2024-08-02 20:56:34,To EUR Savings,0.99,0,EUR,COMPLETED,6197.53
TRANSFER,Savings,2024-08-03 07:51:50,2024-08-03 07:51:50,To EUR Savings,0.5,0,EUR,COMPLETED,6198.03
TRANSFER,Savings,2024-08-03 09:08:04,2024-08-03 09:08:04,To EUR Savings,0.09,0,EUR,COMPLETED,6198.12
TRANSFER,Savings,2024-08-03 09:38:10,2024-08-03 09:38:10,To EUR Savings,0.51,0,EUR,COMPLETED,6198.63
TRANSFER,Savings,2024-08-03 15:11:13,2024-08-03 15:11:13,To EUR Savings,1,0,EUR,COMPLETED,6199.63
TRANSFER,Savings,2024-08-04 08:32:31,2024-08-04 08:32:31,To EUR Savings,0.5,0,EUR,COMPLETED,6200.13
TRANSFER,Savings,2024-08-04 10:03:27,2024-08-04 10:03:27,To EUR Savings,0.86,0,EUR,COMPLETED,6200.99
TRANSFER,Savings,2024-08-04 10:19:59,2024-08-04 10:19:59,To EUR Savings,0.5,0,EUR,COMPLETED,6201.49
TRANSFER,Savings,2024-08-04 15:58:23,2024-08-04 15:58:23,To EUR Savings,1,0,EUR,COMPLETED,6202.49
TRANSFER,Savings,2024-08-05 09:56:04,2024-08-05 09:56:04,To EUR Savings,20,0,EUR,COMPLETED,6222.49
TRANSFER,Savings,2024-08-06 15:03:59,2024-08-06 15:03:59,To EUR Savings,0.65,0,EUR,COMPLETED,6223.14
TRANSFER,Savings,2024-08-06 18:14:13,2024-08-06 18:14:13,To EUR Savings,0.81,0,EUR,COMPLETED,6223.95
TRANSFER,Savings,2024-08-07 18:49:24,2024-08-07 18:49:24,To EUR Savings,1,0,EUR,COMPLETED,6224.95
TRANSFER,Savings,2024-08-08 08:34:51,2024-08-08 08:34:51,To EUR Savings,0.9,0,EUR,COMPLETED,6225.85
TRANSFER,Savings,2024-08-08 12:41:33,2024-08-08 12:41:33,To EUR Savings,0.2,0,EUR,COMPLETED,6226.05
TRANSFER,Savings,2024-08-09 21:24:35,2024-08-09 21:24:35,To EUR Savings,0.9,0,EUR,COMPLETED,6226.95
TRANSFER,Savings,2024-08-10 08:17:46,2024-08-10 08:17:46,To EUR Savings,0.01,0,EUR,COMPLETED,6226.96
TRANSFER,Savings,2024-08-10 11:48:39,2024-08-10 11:48:39,To EUR Savings,0.04,0,EUR,COMPLETED,6227
TRANSFER,Savings,2024-08-10 12:15:37,2024-08-10 12:15:37,To EUR Savings,0.32,0,EUR,COMPLETED,6227.32
TRANSFER,Savings,2024-08-10 12:48:42,2024-08-10 12:48:42,To EUR Savings,0.9,0,EUR,COMPLETED,6228.22
TRANSFER,Savings,2024-08-10 13:00:53,2024-08-10 13:00:53,To EUR Savings,0.58,0,EUR,COMPLETED,6228.8
TRANSFER,Savings,2024-08-10 13:10:27,2024-08-10 13:10:27,To EUR Savings,1,0,EUR,COMPLETED,6229.8
TRANSFER,Savings,2024-08-10 13:11:33,2024-08-10 13:11:33,To EUR Savings,0.01,0,EUR,COMPLETED,6229.81
TRANSFER,Savings,2024-08-10 19:05:23,2024-08-10 19:05:23,To EUR Savings,0.5,0,EUR,COMPLETED,6230.31
TRANSFER,Savings,2024-08-10 21:12:04,2024-08-10 21:12:04,To EUR Savings,0.95,0,EUR,COMPLETED,6231.26
TRANSFER,Savings,2024-08-10 21:13:45,2024-08-10 21:13:45,To EUR Savings,0.95,0,EUR,COMPLETED,6232.21
TRANSFER,Savings,2024-08-11 08:16:07,2024-08-11 08:16:07,To EUR Savings,0.5,0,EUR,COMPLETED,6232.71
TRANSFER,Savings,2024-08-11 09:19:30,2024-08-11 09:19:30,To EUR Savings,0.06,0,EUR,COMPLETED,6232.77
TRANSFER,Savings,2024-08-12 09:49:33,2024-08-12 09:49:33,To EUR Savings,20,0,EUR,COMPLETED,6252.77
TRANSFER,Savings,2024-08-15 08:10:45,2024-08-15 08:10:45,To EUR Savings,0.5,0,EUR,COMPLETED,6253.27
TRANSFER,Savings,2024-08-15 12:51:48,2024-08-15 12:51:48,To EUR Savings,0.8,0,EUR,COMPLETED,6254.07
TRANSFER,Savings,2024-08-16 12:26:26,2024-08-16 12:26:26,To EUR Savings,0.2,0,EUR,COMPLETED,6254.27
TRANSFER,Savings,2024-08-17 08:19:33,2024-08-17 08:19:33,To EUR Savings,0.5,0,EUR,COMPLETED,6254.77
TRANSFER,Savings,2024-08-17 12:17:19,2024-08-17 12:17:19,To EUR Savings,0.68,0,EUR,COMPLETED,6255.45
TRANSFER,Savings,2024-08-17 15:42:11,2024-08-17 15:42:11,To EUR Savings,0.87,0,EUR,COMPLETED,6256.32
TRANSFER,Savings,2024-08-17 21:40:57,2024-08-17 21:40:57,To EUR Savings,0.51,0,EUR,COMPLETED,6256.83
TRANSFER,Savings,2024-08-18 08:19:09,2024-08-18 08:19:09,To EUR Savings,0.5,0,EUR,COMPLETED,6257.33
TRANSFER,Savings,2024-08-18 11:23:18,2024-08-18 11:23:18,To EUR Savings,0.9,0,EUR,COMPLETED,6258.23
TRANSFER,Savings,2024-08-18 15:41:12,2024-08-18 15:41:12,To EUR Savings,0.1,0,EUR,COMPLETED,6258.33
TRANSFER,Savings,2024-08-19 09:47:06,2024-08-19 09:47:06,To EUR Savings,20,0,EUR,COMPLETED,6278.33
TRANSFER,Savings,2024-08-19 12:51:24,2024-08-19 12:51:24,To EUR Savings,0.65,0,EUR,COMPLETED,6278.98
TRANSFER,Savings,2024-08-20 13:10:03,2024-08-20 13:10:03,To EUR Savings,0.01,0,EUR,COMPLETED,6278.99
TRANSFER,Savings,2024-08-22 13:06:01,2024-08-22 13:06:01,To EUR Savings,0.2,0,EUR,COMPLETED,6279.19
TRANSFER,Savings,2024-08-24 08:16:06,2024-08-24 08:16:06,To EUR Savings,0.5,0,EUR,COMPLETED,6279.69
TRANSFER,Savings,2024-08-24 09:08:01,2024-08-24 09:08:01,To EUR Savings,0.42,0,EUR,COMPLETED,6280.11
TRANSFER,Savings,2024-08-24 09:48:23,2024-08-24 09:48:23,To EUR Savings,0.27,0,EUR,COMPLETED,6280.38
TRANSFER,Savings,2024-08-24 09:57:17,2024-08-24 09:57:17,To EUR Savings,0.41,0,EUR,COMPLETED,6280.79
TRANSFER,Savings,2024-08-24 12:36:40,2024-08-24 12:36:40,To EUR Savings,0.6,0,EUR,COMPLETED,6281.39
TRANSFER,Savings,2024-08-25 08:18:57,2024-08-25 08:18:57,To EUR Savings,0.5,0,EUR,COMPLETED,6281.89
TRANSFER,Savings,2024-08-25 13:58:40,2024-08-25 13:58:40,To EUR Savings,1,0,EUR,COMPLETED,6282.89
TRANSFER,Savings,2024-08-25 14:06:23,2024-08-25 14:06:23,To EUR Savings,0.4,0,EUR,COMPLETED,6283.29
TRANSFER,Savings,2024-08-25 14:34:58,2024-08-25 14:34:58,To EUR Savings,1,0,EUR,COMPLETED,6284.29
TRANSFER,Savings,2024-08-25 15:45:19,2024-08-25 15:45:19,To EUR Savings,1,0,EUR,COMPLETED,6285.29
TRANSFER,Savings,2024-08-25 23:01:32,2024-08-25 23:01:32,To EUR Savings,0.01,0,EUR,COMPLETED,6285.3
TRANSFER,Savings,2024-08-26 09:51:48,2024-08-26 09:51:48,To EUR Savings,20,0,EUR,COMPLETED,6305.3
TRANSFER,Savings,2024-08-27 12:37:47,2024-08-27 12:37:47,To EUR Savings,0.1,0,EUR,COMPLETED,6305.4
TRANSFER,Savings,2024-08-27 17:11:34,2024-08-27 17:11:34,To EUR Savings,0.11,0,EUR,COMPLETED,6305.51
TRANSFER,Savings,2024-08-28 12:15:52,2024-08-28 12:15:52,To EUR Savings,0.01,0,EUR,COMPLETED,6305.52
TRANSFER,Savings,2024-08-28 17:56:54,2024-08-28 17:56:54,To EUR Savings,0.78,0,EUR,COMPLETED,6306.3
TRANSFER,Savings,2024-08-28 18:51:21,2024-08-28 18:51:21,To EUR Savings,0.01,0,EUR,COMPLETED,6306.31
TRANSFER,Savings,2024-08-29 12:49:29,2024-08-29 12:49:29,To EUR Savings,0.2,0,EUR,COMPLETED,6306.51
TRANSFER,Savings,2024-08-29 16:50:33,2024-08-29 16:50:33,To EUR Savings,0.39,0,EUR,COMPLETED,6306.9
TRANSFER,Savings,2024-08-29 18:21:13,2024-08-29 18:21:13,To EUR Savings,0.94,0,EUR,COMPLETED,6307.84
TRANSFER,Savings,2024-08-30 12:44:43,2024-08-30 12:44:43,To EUR Savings,0.4,0,EUR,COMPLETED,6308.24
TRANSFER,Savings,2024-08-30 16:50:18,2024-08-30 16:50:18,To EUR Savings,0.04,0,EUR,COMPLETED,6308.28
TRANSFER,Savings,2024-08-31 08:21:42,2024-08-31 08:21:42,To EUR Savings,0.5,0,EUR,COMPLETED,6308.78
TRANSFER,Savings,2024-09-01 08:15:30,2024-09-01 08:15:30,To EUR Savings,0.5,0,EUR,COMPLETED,6309.28
TRANSFER,Savings,2024-09-01 08:28:08,2024-09-01 08:28:08,To EUR Rainy day,50,0,EUR,COMPLETED,6359.28
TRANSFER,Savings,2024-09-01 09:30:48,2024-09-01 09:30:48,To EUR Savings,0.92,0,EUR,COMPLETED,6360.2
TRANSFER,Savings,2024-09-01 16:50:47,2024-09-01 16:50:47,To EUR Savings,0.9,0,EUR,COMPLETED,6361.1
TRANSFER,Savings,2024-09-01 20:16:13,2024-09-01 20:16:13,To EUR Savings,0.9,0,EUR,COMPLETED,6362
TRANSFER,Savings,2024-09-02 08:28:56,2024-09-02 08:28:56,To EUR Savings,0.86,0,EUR,COMPLETED,6362.86
TRANSFER,Savings,2024-09-02 09:53:54,2024-09-02 09:53:54,To EUR Savings,20,0,EUR,COMPLETED,6382.86
TRANSFER,Savings,2024-09-03 08:43:48,2024-09-03 08:43:48,To EUR Savings,0.1,0,EUR,COMPLETED,6382.96
TRANSFER,Savings,2024-09-03 08:45:07,2024-09-03 08:45:07,To EUR Savings,0.77,0,EUR,COMPLETED,6383.73
TRANSFER,Savings,2024-09-05 13:01:22,2024-09-05 13:01:22,To EUR Savings,0.3,0,EUR,COMPLETED,6384.03
TRANSFER,Savings,2024-09-07 07:45:54,2024-09-07 07:45:54,To EUR Savings,0.5,0,EUR,COMPLETED,6384.53
TRANSFER,Savings,2024-09-07 11:58:24,2024-09-07 11:58:24,To EUR Savings,0.5,0,EUR,COMPLETED,6385.03
TRANSFER,Savings,2024-09-07 20:50:08,2024-09-07 20:50:08,To EUR Savings,0.1,0,EUR,COMPLETED,6385.13
TRANSFER,Savings,2024-09-08 09:26:33,2024-09-08 09:26:33,To EUR Savings,1,0,EUR,COMPLETED,6386.13
TRANSFER,Savings,2024-09-09 04:19:52,2024-09-09 04:19:52,To EUR Savings,1,0,EUR,COMPLETED,6387.13
TRANSFER,Savings,2024-09-09 09:34:14,2024-09-09 09:34:14,To EUR Savings,0.8,0,EUR,COMPLETED,6387.93
TRANSFER,Savings,2024-09-09 09:47:19,2024-09-09 09:47:19,To EUR Savings,20,0,EUR,COMPLETED,6407.93
TRANSFER,Savings,2024-09-09 14:59:11,2024-09-09 14:59:11,To EUR Savings,1,0,EUR,COMPLETED,6408.93
TRANSFER,Savings,2024-09-10 12:08:59,2024-09-10 12:08:59,To EUR Savings,0.86,0,EUR,COMPLETED,6409.79
TRANSFER,Savings,2024-09-10 12:32:25,2024-09-10 12:32:25,To EUR Savings,0.9,0,EUR,COMPLETED,6410.69
TRANSFER,Savings,2024-09-10 20:29:43,2024-09-10 20:29:43,To EUR Savings,0.6,0,EUR,COMPLETED,6411.29
TRANSFER,Savings,2024-09-11 20:17:44,2024-09-11 20:17:44,To EUR Savings,0.59,0,EUR,COMPLETED,6411.88
TRANSFER,Savings,2024-09-12 08:29:32,2024-09-12 08:29:32,To EUR Savings,0.42,0,EUR,COMPLETED,6412.3
TRANSFER,Savings,2024-09-12 08:36:20,2024-09-12 08:36:20,To EUR Savings,0.55,0,EUR,COMPLETED,6412.85
TRANSFER,Savings,2024-09-12 12:46:40,2024-09-12 12:46:40,To EUR Savings,0.3,0,EUR,COMPLETED,6413.15
TRANSFER,Savings,2024-09-14 08:15:27,2024-09-14 08:15:27,To EUR Savings,0.5,0,EUR,COMPLETED,6413.65
TRANSFER,Savings,2024-09-14 09:25:10,2024-09-14 09:25:10,To EUR Savings,0.01,0,EUR,COMPLETED,6413.66
TRANSFER,Savings,2024-09-15 08:26:47,2024-09-15 08:26:47,To EUR Savings,0.5,0,EUR,COMPLETED,6414.16
TRANSFER,Savings,2024-09-15 14:13:54,2024-09-15 14:13:54,To EUR Savings,0.5,0,EUR,COMPLETED,6414.66
TRANSFER,Savings,2024-09-16 09:48:18,2024-09-16 09:48:18,To EUR Savings,20,0,EUR,COMPLETED,6434.66
TRANSFER,Savings,2024-09-17 21:40:58,2024-09-17 21:40:58,To EUR Savings,0.51,0,EUR,COMPLETED,6435.17
TRANSFER,Savings,2024-09-18 11:16:58,2024-09-18 11:16:58,To EUR Savings,0.99,0,EUR,COMPLETED,6436.16
TRANSFER,Savings,2024-09-19 12:48:05,2024-09-19 12:48:05,To EUR Savings,0.87,0,EUR,COMPLETED,6437.03
TRANSFER,Savings,2024-09-19 13:05:26,2024-09-19 13:05:26,To EUR Savings,0.8,0,EUR,COMPLETED,6437.83
TRANSFER,Savings,2024-09-20 13:07:34,2024-09-20 13:07:34,To EUR Savings,0.1,0,EUR,COMPLETED,6437.93
TRANSFER,Savings,2024-09-20 13:10:03,2024-09-20 13:10:03,To EUR Savings,0.01,0,EUR,COMPLETED,6437.94
TRANSFER,Savings,2024-09-20 21:01:04,2024-09-20 21:01:04,To EUR Savings,0.01,0,EUR,COMPLETED,6437.95
TRANSFER,Savings,2024-09-21 08:16:23,2024-09-21 08:16:23,To EUR Savings,0.5,0,EUR,COMPLETED,6438.45
TRANSFER,Savings,2024-09-21 20:29:33,2024-09-21 20:29:33,To EUR Savings,0.5,0,EUR,COMPLETED,6438.95
TRANSFER,Savings,2024-09-22 08:09:01,2024-09-22 08:09:01,To EUR Savings,0.5,0,EUR,COMPLETED,6439.45
TRANSFER,Savings,2024-09-22 08:38:38,2024-09-22 08:38:38,To EUR Savings,0.41,0,EUR,COMPLETED,6439.86
TRANSFER,Savings,2024-09-22 12:43:47,2024-09-22 12:43:47,To EUR Savings,0.8,0,EUR,COMPLETED,6440.66
TRANSFER,Savings,2024-09-23 08:18:00,2024-09-23 08:18:00,To EUR Savings,0.96,0,EUR,COMPLETED,6441.62
TRANSFER,Savings,2024-09-23 09:55:10,2024-09-23 09:55:10,To EUR Savings,20,0,EUR,COMPLETED,6461.62
TRANSFER,Savings,2024-09-26 09:28:20,2024-09-26 09:28:20,To EUR Savings,0.99,0,EUR,COMPLETED,6462.61
TRANSFER,Savings,2024-09-26 13:05:37,2024-09-26 13:05:37,To EUR Savings,0.2,0,EUR,COMPLETED,6462.81
TRANSFER,Savings,2024-09-27 13:48:38,2024-09-27 13:48:38,To EUR Savings,0.25,0,EUR,COMPLETED,6463.06
TRANSFER,Savings,2024-09-28 08:19:20,2024-09-28 08:19:20,To EUR Savings,0.5,0,EUR,COMPLETED,6463.56
TRANSFER,Savings,2024-09-28 10:41:03,2024-09-28 10:41:03,To EUR Savings,0.02,0,EUR,COMPLETED,6463.58
TRANSFER,Savings,2024-09-28 12:15:48,2024-09-28 12:15:48,To EUR Savings,0.01,0,EUR,COMPLETED,6463.59
TRANSFER,Savings,2024-09-28 20:47:47,2024-09-28 20:47:47,To EUR Savings,0.15,0,EUR,COMPLETED,6463.74
TRANSFER,Savings,2024-09-29 05:53:02,2024-09-29 05:53:02,To EUR Savings,0.51,0,EUR,COMPLETED,6464.25
TRANSFER,Savings,2024-09-29 08:35:42,2024-09-29 08:35:42,To EUR Savings,0.5,0,EUR,COMPLETED,6464.75
TRANSFER,Savings,2024-09-29 09:43:27,2024-09-29 09:43:27,To EUR Savings,0.27,0,EUR,COMPLETED,6465.02
TRANSFER,Savings,2024-09-29 13:08:35,2024-09-29 13:08:35,To EUR Savings,0.41,0,EUR,COMPLETED,6465.43
TRANSFER,Savings,2024-09-30 02:53:46,2024-09-30 02:53:46,To EUR Savings,0.05,0,EUR,COMPLETED,6465.48
TRANSFER,Savings,2024-09-30 03:58:44,2024-09-30 03:58:44,To EUR Savings,20,0,EUR,COMPLETED,6485.48
TRANSFER,Savings,2024-10-01 02:25:25,2024-10-01 02:25:25,To EUR Rainy day,50,0,EUR,COMPLETED,6535.48
TRANSFER,Savings,2024-10-01 12:52:07,2024-10-01 12:52:07,To EUR Savings,0.29,0,EUR,COMPLETED,6535.77
TRANSFER,Savings,2024-10-03 12:20:54,2024-10-03 12:20:54,To EUR Savings,0.23,0,EUR,COMPLETED,6536
TRANSFER,Savings,2024-10-03 15:28:37,2024-10-03 15:28:37,To EUR Savings,0.03,0,EUR,COMPLETED,6536.03
TRANSFER,Savings,2024-10-04 16:58:33,2024-10-04 16:58:33,To EUR Savings,0.45,0,EUR,COMPLETED,6536.48
TRANSFER,Savings,2024-10-04 21:43:43,2024-10-04 21:43:43,To EUR Savings,0.6,0,EUR,COMPLETED,6537.08
TRANSFER,Savings,2024-10-05 00:03:02,2024-10-05 00:03:02,To EUR Savings,0.4,0,EUR,COMPLETED,6537.48
TRANSFER,Savings,2024-10-05 08:16:52,2024-10-05 08:16:52,To EUR Savings,0.5,0,EUR,COMPLETED,6537.98
TRANSFER,Savings,2024-10-05 12:32:11,2024-10-05 12:32:11,To EUR Savings,0.35,0,EUR,COMPLETED,6538.33
TRANSFER,Savings,2024-10-05 18:46:45,2024-10-05 18:46:45,To EUR Savings,0.48,0,EUR,COMPLETED,6538.81
TRANSFER,Savings,2024-10-06 08:18:49,2024-10-06 08:18:49,To EUR Savings,0.5,0,EUR,COMPLETED,6539.31
TRANSFER,Savings,2024-10-06 09:06:37,2024-10-06 09:06:37,To EUR Savings,0.93,0,EUR,COMPLETED,6540.24
TRANSFER,Savings,2024-10-06 17:49:27,2024-10-06 17:49:27,To EUR Savings,0.85,0,EUR,COMPLETED,6541.09
TRANSFER,Savings,2024-10-07 07:20:42,2024-10-07 07:20:42,To EUR Savings,20,0,EUR,COMPLETED,6561.09
TRANSFER,Savings,2024-10-08 21:05:36,2024-10-08 21:05:36,To EUR Savings,0.63,0,EUR,COMPLETED,6561.72
TRANSFER,Savings,2024-10-10 12:38:04,2024-10-10 12:38:04,To EUR Savings,0.23,0,EUR,COMPLETED,6561.95
TRANSFER,Savings,2024-10-10 18:12:36,2024-10-10 18:12:36,To EUR Savings,0.03,0,EUR,COMPLETED,6561.98
TRANSFER,Savings,2024-10-11 09:20:36,2024-10-11 09:20:36,To EUR Savings,1,0,EUR,COMPLETED,6562.98
TRANSFER,Savings,2024-10-11 09:29:23,2024-10-11 09:29:23,To EUR Savings,0.6,0,EUR,COMPLETED,6563.58
TRANSFER,Savings,2024-10-12 08:28:53,2024-10-12 08:28:53,To EUR Savings,0.5,0,EUR,COMPLETED,6564.08
TRANSFER,Savings,2024-10-12 12:37:25,2024-10-12 12:37:25,To EUR Savings,0.13,0,EUR,COMPLETED,6564.21
TRANSFER,Savings,2024-10-13 08:18:11,2024-10-13 08:18:11,To EUR Savings,0.5,0,EUR,COMPLETED,6564.71
TRANSFER,Savings,2024-10-13 09:22:54,2024-10-13 09:22:54,To EUR Savings,0.96,0,EUR,COMPLETED,6565.67
TRANSFER,Savings,2024-10-13 09:27:25,2024-10-13 09:27:25,To EUR Savings,0.11,0,EUR,COMPLETED,6565.78
TRANSFER,Savings,2024-10-13 12:33:51,2024-10-13 12:33:51,To EUR Savings,0.93,0,EUR,COMPLETED,6566.71
TRANSFER,Savings,2024-10-13 16:33:12,2024-10-13 16:33:12,To EUR Savings,0.1,0,EUR,COMPLETED,6566.81
TRANSFER,Savings,2024-10-14 11:30:36,2024-10-14 11:30:36,To EUR Savings,20,0,EUR,COMPLETED,6586.81
TRANSFER,Savings,2024-10-15 16:48:22,2024-10-15 16:48:22,To EUR Savings,0.5,0,EUR,COMPLETED,6587.31
TRANSFER,Savings,2024-10-17 08:15:21,2024-10-17 08:15:21,To EUR Savings,0.12,0,EUR,COMPLETED,6587.43
TRANSFER,Savings,2024-10-17 12:52:00,2024-10-17 12:52:00,To EUR Savings,0.23,0,EUR,COMPLETED,6587.66
TRANSFER,Savings,2024-10-18 11:16:00,2024-10-18 11:16:00,To EUR Savings,0.74,0,EUR,COMPLETED,6588.4
TRANSFER,Savings,2024-10-18 12:46:58,2024-10-18 12:46:58,To EUR Savings,0.29,0,EUR,COMPLETED,6588.69
TRANSFER,Savings,2024-10-18 17:44:55,2024-10-18 17:44:55,To EUR Savings,1,0,EUR,COMPLETED,6589.69
TRANSFER,Savings,2024-10-18 20:00:43,2024-10-18 20:00:43,To EUR Savings,0.49,0,EUR,COMPLETED,6590.18
TRANSFER,Savings,2024-10-18 21:34:42,2024-10-18 21:34:42,To EUR Savings,0.02,0,EUR,COMPLETED,6590.2
TRANSFER,Savings,2024-10-19 08:34:16,2024-10-19 08:34:16,To EUR Savings,0.5,0,EUR,COMPLETED,6590.7
TRANSFER,Savings,2024-10-19 09:44:42,2024-10-19 09:44:42,To EUR Savings,0.66,0,EUR,COMPLETED,6591.36
TRANSFER,Savings,2024-10-19 12:46:03,2024-10-19 12:46:03,To EUR Savings,0.29,0,EUR,COMPLETED,6591.65
TRANSFER,Savings,2024-10-19 12:59:02,2024-10-19 12:59:02,To EUR Savings,0.44,0,EUR,COMPLETED,6592.09
TRANSFER,Savings,2024-10-19 20:07:21,2024-10-19 20:07:21,To EUR Savings,0.68,0,EUR,COMPLETED,6592.77
TRANSFER,Savings,2024-10-19 20:20:20,2024-10-19 20:20:20,To EUR Savings,0.54,0,EUR,COMPLETED,6593.31
TRANSFER,Savings,2024-10-20 08:16:36,2024-10-20 08:16:36,To EUR Savings,0.5,0,EUR,COMPLETED,6593.81
TRANSFER,Savings,2024-10-20 12:25:47,2024-10-20 12:25:47,To EUR Savings,0.1,0,EUR,COMPLETED,6593.91
TRANSFER,Savings,2024-10-20 12:45:21,2024-10-20 12:45:21,To EUR Savings,0.77,0,EUR,COMPLETED,6594.68
TRANSFER,Savings,2024-10-20 13:10:03,2024-10-20 13:10:03,To EUR Savings,0.01,0,EUR,COMPLETED,6594.69
TRANSFER,Savings,2024-10-20 13:10:35,2024-10-20 13:10:35,To EUR Savings,0.22,0,EUR,COMPLETED,6594.91
TRANSFER,Savings,2024-10-21 07:16:07,2024-10-21 07:16:07,To EUR Savings,20,0,EUR,COMPLETED,6614.91
TRANSFER,Savings,2024-10-21 12:45:35,2024-10-21 12:45:35,To EUR Savings,0.1,0,EUR,COMPLETED,6615.01
TRANSFER,Savings,2024-10-23 07:30:26,2024-10-23 07:30:26,To EUR Savings,0.18,0,EUR,COMPLETED,6615.19
TRANSFER,Savings,2024-10-23 08:03:28,2024-10-23 08:03:28,To EUR Savings,0.5,0,EUR,COMPLETED,6615.69
TRANSFER,Savings,2024-10-23 08:12:25,2024-10-23 08:12:25,To EUR Savings,0.01,0,EUR,COMPLETED,6615.7
TRANSFER,Savings,2024-10-23 08:41:57,2024-10-23 08:41:57,To EUR Savings,0.7,0,EUR,COMPLETED,6616.4
TRANSFER,Savings,2024-10-24 13:03:58,2024-10-24 13:03:58,To EUR Savings,0.23,0,EUR,COMPLETED,6616.63
TRANSFER,Savings,2024-10-24 13:23:17,2024-10-24 13:23:17,To EUR Savings,0.01,0,EUR,COMPLETED,6616.64
TRANSFER,Savings,2024-10-26 08:15:16,2024-10-26 08:15:16,To EUR Savings,0.5,0,EUR,COMPLETED,6617.14
TRANSFER,Savings,2024-10-27 08:33:26,2024-10-27 08:33:26,To EUR Savings,0.5,0,EUR,COMPLETED,6617.64
TRANSFER,Savings,2024-10-27 09:34:27,2024-10-27 09:34:27,To EUR Savings,0.36,0,EUR,COMPLETED,6618
TRANSFER,Savings,2024-10-27 12:37:35,2024-10-27 12:37:35,To EUR Savings,0.5,0,EUR,COMPLETED,6618.5
TRANSFER,Savings,2024-10-27 14:59:13,2024-10-27 14:59:13,To EUR Savings,0.8,0,EUR,COMPLETED,6619.3
TRANSFER,Savings,2024-10-28 03:16:47,2024-10-28 03:16:47,To EUR Savings,20,0,EUR,COMPLETED,6639.3
TRANSFER,Savings,2024-10-28 11:16:10,2024-10-28 11:16:10,To EUR Savings,0.01,0,EUR,COMPLETED,6639.31
TRANSFER,Savings,2024-10-29 04:52:13,2024-10-29 04:52:13,To EUR Savings,0.51,0,EUR,COMPLETED,6639.82
TRANSFER,Savings,2024-10-29 12:43:59,2024-10-29 12:43:59,To EUR Savings,0.79,0,EUR,COMPLETED,6640.61
TRANSFER,Savings,2024-10-29 20:29:29,2024-10-29 20:29:29,To EUR Savings,0.25,0,EUR,COMPLETED,6640.86
TRANSFER,Savings,2024-10-30 01:54:14,2024-10-30 01:54:14,To EUR Savings,0.05,0,EUR,COMPLETED,6640.91
TRANSFER,Savings,2024-10-31 12:57:54,2024-10-31 12:57:54,To EUR Savings,0.23,0,EUR,COMPLETED,6641.14
TRANSFER,Savings,2024-10-31 17:40:22,2024-10-31 17:40:22,To EUR Savings,0.01,0,EUR,COMPLETED,6641.15
TRANSFER,Savings,2024-11-01 00:45:52,2024-11-01 00:45:52,To EUR Savings,0.05,0,EUR,COMPLETED,6641.2
TRANSFER,Savings,2024-11-01 01:44:13,2024-11-01 01:44:13,To EUR Rainy day,50,0,EUR,COMPLETED,6691.2
TRANSFER,Savings,2024-11-01 08:11:59,2024-11-01 08:11:59,To EUR Savings,0.5,0,EUR,COMPLETED,6691.7
TRANSFER,Savings,2024-11-01 15:25:22,2024-11-01 15:25:22,To EUR Savings,1,0,EUR,COMPLETED,6692.7
TRANSFER,Savings,2024-11-02 08:25:25,2024-11-02 08:25:25,To EUR Savings,0.5,0,EUR,COMPLETED,6693.2
TRANSFER,Savings,2024-11-03 07:59:45,2024-11-03 07:59:45,To EUR Savings,0.5,0,EUR,COMPLETED,6693.7
TRANSFER,Savings,2024-11-03 08:53:42,2024-11-03 08:53:42,To EUR Savings,0.47,0,EUR,COMPLETED,6694.17
TRANSFER,Savings,2024-11-03 09:18:52,2024-11-03 09:18:52,To EUR Savings,0.39,0,EUR,COMPLETED,6694.56
TRANSFER,Savings,2024-11-03 12:42:37,2024-11-03 12:42:37,To EUR Savings,0.71,0,EUR,COMPLETED,6695.27
TRANSFER,Savings,2024-11-04 01:48:26,2024-11-04 01:48:26,To EUR Savings,20,0,EUR,COMPLETED,6715.27
TRANSFER,Savings,2024-11-05 19:18:09,2024-11-05 19:18:09,To EUR Savings,0.43,0,EUR,COMPLETED,6715.7
TRANSFER,Savings,2024-11-06 18:02:51,2024-11-06 18:02:51,To EUR Savings,0.64,0,EUR,COMPLETED,6716.34
TRANSFER,Savings,2024-11-07 08:27:46,2024-11-07 08:27:46,To EUR Savings,1,0,EUR,COMPLETED,6717.34
TRANSFER,Savings,2024-11-07 08:28:47,2024-11-07 08:28:47,To EUR Savings,0.1,0,EUR,COMPLETED,6717.44
TRANSFER,Savings,2024-11-07 12:48:56,2024-11-07 12:48:56,To EUR Savings,0.5,0,EUR,COMPLETED,6717.94
TRANSFER,Savings,2024-11-09 08:40:31,2024-11-09 08:40:31,To EUR Savings,0.5,0,EUR,COMPLETED,6718.44
TRANSFER,Savings,2024-11-09 12:30:32,2024-11-09 12:30:32,To EUR Savings,0.31,0,EUR,COMPLETED,6718.75
TRANSFER,Savings,2024-11-09 12:39:39,2024-11-09 12:39:39,To EUR Savings,0.79,0,EUR,COMPLETED,6719.54
TRANSFER,Savings,2024-11-10 08:31:38,2024-11-10 08:31:38,To EUR Savings,0.5,0,EUR,COMPLETED,6720.04
TRANSFER,Savings,2024-11-10 09:14:35,2024-11-10 09:14:35,To EUR Savings,0.04,0,EUR,COMPLETED,6720.08
TRANSFER,Savings,2024-11-10 09:41:02,2024-11-10 09:41:02,To EUR Savings,0.7,0,EUR,COMPLETED,6720.78
TRANSFER,Savings,2024-11-10 13:59:22,2024-11-10 13:59:22,To EUR Savings,1,0,EUR,COMPLETED,6721.78
TRANSFER,Savings,2024-11-10 14:09:36,2024-11-10 14:09:36,To EUR Savings,0.4,0,EUR,COMPLETED,6722.18
TRANSFER,Savings,2024-11-10 14:40:56,2024-11-10 14:40:56,To EUR Savings,0.2,0,EUR,COMPLETED,6722.38
TRANSFER,Savings,2024-11-10 14:45:59,2024-11-10 14:45:59,To EUR Savings,0.5,0,EUR,COMPLETED,6722.88
TRANSFER,Savings,2024-11-10 14:52:54,2024-11-10 14:52:54,To EUR Savings,1,0,EUR,COMPLETED,6723.88
TRANSFER,Savings,2024-11-10 20:55:51,2024-11-10 20:55:51,To EUR Savings,0.67,0,EUR,COMPLETED,6724.55
TRANSFER,Savings,2024-11-11 01:52:38,2024-11-11 01:52:38,To EUR Savings,20,0,EUR,COMPLETED,6744.55
TRANSFER,Savings,2024-11-14 12:23:55,2024-11-14 12:23:55,To EUR Savings,1,0,EUR,COMPLETED,6745.55
TRANSFER,Savings,2024-11-14 12:45:57,2024-11-14 12:45:57,To EUR Savings,0.23,0,EUR,COMPLETED,6745.78
TRANSFER,Savings,2024-11-16 08:25:05,2024-11-16 08:25:05,To EUR Savings,0.5,0,EUR,COMPLETED,6746.28
TRANSFER,Savings,2024-11-16 09:24:58,2024-11-16 09:24:58,To EUR Savings,0.15,0,EUR,COMPLETED,6746.43
TRANSFER,Savings,2024-11-17 08:27:30,2024-11-17 08:27:30,To EUR Savings,0.5,0,EUR,COMPLETED,6746.93
TRANSFER,Savings,2024-11-17 15:49:28,2024-11-17 15:49:28,To EUR Savings,1,0,EUR,COMPLETED,6747.93
TRANSFER,Savings,2024-11-18 01:56:09,2024-11-18 01:56:09,To EUR Savings,20,0,EUR,COMPLETED,6767.93
TRANSFER,Savings,2024-11-18 10:16:09,2024-11-18 10:16:09,To EUR Savings,0.48,0,EUR,COMPLETED,6768.41
TRANSFER,Savings,2024-11-19 11:46:18,2024-11-19 11:46:18,To EUR Savings,0.58,0,EUR,COMPLETED,6768.99
TRANSFER,Savings,2024-11-20 12:10:03,2024-11-20 12:10:03,To EUR Savings,0.01,0,EUR,COMPLETED,6769
TRANSFER,Savings,2024-11-20 12:56:53,2024-11-20 12:56:53,To EUR Savings,0.29,0,EUR,COMPLETED,6769.29
TRANSFER,Savings,2024-11-22 13:04:48,2024-11-22 13:04:48,To EUR Savings,0.5,0,EUR,COMPLETED,6769.79
TRANSFER,Savings,2024-11-23 07:53:37,2024-11-23 07:53:37,To EUR Savings,0.5,0,EUR,COMPLETED,6770.29
TRANSFER,Savings,2024-11-23 08:12:26,2024-11-23 08:12:26,To EUR Savings,0.01,0,EUR,COMPLETED,6770.3
TRANSFER,Savings,2024-11-23 09:03:17,2024-11-23 09:03:17,To EUR Savings,0.24,0,EUR,COMPLETED,6770.54
TRANSFER,Savings,2024-11-23 09:14:37,2024-11-23 09:14:37,To EUR Savings,0.75,0,EUR,COMPLETED,6771.29
TRANSFER,Savings,2024-11-23 12:54:55,2024-11-23 12:54:55,To EUR Savings,0.63,0,EUR,COMPLETED,6771.92
TRANSFER,Savings,2024-11-24 08:25:55,2024-11-24 08:25:55,To EUR Savings,0.5,0,EUR,COMPLETED,6772.42
TRANSFER,Savings,2024-11-24 12:52:15,2024-11-24 12:52:15,To EUR Savings,0.83,0,EUR,COMPLETED,6773.25
TRANSFER,Savings,2024-11-24 20:10:14,2024-11-24 20:10:14,To EUR Savings,0.93,0,EUR,COMPLETED,6774.18
TRANSFER,Savings,2024-11-25 01:46:20,2024-11-25 01:46:20,To EUR Savings,20,0,EUR,COMPLETED,6794.18
TRANSFER,Savings,2024-11-25 16:21:39,2024-11-25 16:21:39,To EUR Savings,1,0,EUR,COMPLETED,6795.18
TRANSFER,Savings,2024-11-25 22:50:55,2024-11-25 22:50:55,To EUR Savings,0.77,0,EUR,COMPLETED,6795.95
TRANSFER,Savings,2024-11-28 11:16:07,2024-11-28 11:16:07,To EUR Savings,0.01,0,EUR,COMPLETED,6795.96
TRANSFER,Savings,2024-11-28 12:50:07,2024-11-28 12:50:07,To EUR Savings,0.23,0,EUR,COMPLETED,6796.19
TRANSFER,Savings,2024-11-29 05:52:07,2024-11-29 05:52:07,To EUR Savings,0.51,0,EUR,COMPLETED,6796.7
TRANSFER,Savings,2024-11-30 02:57:45,2024-11-30 02:57:45,To EUR Savings,0.05,0,EUR,COMPLETED,6796.75
TRANSFER,Savings,2024-11-30 08:01:07,2024-11-30 08:01:07,To EUR Savings,0.5,0,EUR,COMPLETED,6797.25
TRANSFER,Savings,2024-11-30 12:40:00,2024-11-30 12:40:00,To EUR Savings,0.33,0,EUR,COMPLETED,6797.58
TRANSFER,Savings,2024-12-01 01:11:14,2024-12-01 01:11:14,To EUR Rainy day,50,0,EUR,COMPLETED,6847.58
TRANSFER,Savings,2024-12-01 08:20:28,2024-12-01 08:20:28,To EUR Savings,0.5,0,EUR,COMPLETED,6848.08
TRANSFER,Savings,2024-12-01 08:59:43,2024-12-01 08:59:43,To EUR Savings,0.8,0,EUR,COMPLETED,6848.88
TRANSFER,Savings,2024-12-01 12:44:20,2024-12-01 12:44:20,To EUR Savings,0.73,0,EUR,COMPLETED,6849.61
TRANSFER,Savings,2024-12-02 01:57:57,2024-12-02 01:57:57,To EUR Savings,20,0,EUR,COMPLETED,6869.61
TRANSFER,Savings,2024-12-04 16:54:16,2024-12-04 16:54:16,To EUR Savings,0.6,0,EUR,COMPLETED,6870.21
TRANSFER,Savings,2024-12-05 13:06:04,2024-12-05 13:06:04,To EUR Savings,0.23,0,EUR,COMPLETED,6870.44
TRANSFER,Savings,2024-12-06 12:50:56,2024-12-06 12:50:56,To EUR Savings,0.69,0,EUR,COMPLETED,6871.13
TRANSFER,Savings,2024-12-06 22:34:14,2024-12-06 22:34:14,To EUR Savings,0.01,0,EUR,COMPLETED,6871.14
TRANSFER,Savings,2024-12-07 08:34:44,2024-12-07 08:34:44,To EUR Savings,0.5,0,EUR,COMPLETED,6871.64
TRANSFER,Savings,2024-12-07 09:31:32,2024-12-07 09:31:32,To EUR Savings,0.45,0,EUR,COMPLETED,6872.09
TRANSFER,Savings,2024-12-07 11:19:26,2024-12-07 11:19:26,To EUR Savings,0.16,0,EUR,COMPLETED,6872.25
TRANSFER,Savings,2024-12-08 08:46:48,2024-12-08 08:46:48,To EUR Savings,0.5,0,EUR,COMPLETED,6872.75
TRANSFER,Savings,2024-12-08 11:19:09,2024-12-08 11:19:09,To EUR Savings,1,0,EUR,COMPLETED,6873.75
TRANSFER,Savings,2024-12-09 01:37:31,2024-12-09 01:37:31,To EUR Savings,20,0,EUR,COMPLETED,6893.75
TRANSFER,Savings,2024-12-10 08:58:26,2024-12-10 08:58:26,To EUR Savings,0.79,0,EUR,COMPLETED,6894.54
TRANSFER,Savings,2024-12-11 19:59:00,2024-12-11 19:59:00,To EUR Savings,0.78,0,EUR,COMPLETED,6895.32
TRANSFER,Savings,2024-12-11 22:57:54,2024-12-11 22:57:54,To EUR Savings,0.01,0,EUR,COMPLETED,6895.33
TRANSFER,Savings,2024-12-12 13:00:46,2024-12-12 13:00:46,To EUR Savings,0.23,0,EUR,COMPLETED,6895.56
TRANSFER,Savings,2024-12-12 14:29:01,2024-12-12 14:29:01,To EUR Savings,0.06,0,EUR,COMPLETED,6895.62
TRANSFER,Savings,2024-12-13 22:11:00,2024-12-13 22:11:00,To EUR Savings,1,0,EUR,COMPLETED,6896.62
TRANSFER,Savings,2024-12-14 08:24:53,2024-12-14 08:24:53,To EUR Savings,0.5,0,EUR,COMPLETED,6897.12
TRANSFER,Savings,2024-12-14 09:38:28,2024-12-14 09:38:28,To EUR Savings,0.05,0,EUR,COMPLETED,6897.17
TRANSFER,Savings,2024-12-14 11:01:19,2024-12-14 11:01:19,To EUR Savings,0.4,0,EUR,COMPLETED,6897.57
TRANSFER,Savings,2024-12-14 15:49:40,2024-12-14 15:49:40,To EUR Savings,1,0,EUR,COMPLETED,6898.57
TRANSFER,Savings,2024-12-15 08:37:23,2024-12-15 08:37:23,To EUR Savings,0.5,0,EUR,COMPLETED,6899.07
TRANSFER,Savings,2024-12-15 12:22:50,2024-12-15 12:22:50,To EUR Savings,0.01,0,EUR,COMPLETED,6899.08
TRANSFER,Savings,2024-12-15 16:23:35,2024-12-15 16:23:35,To EUR Savings,1,0,EUR,COMPLETED,6900.08
TRANSFER,Savings,2024-12-16 01:43:11,2024-12-16 01:43:11,To EUR Savings,20,0,EUR,COMPLETED,6920.08
TRANSFER,Savings,2024-12-16 08:28:38,2024-12-16 08:28:38,To EUR Savings,0.5,0,EUR,COMPLETED,6920.58
TRANSFER,Savings,2024-12-16 11:32:07,2024-12-16 11:32:07,To EUR Savings,1,0,EUR,COMPLETED,6921.58
TRANSFER,Savings,2024-12-16 12:02:22,2024-12-16 12:02:22,To EUR Savings,0.15,0,EUR,COMPLETED,6921.73
TRANSFER,Savings,2024-12-16 12:06:26,2024-12-16 12:06:26,To EUR Savings,0.9,0,EUR,COMPLETED,6922.63
TRANSFER,Savings,2024-12-16 15:43:49,2024-12-16 15:43:49,To EUR Savings,0.01,0,EUR,COMPLETED,6922.64
TRANSFER,Savings,2024-12-16 17:57:45,2024-12-16 17:57:45,To EUR Savings,0.72,0,EUR,COMPLETED,6923.36
TRANSFER,Savings,2024-12-16 21:55:31,2024-12-16 21:55:31,To EUR Savings,0.28,0,EUR,COMPLETED,6923.64
TRANSFER,Savings,2024-12-16 23:58:57,2024-12-16 23:58:57,To EUR Savings,1,0,EUR,COMPLETED,6924.64
TRANSFER,Savings,2024-12-17 09:37:29,2024-12-17 09:37:29,To EUR Savings,1,0,EUR,COMPLETED,6925.64
TRANSFER,Savings,2024-12-17 15:28:14,2024-12-17 15:28:14,To EUR Savings,1,0,EUR,COMPLETED,6926.64
TRANSFER,Savings,2024-12-17 22:32:53,2024-12-17 22:32:53,To EUR Savings,0.5,0,EUR,COMPLETED,6927.14
TRANSFER,Savings,2024-12-18 07:49:46,2024-12-18 07:49:46,To EUR Savings,0.68,0,EUR,COMPLETED,6927.82
TRANSFER,Savings,2024-12-18 09:06:19,2024-12-18 09:06:19,To EUR Savings,0.09,0,EUR,COMPLETED,6927.91
TRANSFER,Savings,2024-12-18 10:16:16,2024-12-18 10:16:16,To EUR Savings,0.42,0,EUR,COMPLETED,6928.33
TRANSFER,Savings,2024-12-18 11:18:37,2024-12-18 11:18:37,To EUR Savings,0.1,0,EUR,COMPLETED,6928.43
TRANSFER,Savings,2024-12-18 22:56:47,2024-12-18 22:56:47,To EUR Savings,1,0,EUR,COMPLETED,6929.43
TRANSFER,Savings,2024-12-19 11:46:01,2024-12-19 11:46:01,To EUR Savings,0.24,0,EUR,COMPLETED,6929.67
TRANSFER,Savings,2024-12-19 12:51:27,2024-12-19 12:51:27,To EUR Savings,0.23,0,EUR,COMPLETED,6929.9
TRANSFER,Savings,2024-12-19 14:19:42,2024-12-19 14:19:42,To EUR Savings,0.54,0,EUR,COMPLETED,6930.44
TRANSFER,Savings,2024-12-20 12:10:04,2024-12-20 12:10:04,To EUR Savings,0.01,0,EUR,COMPLETED,6930.45
TRANSFER,Savings,2024-12-20 16:26:49,2024-12-20 16:26:49,To EUR Savings,0.01,0,EUR,COMPLETED,6930.46
TRANSFER,Savings,2024-12-20 16:53:10,2024-12-20 16:53:10,To EUR Savings,0.53,0,EUR,COMPLETED,6930.99
TRANSFER,Savings,2024-12-20 17:26:41,2024-12-20 17:26:41,To EUR Savings,0.1,0,EUR,COMPLETED,6931.09
TRANSFER,Savings,2024-12-21 08:15:13,2024-12-21 08:15:13,To EUR Savings,0.5,0,EUR,COMPLETED,6931.59
TRANSFER,Savings,2024-12-21 09:13:27,2024-12-21 09:13:27,To EUR Savings,0.52,0,EUR,COMPLETED,6932.11
TRANSFER,Savings,2024-12-21 09:50:14,2024-12-21 09:50:14,To EUR Savings,0.03,0,EUR,COMPLETED,6932.14
TRANSFER,Savings,2024-12-22 08:19:38,2024-12-22 08:19:38,To EUR Savings,0.5,0,EUR,COMPLETED,6932.64
TRANSFER,Savings,2024-12-22 08:39:17,2024-12-22 08:39:17,To EUR Savings,0.27,0,EUR,COMPLETED,6932.91
TRANSFER,Savings,2024-12-22 09:29:16,2024-12-22 09:29:16,To EUR Savings,1,0,EUR,COMPLETED,6933.91
TRANSFER,Savings,2024-12-22 12:25:58,2024-12-22 12:25:58,To EUR Savings,0.14,0,EUR,COMPLETED,6934.05
TRANSFER,Savings,2024-12-23 01:37:53,2024-12-23 01:37:53,To EUR Savings,20,0,EUR,COMPLETED,6954.05
TRANSFER,Savings,2024-12-23 08:03:33,2024-12-23 08:03:33,To EUR Savings,0.5,0,EUR,COMPLETED,6954.55
TRANSFER,Savings,2024-12-23 08:12:26,2024-12-23 08:12:26,To EUR Savings,0.01,0,EUR,COMPLETED,6954.56
TRANSFER,Savings,2024-12-23 15:51:34,2024-12-23 15:51:34,To EUR Savings,0.2,0,EUR,COMPLETED,6954.76
TRANSFER,Savings,2024-12-24 08:14:39,2024-12-24 08:14:39,To EUR Savings,0.5,0,EUR,COMPLETED,6955.26
TRANSFER,Savings,2024-12-24 09:18:21,2024-12-24 09:18:21,To EUR Savings,0.09,0,EUR,COMPLETED,6955.35
TRANSFER,Savings,2024-12-24 14:06:59,2024-12-24 14:06:59,To EUR Savings,0.87,0,EUR,COMPLETED,6956.22
TRANSFER,Savings,2024-12-24 14:21:15,2024-12-24 14:21:15,To EUR Savings,1,0,EUR,COMPLETED,6957.22
TRANSFER,Savings,2024-12-25 10:09:56,2024-12-25 10:09:56,To EUR Savings,1,0,EUR,COMPLETED,6958.22
TRANSFER,Savings,2024-12-26 08:28:06,2024-12-26 08:28:06,To EUR Savings,0.5,0,EUR,COMPLETED,6958.72
TRANSFER,Savings,2024-12-26 12:43:55,2024-12-26 12:43:55,To EUR Savings,0.23,0,EUR,COMPLETED,6958.95
TRANSFER,Savings,2024-12-27 08:37:49,2024-12-27 08:37:49,To EUR Savings,0.5,0,EUR,COMPLETED,6959.45
TRANSFER,Savings,2024-12-27 09:35:19,2024-12-27 09:35:19,To EUR Savings,1,0,EUR,COMPLETED,6960.45
TRANSFER,Savings,2024-12-27 09:55:46,2024-12-27 09:55:46,To EUR Savings,0.71,0,EUR,COMPLETED,6961.16
TRANSFER,Savings,2024-12-27 10:11:02,2024-12-27 10:11:02,To EUR Savings,1,0,EUR,COMPLETED,6962.16
TRANSFER,Savings,2024-12-27 15:01:01,2024-12-27 15:01:01,To EUR Savings,1,0,EUR,COMPLETED,6963.16
TRANSFER,Savings,2024-12-27 23:48:54,2024-12-27 23:48:54,To EUR Savings,1,0,EUR,COMPLETED,6964.16
TRANSFER,Savings,2024-12-28 08:34:29,2024-12-28 08:34:29,To EUR Savings,0.5,0,EUR,COMPLETED,6964.66
TRANSFER,Savings,2024-12-28 10:25:52,2024-12-28 10:25:52,To EUR Savings,0.62,0,EUR,COMPLETED,6965.28
TRANSFER,Savings,2024-12-28 10:29:38,2024-12-28 10:29:38,To EUR Savings,0.72,0,EUR,COMPLETED,6966
TRANSFER,Savings,2024-12-28 11:16:25,2024-12-28 11:16:25,To EUR Savings,0.01,0,EUR,COMPLETED,6966.01
TRANSFER,Savings,2024-12-28 12:04:15,2024-12-28 12:04:15,To EUR,-1000,0,EUR,COMPLETED,5966.01
TRANSFER,Savings,2024-12-29 05:52:01,2024-12-29 05:52:01,To EUR Savings,0.51,0,EUR,COMPLETED,5966.52
TRANSFER,Savings,2024-12-29 08:29:48,2024-12-29 08:29:48,To EUR Savings,0.28,0,EUR,COMPLETED,5966.8
TRANSFER,Savings,2024-12-30 01:41:29,2024-12-30 01:41:29,To EUR Savings,20,0,EUR,COMPLETED,5986.8
TRANSFER,Savings,2024-12-30 02:53:43,2024-12-30 02:53:43,To EUR Savings,0.05,0,EUR,COMPLETED,5986.85
TRANSFER,Savings,2024-12-30 08:31:45,2024-12-30 08:31:45,To EUR Savings,0.5,0,EUR,COMPLETED,5987.35
TRANSFER,Savings,2024-12-30 09:28:12,2024-12-30 09:28:12,To EUR Savings,0.84,0,EUR,COMPLETED,5988.19
TRANSFER,Savings,2024-12-30 12:46:17,2024-12-30 12:46:17,To EUR Savings,0.29,0,EUR,COMPLETED,5988.48
TRANSFER,Savings,2024-12-30 20:20:23,2024-12-30 20:20:23,To EUR Savings,0.47,0,EUR,COMPLETED,5988.95
TRANSFER,Savings,2024-12-31 08:30:59,2024-12-31 08:30:59,To EUR Savings,0.5,0,EUR,COMPLETED,5989.45
TRANSFER,Savings,2024-12-31 09:23:14,2024-12-31 09:23:14,To EUR Savings,0.4,0,EUR,COMPLETED,5989.85
TRANSFER,Savings,2024-12-31 15:13:40,2024-12-31 15:13:40,To EUR Savings,1,0,EUR,COMPLETED,5990.85
TRANSFER,Savings,2025-01-01 01:19:41,2025-01-01 01:19:41,To EUR Rainy day,50,0,EUR,COMPLETED,6040.85
TRANSFER,Savings,2025-01-01 13:19:02,2025-01-01 13:19:02,To EUR Savings,1,0,EUR,COMPLETED,6041.85
TRANSFER,Savings,2025-01-03 12:52:02,2025-01-03 12:52:02,To EUR Savings,0.23,0,EUR,COMPLETED,6042.08
TRANSFER,Savings,2025-01-04 08:27:45,2025-01-04 08:27:45,To EUR Savings,0.5,0,EUR,COMPLETED,6042.58
TRANSFER,Savings,2025-01-04 09:13:55,2025-01-04 09:13:55,To EUR Savings,0.35,0,EUR,COMPLETED,6042.93
TRANSFER,Savings,2025-01-04 09:27:29,2025-01-04 09:27:29,To EUR Savings,0.41,0,EUR,COMPLETED,6043.34
TRANSFER,Savings,2025-01-06 01:38:32,2025-01-06 01:38:32,To EUR Savings,20,0,EUR,COMPLETED,6063.34
TRANSFER,Savings,2025-01-06 17:09:35,2025-01-06 17:09:35,To EUR Savings,0.51,0,EUR,COMPLETED,6063.85
TRANSFER,Savings,2025-01-07 08:33:52,2025-01-07 08:33:52,To EUR Savings,0.01,0,EUR,COMPLETED,6063.86
TRANSFER,Savings,2025-01-07 12:32:35,2025-01-07 12:32:35,To EUR Savings,0.01,0,EUR,COMPLETED,6063.87
TRANSFER,Savings,2025-01-07 21:30:55,2025-01-07 21:30:55,To EUR Savings,0.52,0,EUR,COMPLETED,6064.39
TRANSFER,Savings,2025-01-07 23:27:17,2025-01-07 23:27:17,To EUR Savings,0.68,0,EUR,COMPLETED,6065.07
TRANSFER,Savings,2025-01-08 12:06:46,2025-01-08 12:06:46,To EUR Savings,0.71,0,EUR,COMPLETED,6065.78
TRANSFER,Savings,2025-01-08 12:49:43,2025-01-08 12:49:43,To EUR Savings,0.67,0,EUR,COMPLETED,6066.45
TRANSFER,Savings,2025-01-09 12:40:16,2025-01-09 12:40:16,To EUR Savings,0.19,0,EUR,COMPLETED,6066.64
TRANSFER,Savings,2025-01-09 12:50:44,2025-01-09 12:50:44,To EUR Savings,0.23,0,EUR,COMPLETED,6066.87
TRANSFER,Savings,2025-01-10 00:41:47,2025-01-10 00:41:47,To EUR Savings,0.01,0,EUR,COMPLETED,6066.88
TRANSFER,Savings,2025-01-10 08:37:26,2025-01-10 08:37:26,To EUR,-400,0,EUR,COMPLETED,5666.88
TRANSFER,Savings,2025-01-11 07:49:44,2025-01-11 07:49:44,To EUR Savings,0.5,0,EUR,COMPLETED,5667.38
TRANSFER,Savings,2025-01-11 08:19:53,2025-01-11 08:19:53,To EUR Savings,0.66,0,EUR,COMPLETED,5668.04
TRANSFER,Savings,2025-01-11 11:04:15,2025-01-11 11:04:15,To EUR Savings,0.75,0,EUR,COMPLETED,5668.79
TRANSFER,Savings,2025-01-12 09:54:26,2025-01-12 09:54:26,To EUR Savings,0.6,0,EUR,COMPLETED,5669.39
TRANSFER,Savings,2025-01-12 10:38:46,2025-01-12 10:38:46,To EUR Savings,0.21,0,EUR,COMPLETED,5669.6
TRANSFER,Savings,2025-01-12 11:16:52,2025-01-12 11:16:52,To EUR Savings,1,0,EUR,COMPLETED,5670.6
TRANSFER,Savings,2025-01-12 17:58:37,2025-01-12 17:58:37,To EUR Savings,0.15,0,EUR,COMPLETED,5670.75
TRANSFER,Savings,2025-01-13 01:39:29,2025-01-13 01:39:29,To EUR Savings,20,0,EUR,COMPLETED,5690.75
TRANSFER,Savings,2025-01-13 09:15:14,2025-01-13 09:15:14,To EUR Savings,0.22,0,EUR,COMPLETED,5690.97
TRANSFER,Savings,2025-01-14 11:49:34,2025-01-14 11:49:34,To EUR Savings,0.81,0,EUR,COMPLETED,5691.78
TRANSFER,Savings,2025-01-16 12:20:13,2025-01-16 12:20:13,To EUR Savings,0.23,0,EUR,COMPLETED,5692.01
TRANSFER,Savings,2025-01-17 12:34:07,2025-01-17 12:34:07,To EUR Savings,0.69,0,EUR,COMPLETED,5692.7
TRANSFER,Savings,2025-01-18 08:29:03,2025-01-18 08:29:03,To EUR Savings,0.75,0,EUR,COMPLETED,5693.45
TRANSFER,Savings,2025-01-18 09:17:31,2025-01-18 09:17:31,To EUR Savings,0.97,0,EUR,COMPLETED,5694.42
TRANSFER,Savings,2025-01-18 09:52:52,2025-01-18 09:52:52,To EUR Rainy day,1400,0,EUR,COMPLETED,7094.42
TRANSFER,Savings,2025-01-18 09:58:24,2025-01-18 09:58:24,To EUR Savings,0.09,0,EUR,COMPLETED,7094.51
TRANSFER,Savings,2025-01-18 10:16:39,2025-01-18 10:16:39,To EUR Savings,0.23,0,EUR,COMPLETED,7094.74
TRANSFER,Savings,2025-01-18 15:37:12,2025-01-18 15:37:12,To EUR Savings,0.48,0,EUR,COMPLETED,7095.22
TRANSFER,Savings,2025-01-19 08:42:08,2025-01-19 08:42:08,To EUR Savings,0.5,0,EUR,COMPLETED,7095.72
TRANSFER,Savings,2025-01-19 11:46:28,2025-01-19 11:46:28,To EUR Savings,0.97,0,EUR,COMPLETED,7096.69
TRANSFER,Savings,2025-01-19 12:17:35,2025-01-19 12:17:35,To EUR Savings,0.14,0,EUR,COMPLETED,7096.83
TRANSFER,Savings,2025-01-20 01:45:24,2025-01-20 01:45:24,To EUR Savings,20,0,EUR,COMPLETED,7116.83
TRANSFER,Savings,2025-01-20 12:10:03,2025-01-20 12:10:03,To EUR Savings,0.01,0,EUR,COMPLETED,7116.84
TRANSFER,Savings,2025-01-23 08:12:26,2025-01-23 08:12:26,To EUR Savings,0.01,0,EUR,COMPLETED,7116.85
TRANSFER,Savings,2025-01-23 13:04:05,2025-01-23 13:04:05,To EUR Savings,0.99,0,EUR,COMPLETED,7117.84
TRANSFER,Savings,2025-01-25 08:14:06,2025-01-25 08:14:06,To EUR Savings,0.5,0,EUR,COMPLETED,7118.34
TRANSFER,Savings,2025-01-25 08:56:43,2025-01-25 08:56:43,To EUR Savings,0.55,0,EUR,COMPLETED,7118.89
TRANSFER,Savings,2025-01-25 12:37:46,2025-01-25 12:37:46,To EUR Savings,0.82,0,EUR,COMPLETED,7119.71
TRANSFER,Savings,2025-01-27 01:37:09,2025-01-27 01:37:09,To EUR Savings,20,0,EUR,COMPLETED,7139.71
TRANSFER,Savings,2025-01-28 11:16:10,2025-01-28 11:16:10,To EUR Savings,0.01,0,EUR,COMPLETED,7139.72
TRANSFER,Savings,2025-01-29 05:52:17,2025-01-29 05:52:17,To EUR Savings,0.51,0,EUR,COMPLETED,7140.23
TRANSFER,Savings,2025-01-29 22:24:25,2025-01-29 22:24:25,To EUR Savings,0.23,0,EUR,COMPLETED,7140.46
TRANSFER,Savings,2025-01-30 02:53:46,2025-01-30 02:53:46,To EUR Savings,0.05,0,EUR,COMPLETED,7140.51
TRANSFER,Savings,2025-01-30 12:47:11,2025-01-30 12:47:11,To EUR Savings,0.23,0,EUR,COMPLETED,7140.74
TRANSFER,Savings,2025-02-01 01:11:49,2025-02-01 01:11:49,To EUR Rainy day,50,0,EUR,COMPLETED,7190.74
TRANSFER,Savings,2025-02-01 08:34:42,2025-02-01 08:34:42,To EUR Savings,0.5,0,EUR,COMPLETED,7191.24
TRANSFER,Savings,2025-02-01 09:26:06,2025-02-01 09:26:06,To EUR Savings,0.03,0,EUR,COMPLETED,7191.27
TRANSFER,Savings,2025-02-02 08:35:26,2025-02-02 08:35:26,To EUR Savings,0.5,0,EUR,COMPLETED,7191.77
TRANSFER,Savings,2025-02-02 08:59:15,2025-02-02 08:59:15,To EUR Savings,1,0,EUR,COMPLETED,7192.77
TRANSFER,Savings,2025-02-03 01:42:28,2025-02-03 01:42:28,To EUR Savings,20,0,EUR,COMPLETED,7212.77
TRANSFER,Savings,2025-02-07 00:05:56,2025-02-07 00:05:56,To EUR Savings,0.32,0,EUR,COMPLETED,7213.09
TRANSFER,Savings,2025-02-07 12:04:56,2025-02-07 12:04:56,To EUR Savings,0.23,0,EUR,COMPLETED,7213.32
TRANSFER,Savings,2025-02-08 08:25:20,2025-02-08 08:25:20,To EUR Savings,0.5,0,EUR,COMPLETED,7213.82
TRANSFER,Savings,2025-02-08 09:09:23,2025-02-08 09:09:23,To EUR Savings,1,0,EUR,COMPLETED,7214.82
TRANSFER,Savings,2025-02-08 09:40:32,2025-02-08 09:40:32,To EUR Savings,0.42,0,EUR,COMPLETED,7215.24
TRANSFER,Savings,2025-02-08 09:51:59,2025-02-08 09:51:59,To EUR Savings,0.84,0,EUR,COMPLETED,7216.08
TRANSFER,Savings,2025-02-08 10:11:11,2025-02-08 10:11:11,To EUR Savings,0.49,0,EUR,COMPLETED,7216.57
TRANSFER,Savings,2025-02-08 12:27:32,2025-02-08 12:27:32,To EUR Savings,0.29,0,EUR,COMPLETED,7216.86
TRANSFER,Savings,2025-02-09 08:16:50,2025-02-09 08:16:50,To EUR Savings,0.5,0,EUR,COMPLETED,7217.36
TRANSFER,Savings,2025-02-10 01:42:09,2025-02-10 01:42:09,To EUR Savings,20,0,EUR,COMPLETED,7237.36
TRANSFER,Savings,2025-02-11 15:16:31,2025-02-11 15:16:31,To EUR Savings,0.21,0,EUR,COMPLETED,7237.57
TRANSFER,Savings,2025-02-13 12:59:15,2025-02-13 12:59:15,To EUR Savings,0.23,0,EUR,COMPLETED,7237.8
TRANSFER,Savings,2025-02-14 17:06:05,2025-02-14 17:06:05,To EUR Savings,0.02,0,EUR,COMPLETED,7237.82
TRANSFER,Savings,2025-02-14 23:39:54,2025-02-14 23:39:54,To EUR Savings,0.53,0,EUR,COMPLETED,7238.35
TRANSFER,Savings,2025-02-15 07:54:48,2025-02-15 07:54:48,To EUR Savings,0.5,0,EUR,COMPLETED,7238.85
TRANSFER,Savings,2025-02-15 08:29:53,2025-02-15 08:29:53,To EUR Savings,0.42,0,EUR,COMPLETED,7239.27
TRANSFER,Savings,2025-02-16 08:43:36,2025-02-16 08:43:36,To EUR Savings,0.5,0,EUR,COMPLETED,7239.77
TRANSFER,Savings,2025-02-16 13:18:20,2025-02-16 13:18:20,To EUR Savings,0.56,0,EUR,COMPLETED,7240.33
TRANSFER,Savings,2025-02-16 13:47:03,2025-02-16 13:47:03,To EUR Savings,0.1,0,EUR,COMPLETED,7240.43
TRANSFER,Savings,2025-02-17 01:39:31,2025-02-17 01:39:31,To EUR Savings,20,0,EUR,COMPLETED,7260.43
TRANSFER,Savings,2025-02-18 16:34:19,2025-02-18 16:34:19,To EUR Savings,0.94,0,EUR,COMPLETED,7261.37
TRANSFER,Savings,2025-02-18 18:52:44,2025-02-18 18:52:44,To EUR Savings,0.01,0,EUR,COMPLETED,7261.38
TRANSFER,Savings,2025-02-19 11:46:09,2025-02-19 11:46:09,To EUR Savings,0.28,0,EUR,COMPLETED,7261.66
TRANSFER,Savings,2025-02-20 12:10:02,2025-02-20 12:10:02,To EUR Savings,0.01,0,EUR,COMPLETED,7261.67
TRANSFER,Savings,2025-02-20 12:54:14,2025-02-20 12:54:14,To EUR Savings,0.69,0,EUR,COMPLETED,7262.36
TRANSFER,Savings,2025-02-22 08:34:35,2025-02-22 08:34:35,To EUR Savings,0.5,0,EUR,COMPLETED,7262.86
TRANSFER,Savings,2025-02-22 09:31:43,2025-02-22 09:31:43,To EUR Savings,0.73,0,EUR,COMPLETED,7263.59
TRANSFER,Savings,2025-02-22 10:09:31,2025-02-22 10:09:31,To EUR Savings,0.49,0,EUR,COMPLETED,7264.08
TRANSFER,Savings,2025-02-23 08:12:26,2025-02-23 08:12:26,To EUR Savings,0.01,0,EUR,COMPLETED,7264.09
TRANSFER,Savings,2025-02-23 08:33:48,2025-02-23 08:33:48,To EUR Savings,0.5,0,EUR,COMPLETED,7264.59
TRANSFER,Savings,2025-02-23 15:34:56,2025-02-23 15:34:56,To EUR Savings,0.4,0,EUR,COMPLETED,7264.99
TRANSFER,Savings,2025-02-23 16:49:41,2025-02-23 16:49:41,To EUR Savings,0.9,0,EUR,COMPLETED,7265.89
TRANSFER,Savings,2025-02-24 01:34:18,2025-02-24 01:34:18,To EUR Savings,20,0,EUR,COMPLETED,7285.89
TRANSFER,Savings,2025-02-25 19:45:40,2025-02-25 19:45:40,To EUR Savings,0.08,0,EUR,COMPLETED,7285.97
TRANSFER,Savings,2025-02-25 19:46:18,2025-02-25 19:46:18,To EUR Savings,0.78,0,EUR,COMPLETED,7286.75
TRANSFER,Savings,2025-02-26 18:27:18,2025-02-26 18:27:18,To EUR Savings,0.53,0,EUR,COMPLETED,7287.28
TRANSFER,Savings,2025-02-28 02:53:46,2025-02-28 02:53:46,To EUR Savings,0.05,0,EUR,COMPLETED,7287.33
TRANSFER,Savings,2025-02-28 05:54:20,2025-02-28 05:54:20,To EUR Savings,0.51,0,EUR,COMPLETED,7287.84
TRANSFER,Savings,2025-02-28 11:16:10,2025-02-28 11:16:10,To EUR Savings,0.01,0,EUR,COMPLETED,7287.85
TRANSFER,Savings,2025-02-28 12:17:00,2025-02-28 12:17:00,To EUR Savings,0.23,0,EUR,COMPLETED,7288.08
TRANSFER,Savings,2025-02-28 18:07:02,2025-02-28 18:07:02,To EUR Savings,0.17,0,EUR,COMPLETED,7288.25
TRANSFER,Savings,2025-02-28 22:40:57,2025-02-28 22:40:57,To EUR Savings,0.7,0,EUR,COMPLETED,7288.95
TRANSFER,Savings,2025-03-01 01:11:45,2025-03-01 01:11:45,To EUR Rainy day,50,0,EUR,COMPLETED,7338.95
TRANSFER,Savings,2025-03-01 08:25:39,2025-03-01 08:25:39,To EUR Savings,0.5,0,EUR,COMPLETED,7339.45
TRANSFER,Savings,2025-03-01 09:07:07,2025-03-01 09:07:07,To EUR Savings,0.04,0,EUR,COMPLETED,7339.49
TRANSFER,Savings,2025-03-01 12:57:15,2025-03-01 12:57:15,To EUR Savings,0.71,0,EUR,COMPLETED,7340.2
TRANSFER,Savings,2025-03-02 07:48:49,2025-03-02 07:48:49,To EUR Savings,0.5,0,EUR,COMPLETED,7340.7
TRANSFER,Savings,2025-03-02 21:33:05,2025-03-02 21:33:05,To EUR Savings,0.5,0,EUR,COMPLETED,7341.2
TRANSFER,Savings,2025-03-03 01:41:58,2025-03-03 01:41:58,To EUR Savings,20,0,EUR,COMPLETED,7361.2
TRANSFER,Savings,2025-03-04 12:40:20,2025-03-04 12:40:20,To EUR Savings,0.69,0,EUR,COMPLETED,7361.89
TRANSFER,Savings,2025-03-06 12:14:12,2025-03-06 12:14:12,To EUR Savings,0.23,0,EUR,COMPLETED,7362.12
TRANSFER,Savings,2025-03-06 15:19:41,2025-03-06 15:19:41,To EUR Savings,0.29,0,EUR,COMPLETED,7362.41
TRANSFER,Savings,2025-03-06 18:06:21,2025-03-06 18:06:21,To EUR Savings,0.69,0,EUR,COMPLETED,7363.1
TRANSFER,Savings,2025-03-08 23:44:40,2025-03-08 23:44:40,To EUR Savings,0.01,0,EUR,COMPLETED,7363.11
TRANSFER,Savings,2025-03-09 08:49:01,2025-03-09 08:49:01,To EUR Savings,0.5,0,EUR,COMPLETED,7363.61
TRANSFER,Savings,2025-03-09 09:33:08,2025-03-09 09:33:08,To EUR Savings,0.01,0,EUR,COMPLETED,7363.62
TRANSFER,Savings,2025-03-09 14:18:10,2025-03-09 14:18:10,To EUR Savings,0.7,0,EUR,COMPLETED,7364.32
TRANSFER,Savings,2025-03-09 20:47:20,2025-03-09 20:47:20,To EUR Savings,0.5,0,EUR,COMPLETED,7364.82
TRANSFER,Savings,2025-03-10 01:36:34,2025-03-10 01:36:34,To EUR Savings,20,0,EUR,COMPLETED,7384.82
TRANSFER,Savings,2025-03-10 09:47:11,2025-03-10 09:47:11,To EUR Savings,0.25,0,EUR,COMPLETED,7385.07
TRANSFER,Savings,2025-03-10 13:12:59,2025-03-10 13:12:59,To EUR Savings,1,0,EUR,COMPLETED,7386.07
TRANSFER,Savings,2025-03-11 03:10:34,2025-03-11 03:10:34,To EUR Savings,1,0,EUR,COMPLETED,7387.07
TRANSFER,Savings,2025-03-13 12:07:58,2025-03-13 12:07:58,To EUR Savings,0.23,0,EUR,COMPLETED,7387.3
TRANSFER,Savings,2025-03-13 20:24:30,2025-03-13 20:24:30,To EUR Savings,0.01,0,EUR,COMPLETED,7387.31
TRANSFER,Savings,2025-03-14 19:34:49,2025-03-14 19:34:49,To EUR Savings,0.99,0,EUR,COMPLETED,7388.3
TRANSFER,Savings,2025-03-14 20:51:30,2025-03-14 20:51:30,To EUR Savings,0.03,0,EUR,COMPLETED,7388.33
TRANSFER,Savings,2025-03-15 07:57:17,2025-03-15 07:57:17,To EUR Savings,0.5,0,EUR,COMPLETED,7388.83
TRANSFER,Savings,2025-03-15 09:11:51,2025-03-15 09:11:51,To EUR Savings,0.43,0,EUR,COMPLETED,7389.26
TRANSFER,Savings,2025-03-15 09:26:59,2025-03-15 09:26:59,To EUR Savings,0.07,0,EUR,COMPLETED,7389.33
TRANSFER,Savings,2025-03-15 09:50:27,2025-03-15 09:50:27,To EUR Savings,0.37,0,EUR,COMPLETED,7389.7
TRANSFER,Savings,2025-03-15 10:29:52,2025-03-15 10:29:52,To EUR Savings,0.85,0,EUR,COMPLETED,7390.55
TRANSFER,Savings,2025-03-17 01:47:52,2025-03-17 01:47:52,To EUR Savings,20,0,EUR,COMPLETED,7410.55
TRANSFER,Savings,2025-03-19 11:45:49,2025-03-19 11:45:49,To EUR Savings,0.34,0,EUR,COMPLETED,7410.89
TRANSFER,Savings,2025-03-20 12:06:39,2025-03-20 12:06:39,To EUR Savings,0.23,0,EUR,COMPLETED,7411.12
TRANSFER,Savings,2025-03-20 12:10:03,2025-03-20 12:10:03,To EUR Savings,0.01,0,EUR,COMPLETED,7411.13
TRANSFER,Savings,2025-03-20 23:16:47,2025-03-20 23:16:47,To EUR Savings,0.01,0,EUR,COMPLETED,7411.14
TRANSFER,Savings,2025-03-21 09:13:28,2025-03-21 09:13:28,To EUR Savings,1,0,EUR,COMPLETED,7412.14
TRANSFER,Savings,2025-03-22 07:33:17,2025-03-22 07:33:17,To EUR Savings,0.5,0,EUR,COMPLETED,7412.64
TRANSFER,Savings,2025-03-22 08:53:32,2025-03-22 08:53:32,To EUR Savings,0.99,0,EUR,COMPLETED,7413.63
TRANSFER,Savings,2025-03-23 07:12:25,2025-03-23 07:12:25,To EUR Savings,0.01,0,EUR,COMPLETED,7413.64
TRANSFER,Savings,2025-03-23 08:38:01,2025-03-23 08:38:01,To EUR Savings,0.5,0,EUR,COMPLETED,7414.14
TRANSFER,Savings,2025-03-24 01:44:06,2025-03-24 01:44:06,To EUR Savings,20,0,EUR,COMPLETED,7434.14
TRANSFER,Savings,2025-03-26 08:26:33,2025-03-26 08:26:33,To EUR Savings,1,0,EUR,COMPLETED,7435.14
TRANSFER,Savings,2025-03-27 08:38:38,2025-03-27 08:38:38,To EUR Savings,1,0,EUR,COMPLETED,7436.14
TRANSFER,Savings,2025-03-27 12:05:03,2025-03-27 12:05:03,To EUR Savings,0.23,0,EUR,COMPLETED,7436.37
TRANSFER,Savings,2025-03-27 20:50:10,2025-03-27 20:50:10,To EUR Savings,0.01,0,EUR,COMPLETED,7436.38
TRANSFER,Savings,2025-03-28 08:09:31,2025-03-28 08:09:31,To EUR Rainy day,-500,0,EUR,COMPLETED,6936.38
TRANSFER,Savings,2025-03-28 08:09:31,2025-03-28 08:09:31,To EUR Rainy day,500,0,EUR,COMPLETED,7436.38
TRANSFER,Savings,2025-03-28 10:01:17,2025-03-28 10:01:17,To EUR Savings,1,0,EUR,COMPLETED,7437.38
TRANSFER,Savings,2025-03-28 12:49:55,2025-03-28 12:49:55,To EUR Savings,0.78,0,EUR,COMPLETED,7438.16
TRANSFER,Savings,2025-03-28 16:55:54,2025-03-28 16:55:54,To EUR Savings,1,0,EUR,COMPLETED,7439.16
TRANSFER,Savings,2025-03-28 18:20:02,2025-03-28 18:20:02,To EUR,-600,0,EUR,COMPLETED,6839.16
TRANSFER,Savings,2025-03-28 18:20:34,2025-03-28 18:20:34,To EUR Savings,0.32,0,EUR,COMPLETED,6839.48
TRANSFER,Savings,2025-03-28 19:07:46,2025-03-28 19:07:46,To EUR Savings,0.87,0,EUR,COMPLETED,6840.35
TRANSFER,Savings,2025-03-28 22:28:25,2025-03-28 22:28:25,To EUR Savings,0.95,0,EUR,COMPLETED,6841.3
TRANSFER,Savings,2025-03-29 04:52:00,2025-03-29 04:52:00,To EUR Savings,0.51,0,EUR,COMPLETED,6841.81
TRANSFER,Savings,2025-03-29 08:23:38,2025-03-29 08:23:38,To EUR Savings,0.5,0,EUR,COMPLETED,6842.31
TRANSFER,Savings,2025-03-29 09:30:28,2025-03-29 09:30:28,To EUR Savings,0.36,0,EUR,COMPLETED,6842.67
TRANSFER,Savings,2025-03-30 02:53:57,2025-03-30 02:53:57,To EUR Savings,0.05,0,EUR,COMPLETED,6842.72
TRANSFER,Savings,2025-03-30 08:26:42,2025-03-30 08:26:42,To EUR Savings,0.5,0,EUR,COMPLETED,6843.22
TRANSFER,Savings,2025-03-30 09:25:22,2025-03-30 09:25:22,To EUR Savings,0.28,0,EUR,COMPLETED,6843.5
TRANSFER,Savings,2025-03-31 02:52:56,2025-03-31 02:52:56,To EUR Savings,20,0,EUR,COMPLETED,6863.5
TRANSFER,Savings,2025-04-01 02:16:05,2025-04-01 02:16:05,To EUR Rainy day,50,0,EUR,COMPLETED,6913.5
TRANSFER,Savings,2025-04-02 12:15:41,2025-04-02 12:15:41,To EUR Savings,0.01,0,EUR,COMPLETED,6913.51
TRANSFER,Savings,2025-04-02 18:04:02,2025-04-02 18:04:02,To EUR Savings,1,0,EUR,COMPLETED,6914.51
TRANSFER,Savings,2025-04-03 12:01:21,2025-04-03 12:01:21,To EUR Savings,0.34,0,EUR,COMPLETED,6914.85