Type,Product,Started Date,Completed Date,Description,Amount,Fee,Currency,State,Balance
TRANSFER,Current,2025-04-01 02:16:05,2025-04-01 02:16:05,To EUR Rainy day,-50,0,EUR,COMPLETED,195.52
TRANSFER,Current,2025-04-02 12:15:41,2025-04-02 12:15:41,To EUR Savings,-0.01,0,EUR,COMPLETED,195.51
TRANSFER,Current,2025-04-02 18:04:02,2025-04-02 18:04:02,To EUR Savings,-1,0,EUR,COMPLETED,194.51
CARD_PAYMENT,Current,2025-04-02 18:03:36,2025-04-03 09:34:42,Hospital Luz Oeiras,-3,0,EUR,COMPLETED,191.51
TRANSFER,Current,2025-04-03 12:01:21,2025-04-03 12:01:21,To EUR Savings,-0.34,0,EUR,COMPLETED,191.17
TOPUP,Current,2025-04-03 12:01:55,2025-04-03 12:01:56,Apple Pay Top-Up by *0264,200,0,EUR,COMPLETED,391.17
CARD_PAYMENT,Current,2025-04-02 12:15:40,2025-04-04 08:58:08,PlayStation,-8.99,0,EUR,COMPLETED,382.18
TRANSFER,Current,2025-04-05 07:36:03,2025-04-05 07:36:03,To EUR Savings,-0.17,0,EUR,COMPLETED,382.01
TRANSFER,Current,2025-04-05 07:59:22,2025-04-05 07:59:22,To EUR Savings,-0.5,0,EUR,COMPLETED,381.51
CARD_PAYMENT,Current,2025-04-05 07:59:21,2025-04-06 06:46:17,A Padaria Portuguesa,-2.5,0,EUR,COMPLETED,379.01
TRANSFER,Current,2025-04-06 08:17:50,2025-04-06 08:17:50,To EUR Savings,-0.5,0,EUR,COMPLETED,378.51
CARD_PAYMENT,Current,2025-04-03 12:01:20,2025-04-06 08:48:54,Uber Eats,-31.66,0,EUR,COMPLETED,346.85
TRANSFER,Current,2025-04-06 09:41:05,2025-04-06 09:41:05,To EUR Savings,-0.1,0,EUR,COMPLETED,346.75
CARD_PAYMENT,Current,2025-04-05 07:36:02,2025-04-06 11:23:10,Hospital Luz Oeiras,-37.83,0,EUR,COMPLETED,308.92
TRANSFER,Current,2025-04-06 18:36:17,2025-04-06 18:36:17,To EUR Savings,-0.09,0,EUR,COMPLETED,308.83
TRANSFER,Current,2025-04-07 02:50:05,2025-04-07 02:50:05,To EUR Savings,-20,0,EUR,COMPLETED,288.83
CARD_PAYMENT,Current,2025-04-06 08:17:49,2025-04-07 06:39:49,A Padaria Portuguesa,-2.5,0,EUR,COMPLETED,286.33
CARD_PAYMENT,Current,2025-04-06 09:41:04,2025-04-07 11:33:41,Jean Louis David,-18.9,0,EUR,COMPLETED,267.43
CARD_PAYMENT,Current,2025-04-06 18:36:17,2025-04-07 19:04:24,Codeium,-16.91,0.17,EUR,COMPLETED,250.35
TRANSFER,Current,2025-04-08 17:56:12,2025-04-08 17:56:12,To EUR Savings,-0.23,0,EUR,COMPLETED,250.12
TRANSFER,Current,2025-04-09 12:42:10,2025-04-09 12:42:10,To EUR Savings,-1,0,EUR,COMPLETED,249.12
TRANSFER,Current,2025-04-10 09:01:21,2025-04-10 09:01:21,To EUR Savings,-0.4,0,EUR,COMPLETED,248.72
TRANSFER,Current,2025-04-10 12:07:08,2025-04-10 12:07:08,To EUR Savings,-0.34,0,EUR,COMPLETED,248.38
CARD_PAYMENT,Current,2025-04-08 17:56:12,2025-04-10 16:29:21,Aishang2jxc,-45.95,0,EUR,COMPLETED,202.43
CARD_PAYMENT,Current,2025-04-10 09:01:21,2025-04-10 16:53:31,Codeium,-11.6,0,EUR,COMPLETED,190.83
CARD_PAYMENT,Current,2025-04-09 12:42:10,2025-04-11 11:06:14,Uber Eats,-49,0,EUR,COMPLETED,141.83
TRANSFER,Current,2025-04-12 06:47:24,2025-04-12 06:47:24,To EUR Savings,-0.4,0,EUR,COMPLETED,141.43
TRANSFER,Current,2025-04-12 07:01:41,2025-04-12 07:01:41,To EUR Savings,-1,0,EUR,COMPLETED,140.43
CARD_PAYMENT,Current,2025-04-10 12:07:08,2025-04-12 10:36:42,Uber Eats,-31.66,0,EUR,COMPLETED,108.77
TRANSFER,Current,2025-04-12 12:57:58,2025-04-12 12:57:58,To EUR Savings,-0.1,0,EUR,COMPLETED,108.67
TRANSFER,Current,2025-04-12 21:50:29,2025-04-12 21:50:29,To EUR Savings,-0.8,0,EUR,COMPLETED,107.87
CARD_PAYMENT,Current,2025-04-12 12:57:57,2025-04-13 06:22:09,Alvaros,-14.9,0,EUR,COMPLETED,92.97
TRANSFER,Current,2025-04-13 08:21:47,2025-04-13 08:21:47,To EUR Savings,-0.3,0,EUR,COMPLETED,92.67
CARD_PAYMENT,Current,2025-04-12 07:01:41,2025-04-13 09:10:27,Miió,-20,0,EUR,COMPLETED,72.67
TRANSFER,Current,2025-04-13 13:18:13,2025-04-13 13:18:13,To EUR Savings,-0.1,0,EUR,COMPLETED,72.57
CARD_PAYMENT,Current,2025-04-12 06:47:23,2025-04-13 15:58:39,Brisa,-9.6,0,EUR,COMPLETED,62.97
TRANSFER,Current,2025-04-14 03:05:14,2025-04-14 03:05:14,To EUR Savings,-20,0,EUR,COMPLETED,42.97
CARD_PAYMENT,Current,2025-04-12 21:50:28,2025-04-14 05:41:38,Alvaros,-11.2,0,EUR,COMPLETED,31.77
CARD_PAYMENT,Current,2025-04-13 13:18:12,2025-04-14 05:41:38,Alvaros Cafe Unipess,-19.9,0,EUR,COMPLETED,11.87
CARD_PAYMENT,Current,2025-04-13 08:21:47,2025-04-14 05:51:31,Oleigois,-2.7,0,EUR,COMPLETED,9.17
TOPUP,Current,2025-04-14 13:52:54,2025-04-14 13:52:55,Apple Pay Top-Up by *0264,400,0,EUR,COMPLETED,409.17
TRANSFER,Current,2025-04-14 14:29:12,2025-04-14 14:29:12,To EUR Savings,-0.72,0,EUR,COMPLETED,408.45
TRANSFER,Current,2025-04-14 19:28:15,2025-04-14 19:28:15,To EUR Savings,-0.47,0,EUR,COMPLETED,407.98
TRANSFER,Current,2025-04-15 08:10:11,2025-04-15 08:10:11,To EUR Savings,-0.41,0,EUR,COMPLETED,407.57
CARD_PAYMENT,Current,2025-04-14 14:29:11,2025-04-15 16:51:14,Codeium,-11.28,0,EUR,COMPLETED,396.29
TRANSFER,Current,2025-04-15 22:16:43,2025-04-15 22:16:43,To EUR Savings,-1,0,EUR,COMPLETED,395.29
TRANSFER,Current,2025-04-16 11:01:27,2025-04-16 11:01:27,To EUR Savings,-1,0,EUR,COMPLETED,394.29
TOPUP,Current,2025-04-16 11:03:06,2025-04-16 11:03:08,Apple Pay Top-Up by *0264,200,0,EUR,COMPLETED,594.29
CARD_PAYMENT,Current,2025-04-15 08:10:11,2025-04-16 12:12:42,Leroy Merlin,-35.59,0,EUR,COMPLETED,558.7
CARD_PAYMENT,Current,2025-04-14 19:28:15,2025-04-16 12:24:16,Uber Eats,-46.53,0,EUR,COMPLETED,512.17
TRANSFER,Current,2025-04-17 13:00:03,2025-04-17 13:00:03,To EUR Savings,-0.34,0,EUR,COMPLETED,511.83
CARD_PAYMENT,Current,2025-04-15 22:16:43,2025-04-17 14:14:11,Rest Ilha Da Madeira,-62,0,EUR,COMPLETED,449.83
CARD_PAYMENT,Current,2025-04-16 11:01:26,2025-04-17 14:14:18,Hospital Da Luz Oeir,-30,0,EUR,COMPLETED,419.83
TRANSFER,Current,2025-04-18 08:17:41,2025-04-18 08:17:41,To EUR Savings,-0.5,0,EUR,COMPLETED,419.33
TOPUP,Current,2025-04-18 23:58:56,2025-04-18 23:58:57,Apple Pay Top-Up by *0264,500,0,EUR,COMPLETED,919.33
TRANSFER,Current,2025-04-18 23:59:19,2025-04-18 23:59:19,To EUR Savings,-0.01,0,EUR,COMPLETED,919.32
CARD_PAYMENT,Current,2025-04-18 08:17:41,2025-04-19 06:33:48,A Padaria Portuguesa,-2.5,0,EUR,COMPLETED,916.82
TRANSFER,Current,2025-04-19 08:35:44,2025-04-19 08:35:44,To EUR Savings,-0.5,0,EUR,COMPLETED,916.32
CARD_PAYMENT,Current,2025-04-17 13:00:03,2025-04-19 10:36:27,Uber Eats,-31.66,0,EUR,COMPLETED,884.66
TRANSFER,Current,2025-04-19 12:46:00,2025-04-19 12:46:00,To EUR Savings,-0.34,0,EUR,COMPLETED,884.32
TOPUP,Current,2025-04-19 17:03:57,2025-04-19 17:03:58,Apple Pay Top-Up by *0264,200,0,EUR,COMPLETED,1084.32
TRANSFER,Current,2025-04-19 17:07:36,2025-04-19 17:07:36,To EUR Savings,-0.57,0,EUR,COMPLETED,1083.75
CARD_PAYMENT,Current,2025-04-19 08:35:43,2025-04-20 06:29:24,A Padaria Portuguesa,-2.5,0,EUR,COMPLETED,1081.25
TRANSFER,Current,2025-04-20 08:34:51,2025-04-20 08:34:51,To EUR Savings,-0.5,0,EUR,COMPLETED,1080.75
TRANSFER,Current,2025-04-20 09:41:23,2025-04-20 09:41:23,To EUR Savings,-0.35,0,EUR,COMPLETED,1080.4
TRANSFER,Current,2025-04-20 13:10:03,2025-04-20 13:10:03,To EUR Savings,-0.01,0,EUR,COMPLETED,1080.39
CARD_PAYMENT,Current,2025-04-19 12:46:00,2025-04-20 13:49:10,OpenAI,-21.66,0.22,EUR,COMPLETED,1058.51
TRANSFER,Current,2025-04-21 02:47:15,2025-04-21 02:47:15,To EUR Savings,-20,0,EUR,COMPLETED,1038.51
CARD_PAYMENT,Current,2025-04-20 08:34:50,2025-04-21 06:09:03,A Padaria Portuguesa,-2.5,0,EUR,COMPLETED,1036.01
CARD_PAYMENT,Current,2025-04-20 09:41:22,2025-04-21 10:34:44,Pingo Doce,-58.65,0,EUR,COMPLETED,977.36
CARD_PAYMENT,Current,2025-04-18 23:59:19,2025-04-21 10:49:42,Ikeaportuga 15,-561.99,0,EUR,COMPLETED,415.37
CARD_PAYMENT,Current,2025-04-20 13:10:02,2025-04-21 10:50:11,Uber,-4.99,0,EUR,COMPLETED,410.38
CARD_PAYMENT,Current,2025-04-19 17:03:03,2025-04-21 11:04:10,Etnaga,-64.43,0,EUR,COMPLETED,345.95
TRANSFER,Current,2025-04-21 18:49:37,2025-04-21 18:49:37,To EUR Savings,-1,0,EUR,COMPLETED,344.95
CARD_PAYMENT,Current,2025-04-21 18:49:36,2025-04-22 09:02:35,Hospital Luz Oeiras,-15,0,EUR,COMPLETED,329.95
CARD_PAYMENT,Current,2025-04-22 15:01:03,,Render,-0.88,0,EUR,REVERTED,
TRANSFER,Current,2025-04-22 15:01:04,2025-04-22 15:01:04,To EUR Savings,-0.12,0,EUR,COMPLETED,329.83
TRANSFER,Current,2025-04-23 07:16:03,2025-04-23 07:16:03,To EUR Savings,-0.8,0,EUR,COMPLETED,329.03
TRANSFER,Current,2025-04-23 07:23:52,2025-04-23 07:23:52,To EUR Savings,-0.05,0,EUR,COMPLETED,328.98
TRANSFER,Current,2025-04-23 08:12:26,2025-04-23 08:12:26,To EUR Savings,-0.01,0,EUR,COMPLETED,328.97
TRANSFER,Current,2025-04-23 13:23:23,2025-04-23 13:23:23,To EUR Savings,-0.1,0,EUR,COMPLETED,328.87
TRANSFER,Current,2025-04-23 19:15:07,2025-04-23 19:15:07,To EUR Savings,-0.24,0,EUR,COMPLETED,328.63
TOPUP,Current,2025-04-23 20:03:12,2025-04-23 20:03:13,Apple Pay Top-Up by *0264,200,0,EUR,COMPLETED,528.63
TRANSFER,Current,2025-04-23 20:04:06,2025-04-23 20:04:06,To EUR Savings,-0.6,0,EUR,COMPLETED,528.03
CARD_PAYMENT,Current,2025-04-23 19:15:06,2025-04-24 06:47:35,Minipreço,-6.76,0,EUR,COMPLETED,521.27
CARD_PAYMENT,Current,2025-04-23 13:23:22,2025-04-24 06:47:35,Alvaros,-31.9,0,EUR,COMPLETED,489.37
TRANSFER,Current,2025-04-24 08:43:57,2025-04-24 08:43:57,To EUR Savings,-0.3,0,EUR,COMPLETED,489.07
TRANSFER,Current,2025-04-24 09:04:29,2025-04-24 09:04:29,To EUR Savings,-0.01,0,EUR,COMPLETED,489.06
TRANSFER,Current,2025-04-24 12:45:04,2025-04-24 12:45:04,To EUR Savings,-0.8,0,EUR,COMPLETED,488.26
CARD_PAYMENT,Current,2025-04-23 07:16:02,2025-04-24 13:09:19,Brisa,-5.2,0,EUR,COMPLETED,483.06
CARD_PAYMENT,Current,2025-04-23 07:23:51,2025-04-24 13:09:20,Brisa,-1.95,0,EUR,COMPLETED,481.11
CARD_PAYMENT,Current,2025-04-23 08:12:26,2025-04-24 16:18:17,YouTube,-17.99,0,EUR,COMPLETED,463.12
TRANSFER,Current,2025-04-24 19:51:00,2025-04-24 19:51:00,To EUR Savings,-0.35,0,EUR,COMPLETED,462.77
TRANSFER,Current,2025-04-24 20:59:46,2025-04-24 20:59:46,To EUR Savings,-0.1,0,EUR,COMPLETED,462.67
CARD_PAYMENT,Current,2025-04-24 12:45:02,2025-04-25 06:17:57,Isabel Bandeira,-21.2,0,EUR,COMPLETED,441.47
CARD_PAYMENT,Current,2025-04-24 19:50:59,2025-04-25 06:20:38,Minipreço,-31.65,0,EUR,COMPLETED,409.82
CARD_PAYMENT,Current,2025-04-23 20:04:05,2025-04-25 06:20:46,Alvaros,-12.4,0,EUR,COMPLETED,397.42
CARD_PAYMENT,Current,2025-04-24 08:43:56,2025-04-25 06:20:46,C C Pombalinho,-6.7,0,EUR,COMPLETED,390.72
TRANSFER,Current,2025-04-25 09:13:28,2025-04-25 09:13:28,To EUR Savings,-0.18,0,EUR,COMPLETED,390.54
TRANSFER,Current,2025-04-25 09:31:30,2025-04-25 09:31:30,To EUR Savings,-1,0,EUR,COMPLETED,389.54
TRANSFER,Current,2025-04-25 09:51:32,2025-04-25 09:51:32,To EUR Savings,-0.35,0,EUR,COMPLETED,389.19
TRANSFER,Current,2025-04-25 10:05:22,2025-04-25 10:05:22,To EUR Savings,-1,0,EUR,COMPLETED,388.19
TRANSFER,Current,2025-04-25 10:55:12,2025-04-25 10:55:12,To EUR Savings,-0.67,0,EUR,COMPLETED,387.52
TRANSFER,Current,2025-04-25 19:04:44,2025-04-25 19:04:44,To EUR Savings,-0.48,0,EUR,COMPLETED,387.04
TOPUP,Current,2025-04-25 19:05:29,2025-04-25 19:05:30,Apple Pay Top-Up by *0264,200,0,EUR,COMPLETED,587.04
TRANSFER,Current,2025-04-25 20:16:28,2025-04-25 20:16:28,To EUR Savings,-0.4,0,EUR,COMPLETED,586.64
CARD_PAYMENT,Current,2025-04-25 09:51:31,2025-04-26 05:56:25,O Pao Quente,-10.65,0,EUR,COMPLETED,575.99
CARD_PAYMENT,Current,2025-04-25 10:55:11,2025-04-26 05:59:05,Minipreço,-9.33,0,EUR,COMPLETED,566.66
CARD_PAYMENT,Current,2025-04-25 19:04:43,2025-04-26 05:59:06,Minipreço,-7.52,0,EUR,COMPLETED,559.14
CARD_PAYMENT,Current,2025-04-24 20:59:45,2025-04-26 05:59:06,Alvaros,-23.9,0,EUR,COMPLETED,535.24
CARD_PAYMENT,Current,2025-04-25 09:13:27,2025-04-26 06:14:41,Lidl,-9.82,0,EUR,COMPLETED,525.42
TRANSFER,Current,2025-04-26 08:30:30,2025-04-26 08:30:30,To EUR Savings,-0.3,0,EUR,COMPLETED,525.12
TRANSFER,Current,2025-04-26 09:50:34,2025-04-26 09:50:34,To EUR Savings,-0.36,0,EUR,COMPLETED,524.76
CARD_PAYMENT,Current,2025-04-24 09:04:29,2025-04-26 10:07:13,Apple,-7.99,0,EUR,COMPLETED,516.77
TRANSFER,Current,2025-04-26 12:55:12,2025-04-26 12:55:12,To EUR Savings,-0.85,0,EUR,COMPLETED,515.92
CARD_PAYMENT,Current,2025-04-25 09:31:30,2025-04-26 16:59:58,Miió,-20,0,EUR,COMPLETED,495.92
CARD_PAYMENT,Current,2025-04-25 10:05:21,2025-04-26 17:00:00,Miió,-20,0,EUR,COMPLETED,475.92
TRANSFER,Current,2025-04-26 18:16:39,2025-04-26 18:16:39,To EUR Savings,-0.6,0,EUR,COMPLETED,475.32
TRANSFER,Current,2025-04-26 18:57:14,2025-04-26 18:57:14,To EUR Savings,-0.33,0,EUR,COMPLETED,474.99
TRANSFER,Current,2025-04-27 03:21:59,2025-04-27 03:21:59,To EUR Savings,-0.01,0,EUR,COMPLETED,474.98
CARD_PAYMENT,Current,2025-04-26 18:16:38,2025-04-27 06:13:46,A Piriquita Da N2,-8.4,0,EUR,COMPLETED,466.58
CARD_PAYMENT,Current,2025-04-26 18:57:13,2025-04-27 06:13:49,Minipreço,-5.67,0,EUR,COMPLETED,460.91
CARD_PAYMENT,Current,2025-04-25 20:16:27,2025-04-27 06:13:49,Alvaros,-17.6,0,EUR,COMPLETED,443.31
CARD_PAYMENT,Current,2025-04-26 08:30:29,2025-04-27 06:13:49,C C Pombalinho,-6.7,0,EUR,COMPLETED,436.61
CARD_PAYMENT,Current,2025-04-26 12:55:11,2025-04-27 06:13:49,C C Pombalinho,-11.15,0,EUR,COMPLETED,425.46
TRANSFER,Current,2025-04-27 08:40:46,2025-04-27 08:40:46,To EUR Savings,-0.55,0,EUR,COMPLETED,424.91
CARD_PAYMENT,Current,2025-04-26 09:50:34,2025-04-27 14:51:32,Openrouter,-9.64,0.1,EUR,COMPLETED,415.17
TRANSFER,Current,2025-04-27 20:15:10,2025-04-27 20:15:10,To EUR Savings,-0.46,0,EUR,COMPLETED,414.71
TRANSFER,Current,2025-04-28 03:00:10,2025-04-28 03:00:10,To EUR Savings,-20,0,EUR,COMPLETED,394.71
CARD_PAYMENT,Current,2025-04-27 08:40:45,2025-04-28 06:05:52,Oleigois,-6.45,0,EUR,COMPLETED,388.26
TRANSFER,Current,2025-04-28 09:09:36,2025-04-28 09:09:36,To EUR Savings,-0.03,0,EUR,COMPLETED,388.23
CARD_PAYMENT,Current,2025-04-27 03:21:59,2025-04-28 11:51:33,Netflix,-12.99,0,EUR,COMPLETED,375.24
CARD_PAYMENT,Current,2025-04-27 20:15:10,2025-04-28 16:42:30,CLAUDE,-6.54,0.07,EUR,COMPLETED,368.63
TRANSFER,Current,2025-04-28 20:08:20,2025-04-28 20:08:20,To EUR Savings,-0.77,0,EUR,COMPLETED,367.86
TRANSFER,Current,2025-04-29 05:53:21,2025-04-29 05:53:21,To EUR Savings,-0.51,0,EUR,COMPLETED,367.35
CARD_PAYMENT,Current,2025-04-28 20:08:20,2025-04-29 16:35:18,Codeium,-16.23,0,EUR,COMPLETED,351.12
TRANSFER,Current,2025-04-29 18:16:03,2025-04-29 18:16:03,To EUR Savings,-1,0,EUR,COMPLETED,350.12
TOPUP,Current,2025-04-29 18:17:56,2025-04-29 18:17:57,Apple Pay Top-Up by *0264,400,0,EUR,COMPLETED,750.12
TRANSFER,Current,2025-04-30 02:53:35,2025-04-30 02:53:35,To EUR Savings,-0.05,0,EUR,COMPLETED,750.07
TRANSFER,Current,2025-04-30 12:05:08,2025-04-30 12:05:08,To EUR Savings,-0.44,0,EUR,COMPLETED,749.63
CARD_PAYMENT,Current,2025-04-28 09:09:36,2025-04-30 13:22:41,Amazon,-246.97,0,EUR,COMPLETED,502.66
CARD_PAYMENT,Current,2025-04-29 05:53:21,2025-04-30 13:39:30,Apple,-5.49,0,EUR,COMPLETED,497.17
CARD_PAYMENT,Current,2025-04-29 18:16:02,2025-04-30 18:31:20,Hospital Da Luz Oeir,-19,0,EUR,COMPLETED,478.17
TRANSFER,Current,2025-05-01 02:27:35,2025-05-01 02:27:35,To EUR Rainy day,-50,0,EUR,COMPLETED,428.17
TRANSFER,Current,2025-05-01 08:09:31,2025-05-01 08:09:31,To EUR Savings,-0.5,0,EUR,COMPLETED,427.67
CARD_PAYMENT,Current,2025-04-30 02:53:35,2025-05-01 09:39:31,Apple,-21.95,0,EUR,COMPLETED,405.72
TRANSFER,Current,2025-05-01 12:51:04,2025-05-01 12:51:04,To EUR Savings,-0.67,0,EUR,COMPLETED,405.05
TRANSFER,Current,2025-05-01 14:13:17,2025-05-01 14:13:17,To EUR Savings,-0.6,0,EUR,COMPLETED,404.45
TRANSFER,Current,2025-05-01 16:15:43,2025-05-01 16:15:43,To EUR Savings,-0.63,0,EUR,COMPLETED,403.82
CARD_PAYMENT,Current,2025-05-01 08:09:31,2025-05-02 05:52:34,A Padaria Portuguesa,-2.5,0,EUR,COMPLETED,401.32
CARD_PAYMENT,Current,2025-05-01 14:13:17,2025-05-02 10:27:13,Uber Eats,-3.4,0,EUR,COMPLETED,397.92
TRANSFER,Current,2025-05-02 12:16:22,2025-05-02 12:16:22,To EUR Savings,-0.01,0,EUR,COMPLETED,397.91
CARD_PAYMENT,Current,2025-05-01 16:15:43,2025-05-02 15:31:45,CLAUDE,-27.37,0,EUR,COMPLETED,370.54
TOPUP,Current,2025-05-02 17:57:22,2025-05-02 17:57:23,Apple Pay Top-Up by *0264,200,0,EUR,COMPLETED,570.54
TRANSFER,Current,2025-05-03 08:38:24,2025-05-03 08:38:24,To EUR Savings,-0.41,0,EUR,COMPLETED,570.13
TRANSFER,Current,2025-05-03 10:29:03,2025-05-03 10:29:03,To EUR Savings,-0.8,0,EUR,COMPLETED,569.33
CARD_PAYMENT,Current,2025-04-30 12:05:08,2025-05-03 11:03:03,Uber Eats,-35.56,0,EUR,COMPLETED,533.77
TRANSFER,Current,2025-05-03 18:25:31,2025-05-03 18:25:31,To EUR Savings,-0.55,0,EUR,COMPLETED,533.22
TRANSFER,Current,2025-05-03 18:26:24,2025-05-03 18:26:24,To EUR Savings,-1,0,EUR,COMPLETED,532.22
CARD_PAYMENT,Current,2025-05-03 18:25:30,2025-05-04 05:32:09,Cinemacity Alfragide,-14.45,0,EUR,COMPLETED,517.77
CARD_PAYMENT,Current,2025-05-03 18:26:23,2025-05-04 05:32:09,Cinemacity Alfragide,-2,0,EUR,COMPLETED,515.77
CARD_PAYMENT,Current,2025-05-03 10:29:02,2025-05-04 06:39:22,Talho Super Desconto,-33.2,0,EUR,COMPLETED,482.57
TRANSFER,Current,2025-05-04 08:33:35,2025-05-04 08:33:35,To EUR Savings,-0.5,0,EUR,COMPLETED,482.07
TRANSFER,Current,2025-05-04 09:20:35,2025-05-04 09:20:35,To EUR Savings,-0.52,0,EUR,COMPLETED,481.55
CARD_PAYMENT,Current,2025-05-02 12:16:22,2025-05-04 13:40:19,PlayStation,-8.99,0,EUR,COMPLETED,472.56
CARD_PAYMENT,Current,2025-05-01 12:51:03,2025-05-04 13:52:43,Uber Eats,-36.33,0,EUR,COMPLETED,436.23
TRANSFER,Current,2025-05-04 14:52:02,2025-05-04 14:52:02,To EUR Savings,-1,0,EUR,COMPLETED,435.23
TRANSFER,Current,2025-05-04 17:49:42,2025-05-04 17:49:42,To EUR Savings,-0.4,0,EUR,COMPLETED,434.83
TRANSFER,Current,2025-05-05 03:04:50,2025-05-05 03:04:50,To EUR Savings,-20,0,EUR,COMPLETED,414.83
CARD_PAYMENT,Current,2025-05-04 14:52:01,2025-05-05 06:07:17,Scut,-5,0,EUR,COMPLETED,409.83
CARD_PAYMENT,Current,2025-05-04 08:33:34,2025-05-05 07:16:50,A Padaria Portuguesa,-2.5,0,EUR,COMPLETED,407.33
CARD_PAYMENT,Current,2025-05-04 09:20:34,2025-05-05 10:21:31,Pingo Doce,-41.48,0,EUR,COMPLETED,365.85
CARD_PAYMENT,Current,2025-05-04 17:49:41,2025-05-05 10:21:58,Pq Est Hosp Soerad,-3.6,0,EUR,COMPLETED,362.25
CARD_PAYMENT,Current,2025-05-05 11:26:54,2025-05-06 16:06:12,Cursor,-17.73,0,EUR,COMPLETED,344.52
CARD_PAYMENT,Current,2025-05-03 08:38:23,2025-05-06 19:08:16,Paddle,-24.59,0,EUR,COMPLETED,319.93
TRANSFER,Current,2025-05-06 19:37:02,2025-05-06 19:37:02,To EUR Savings,-0.69,0,EUR,COMPLETED,319.24
CARD_PAYMENT,Current,2025-05-06 19:37:02,2025-05-07 16:18:37,Codeium,-16.31,0,EUR,COMPLETED,302.93
TRANSFER,Current,2025-05-08 12:00:51,2025-05-08 12:00:51,To EUR Savings,-0.47,0,EUR,COMPLETED,302.46
TRANSFER,Current,2025-05-08 19:23:01,2025-05-08 19:23:01,To EUR Savings,-0.71,0,EUR,COMPLETED,301.75
CARD_PAYMENT,Current,2025-05-08 19:23:00,2025-05-09 07:32:20,Minipreço,-3.29,0,EUR,COMPLETED,298.46
TRANSFER,Current,2025-05-09 08:16:46,2025-05-09 08:16:46,To EUR Savings,-0.09,0,EUR,COMPLETED,298.37
TOPUP,Current,2025-05-09 15:15:13,2025-05-09 15:15:15,Apple Pay Top-Up by *0264,200,0,EUR,COMPLETED,498.37
TRANSFER,Current,2025-05-09 15:17:55,2025-05-09 15:17:55,To EUR Savings,-0.64,0,EUR,COMPLETED,497.73
CARD_PAYMENT,Current,2025-05-08 12:00:51,2025-05-09 19:52:01,Uber Eats,-23.53,0,EUR,COMPLETED,474.2
TRANSFER,Current,2025-05-10 03:38:13,2025-05-10 03:38:13,To EUR Savings,-1,0,EUR,COMPLETED,473.2
TRANSFER,Current,2025-05-10 08:19:47,2025-05-10 08:19:47,To EUR Savings,-0.5,0,EUR,COMPLETED,472.7
TOPUP,Current,2025-05-10 08:20:05,2025-05-10 08:20:06,Apple Pay Top-Up by *0264,200,0,EUR,COMPLETED,672.7
TRANSFER,Current,2025-05-10 17:17:36,2025-05-10 17:17:36,To EUR Savings,-0.99,0,EUR,COMPLETED,671.71
CARD_PAYMENT,Current,2025-05-09 15:17:54,2025-05-10 22:22:17,Codeium,-11.36,0,EUR,COMPLETED,660.35
CARD_PAYMENT,Current,2025-05-10 17:17:36,2025-05-11 06:39:58,Minipreço,-15.01,0,EUR,COMPLETED,645.34
CARD_PAYMENT,Current,2025-05-10 08:19:46,2025-05-11 06:58:25,A Padaria Portuguesa,-2.5,0,EUR,COMPLETED,642.84
TRANSFER,Current,2025-05-11 07:52:24,2025-05-11 07:52:24,To EUR Savings,-0.5,0,EUR,COMPLETED,642.34
CARD_REFUND,Current,2025-05-10 10:23:13,2025-05-11 09:15:03,Ikeaportuga 15,14,0,EUR,COMPLETED,656.34
TRANSFER,Current,2025-05-11 12:43:35,2025-05-11 12:43:35,To EUR Savings,-0.16,0,EUR,COMPLETED,656.18
TRANSFER,Current,2025-05-11 14:05:41,2025-05-11 14:05:41,To EUR Savings,-0.61,0,EUR,COMPLETED,655.57
TRANSFER,Current,2025-05-11 21:14:01,2025-05-11 21:14:01,To EUR Savings,-0.5,0,EUR,COMPLETED,655.07
TRANSFER,Current,2025-05-12 03:14:10,2025-05-12 03:14:10,To EUR Savings,-20,0,EUR,COMPLETED,635.07
CARD_PAYMENT,Current,2025-05-11 07:52:24,2025-05-12 07:52:58,A Padaria Portuguesa,-2.5,0,EUR,COMPLETED,632.57
TRANSFER,Current,2025-05-12 07:53:04,2025-05-12 07:53:04,To EUR Savings,-0.5,0,EUR,COMPLETED,632.07
TRANSFER,Current,2025-05-12 11:09:06,2025-05-12 11:09:06,To EUR Savings,-0.4,0,EUR,COMPLETED,631.67
TRANSFER,Current,2025-05-12 11:30:10,2025-05-12 11:30:10,To EUR Savings,-1,0,EUR,COMPLETED,630.67
CARD_PAYMENT,Current,2025-05-09 08:16:45,2025-05-12 12:16:31,Ikeaportuga 15,-160.91,0,EUR,COMPLETED,469.76
CARD_PAYMENT,Current,2025-05-11 14:05:41,2025-05-12 12:38:02,Uber Eats,-1.39,0,EUR,COMPLETED,468.37
CARD_PAYMENT,Current,2025-05-10 03:38:12,2025-05-12 12:38:03,Publicocomu,-76,0,EUR,COMPLETED,392.37
TRANSFER,Current,2025-05-12 21:19:52,2025-05-12 21:19:52,To EUR Savings,-0.9,0,EUR,COMPLETED,391.47
CARD_PAYMENT,Current,2025-05-11 21:14:00,2025-05-13 05:36:14,Rest Sete Castelos,-22.5,0,EUR,COMPLETED,368.97
CARD_PAYMENT,Current,2025-05-12 07:53:03,2025-05-13 07:01:23,A Padaria Portuguesa,-2.5,0,EUR,COMPLETED,366.47
TRANSFER,Current,2025-05-13 10:14:36,2025-05-13 10:14:36,To EUR Savings,-0.9,0,EUR,COMPLETED,365.57
CARD_PAYMENT,Current,2025-05-11 12:43:35,2025-05-13 10:29:34,Uber Eats,-14.84,0,EUR,COMPLETED,350.73
CARD_REFUND,Current,2025-05-12 09:50:18,2025-05-13 10:30:02,Publicocomu,76,0,EUR,COMPLETED,426.73
TRANSFER,Current,2025-05-13 13:44:34,2025-05-13 13:44:34,To EUR Savings,-0.4,0,EUR,COMPLETED,426.33
TRANSFER,Current,2025-05-13 13:55:41,2025-05-13 13:55:41,To EUR Savings,-0.19,0,EUR,COMPLETED,426.14
CARD_PAYMENT,Current,2025-05-12 11:09:05,2025-05-13 16:04:18,Music Factory,-8.6,0,EUR,COMPLETED,417.54
CARD_PAYMENT,Current,2025-05-12 11:30:09,2025-05-13 17:06:37,IKEA,-45,0,EUR,COMPLETED,372.54
TRANSFER,Current,2025-05-13 17:50:57,2025-05-13 17:50:57,To EUR Savings,-1,0,EUR,COMPLETED,371.54
TOPUP,Current,2025-05-13 17:51:38,2025-05-13 17:51:40,Apple Pay Top-Up by *0264,200,0,EUR,COMPLETED,571.54
TRANSFER,Current,2025-05-13 21:09:15,2025-05-13 21:09:15,To EUR Savings,-0.6,0,EUR,COMPLETED,570.94
CARD_PAYMENT,Current,2025-05-13 13:55:40,2025-05-14 05:57:45,Minipreço,-6.81,0,EUR,COMPLETED,564.13
CARD_PAYMENT,Current,2025-05-13 13:44:33,2025-05-14 05:57:45,Alvaros Cafe Unipess,-23.6,0,EUR,COMPLETED,540.53
CARD_PAYMENT,Current,2025-05-13 10:14:35,2025-05-14 09:39:40,Brisa,-8.1,0,EUR,COMPLETED,532.43
CARD_PAYMENT,Current,2025-05-12 21:19:51,2025-05-14 09:39:45,La Siesta Cocina Mexicana,-62.1,0,EUR,COMPLETED,470.33
TRANSFER,Current,2025-05-14 13:53:11,2025-05-14 13:53:11,To EUR Savings,-0.7,0,EUR,COMPLETED,469.63
TRANSFER,Current,2025-05-14 14:07:42,2025-05-14 14:07:42,To EUR Savings,-0.02,0,EUR,COMPLETED,469.61
TRANSFER,Current,2025-05-14 17:17:15,2025-05-14 17:17:15,To EUR Savings,-0.13,0,EUR,COMPLETED,469.48
TRANSFER,Current,2025-05-14 17:50:35,2025-05-14 17:50:35,To EUR Savings,-1,0,EUR,COMPLETED,468.48
CARD_PAYMENT,Current,2025-05-13 17:50:56,2025-05-14 18:38:09,Hospitaldal,-30,0,EUR,COMPLETED,438.48
TRANSFER,Current,2025-05-14 19:35:02,2025-05-14 19:35:02,To EUR Savings,-0.8,0,EUR,COMPLETED,437.68
CARD_PAYMENT,Current,2025-05-14 13:53:10,2025-05-15 06:08:03,Cafe Rest Beira Rio,-23.3,0,EUR,COMPLETED,414.38
CARD_PAYMENT,Current,2025-05-14 19:35:01,2025-05-15 06:08:03,Isabel Bandeira,-7.2,0,EUR,COMPLETED,407.18
CARD_PAYMENT,Current,2025-05-14 14:07:41,2025-05-15 06:10:49,Minipreço,-4.98,0,EUR,COMPLETED,402.2
CARD_PAYMENT,Current,2025-05-14 17:17:14,2025-05-15 06:10:49,Minipreço,-10.87,0,EUR,COMPLETED,391.33
CARD_PAYMENT,Current,2025-05-13 21:09:14,2025-05-15 06:10:58,Alvaros,-30.4,0,EUR,COMPLETED,360.93
TRANSFER,Current,2025-05-15 15:34:23,2025-05-15 15:34:23,To EUR Savings,-1,0,EUR,COMPLETED,359.93
TRANSFER,Current,2025-05-15 17:02:39,2025-05-15 17:02:39,To EUR Savings,-1,0,EUR,COMPLETED,358.93
TRANSFER,Current,2025-05-15 17:57:51,2025-05-15 17:57:51,To EUR Savings,-0.6,0,EUR,COMPLETED,358.33
CARD_PAYMENT,Current,2025-05-14 17:50:35,2025-05-15 18:48:30,Zaask,-99,0,EUR,COMPLETED,259.33
CARD_PAYMENT,Current,2025-05-15 17:57:50,2025-05-16 05:58:28,Cafe Rest Beira Rio,-5.4,0,EUR,COMPLETED,253.93
CARD_PAYMENT,Current,2025-05-15 17:02:39,2025-05-16 11:23:53,Miió,-20,0,EUR,COMPLETED,233.93
TRANSFER,Current,2025-05-16 12:20:26,2025-05-16 12:20:26,To EUR Savings,-0.5,0,EUR,COMPLETED,233.43
TRANSFER,Current,2025-05-16 19:43:05,2025-05-16 19:43:05,To EUR Savings,-0.31,0,EUR,COMPLETED,233.12
CARD_PAYMENT,Current,2025-05-15 15:34:23,2025-05-16 19:58:46,Miió,-20,0,EUR,COMPLETED,213.12
CARD_PAYMENT,Current,2025-05-16 12:20:25,2025-05-17 05:40:06,C C Pombalinho,-12.5,0,EUR,COMPLETED,200.62
TRANSFER,Current,2025-05-17 07:54:31,2025-05-17 07:54:31,To EUR Savings,-0.5,0,EUR,COMPLETED,200.12
TRANSFER,Current,2025-05-17 09:42:41,2025-05-17 09:42:41,To EUR Savings,-0.24,0,EUR,COMPLETED,199.88
CARD_PAYMENT,Current,2025-05-17 09:42:40,2025-05-18 05:32:32,Talho Super Desconto,-23.76,0,EUR,COMPLETED,176.12
CARD_PAYMENT,Current,2025-05-17 07:54:31,2025-05-18 05:34:08,A Padaria Portuguesa,-2.5,0,EUR,COMPLETED,173.62
TRANSFER,Current,2025-05-18 08:25:32,2025-05-18 08:25:32,To EUR Savings,-0.5,0,EUR,COMPLETED,173.12
TOPUP,Current,2025-05-18 08:26:05,2025-05-18 08:26:06,Apple Pay Top-Up by *0264,200,0,EUR,COMPLETED,373.12
TRANSFER,Current,2025-05-18 09:03:26,2025-05-18 09:03:26,To EUR Savings,-0.13,0,EUR,COMPLETED,372.99
TRANSFER,Current,2025-05-19 03:03:53,2025-05-19 03:03:53,To EUR Savings,-20,0,EUR,COMPLETED,352.99
CARD_PAYMENT,Current,2025-05-18 08:25:31,2025-05-19 07:02:20,A Padaria Portuguesa,-2.5,0,EUR,COMPLETED,350.49
TRANSFER,Current,2025-05-19 07:46:35,2025-05-19 07:46:35,To EUR Savings,-0.87,0,EUR,COMPLETED,349.62
TRANSFER,Current,2025-05-19 07:50:51,2025-05-19 07:50:51,To EUR Savings,-0.87,0,EUR,COMPLETED,348.75
TRANSFER,Current,2025-05-19 08:22:20,2025-05-19 08:22:20,To EUR Savings,-0.26,0,EUR,COMPLETED,348.49
TRANSFER,Current,2025-05-19 11:15:32,2025-05-19 11:15:32,To EUR Savings,-0.52,0,EUR,COMPLETED,347.97
CARD_PAYMENT,Current,2025-05-18 09:03:26,2025-05-19 11:44:34,Pingo Doce,-55.87,0,EUR,COMPLETED,292.1
CARD_PAYMENT,Current,2025-05-16 19:43:04,2025-05-19 13:45:22,Uber Eats,-17.69,0,EUR,COMPLETED,274.41
CARD_PAYMENT,Current,2025-05-19 08:22:20,2025-05-20 06:13:12,UK Visas and Immigration,-19.74,0,EUR,COMPLETED,254.67
TRANSFER,Current,2025-05-20 13:10:03,2025-05-20 13:10:03,To EUR Savings,-0.01,0,EUR,COMPLETED,254.66
CARD_PAYMENT,Current,2025-05-19 07:46:34,2025-05-20 13:25:55,Worten,-39.13,0,EUR,COMPLETED,215.53
CARD_PAYMENT,Current,2025-05-19 07:50:51,2025-05-20 13:25:55,Worten,-39.13,0,EUR,COMPLETED,176.4
TRANSFER,Current,2025-05-20 15:38:08,2025-05-20 15:38:08,To EUR Savings,-0.05,0,EUR,COMPLETED,176.35
CARD_PAYMENT,Current,2025-05-19 11:15:32,2025-05-20 18:32:49,CLAUDE,-5.48,0,EUR,COMPLETED,170.87
TRANSFER,Current,2025-05-21 09:01:40,2025-05-21 09:01:40,To EUR Savings,-0.85,0,EUR,COMPLETED,170.02
CARD_PAYMENT,Current,2025-05-20 13:10:03,2025-05-21 14:47:39,Uber,-4.99,0,EUR,COMPLETED,165.03
CARD_PAYMENT,Current,2025-05-20 15:38:08,2025-05-21 17:37:34,OpenAI,-21.95,0,EUR,COMPLETED,143.08
TRANSFER,Current,2025-05-21 17:37:48,2025-05-21 17:37:48,To EUR Savings,-0.83,0,EUR,COMPLETED,142.25
TRANSFER,Current,2025-05-22 12:47:37,2025-05-22 12:47:37,To EUR Savings,-0.6,0,EUR,COMPLETED,141.65
CARD_PAYMENT,Current,2025-05-21 09:01:40,2025-05-22 15:56:11,Uber,-8.15,0,EUR,COMPLETED,133.5
CARD_PAYMENT,Current,2025-05-21 17:37:47,2025-05-22 15:56:13,Uber,-7.17,0,EUR,COMPLETED,126.33
TRANSFER,Current,2025-05-23 08:12:26,2025-05-23 08:12:26,To EUR Savings,-0.01,0,EUR,COMPLETED,126.32
TRANSFER,Current,2025-05-23 20:13:23,2025-05-23 20:13:23,To EUR Savings,-1,0,EUR,COMPLETED,125.32
TRANSFER,Current,2025-05-24 08:17:40,2025-05-24 08:17:40,To EUR Savings,-0.5,0,EUR,COMPLETED,124.82
TOPUP,Current,2025-05-24 08:18:08,2025-05-24 08:18:09,Apple Pay Top-Up by *0264,200,0,EUR,COMPLETED,324.82
TRANSFER,Current,2025-05-24 10:23:44,2025-05-24 10:23:44,To EUR Savings,-0.01,0,EUR,COMPLETED,324.81
TRANSFER,Current,2025-05-24 12:28:10,2025-05-24 12:28:10,To EUR Savings,-0.78,0,EUR,COMPLETED,324.03
TRANSFER,Current,2025-05-24 17:13:13,2025-05-24 17:13:13,To EUR Savings,-0.26,0,EUR,COMPLETED,323.77
CARD_PAYMENT,Current,2025-05-23 20:13:23,2025-05-24 18:24:32,GitHub,-4,0,EUR,COMPLETED,319.77
CARD_PAYMENT,Current,2025-05-24 10:23:43,2025-05-25 05:53:05,Roady Sao Domingos D,-3.99,0,EUR,COMPLETED,315.78
CARD_PAYMENT,Current,2025-05-24 08:17:39,2025-05-25 05:53:10,A Padaria Portuguesa,-2.5,0,EUR,COMPLETED,313.28
TRANSFER,Current,2025-05-25 07:14:15,2025-05-25 07:14:15,To EUR Savings,-0.5,0,EUR,COMPLETED,312.78
TOPUP,Current,2025-05-25 07:14:49,2025-05-25 07:14:50,Apple Pay Top-Up by *0264,200,0,EUR,COMPLETED,512.78
TRANSFER,Current,2025-05-25 08:14:48,2025-05-25 08:14:48,To EUR Savings,-0.33,0,EUR,COMPLETED,512.45
TOPUP,Current,2025-05-25 09:16:15,2025-05-25 09:16:17,Apple Pay Top-Up by *0264,500,0,EUR,COMPLETED,1012.45
TRANSFER,Current,2025-05-25 09:16:42,2025-05-25 09:16:42,To EUR Savings,-0.95,0,EUR,COMPLETED,1011.5
CARD_PAYMENT,Current,2025-05-22 12:47:37,2025-05-25 12:06:07,Uber Eats,-24.4,0,EUR,COMPLETED,987.1
CARD_PAYMENT,Current,2025-05-23 08:12:25,2025-05-25 12:35:11,Google,-17.99,0,EUR,COMPLETED,969.11
CARD_PAYMENT,Current,2025-05-24 17:13:13,2025-05-25 14:42:20,GitHub,-10.74,0.11,EUR,COMPLETED,958.26
TRANSFER,Current,2025-05-26 03:01:51,2025-05-26 03:01:51,To EUR Savings,-20,0,EUR,COMPLETED,938.26
CARD_PAYMENT,Current,2025-05-25 09:16:41,2025-05-26 06:07:59,Roady Sao Domingos D,-528.05,0,EUR,COMPLETED,410.21
CARD_PAYMENT,Current,2025-05-25 07:14:15,2025-05-26 06:08:01,A Padaria Portuguesa,-2.5,0,EUR,COMPLETED,407.71
TRANSFER,Current,2025-05-26 11:16:42,2025-05-26 11:16:42,To EUR Savings,-0.86,0,EUR,COMPLETED,406.85
CARD_PAYMENT,Current,2025-05-25 08:14:47,2025-05-26 12:19:07,Pingo Doce,-49.67,0,EUR,COMPLETED,357.18
TRANSFER,Current,2025-05-26 12:40:25,2025-05-26 12:40:25,To EUR Savings,-0.14,0,EUR,COMPLETED,357.04
TRANSFER,Current,2025-05-26 15:31:56,2025-05-26 15:31:56,To EUR Savings,-0.86,0,EUR,COMPLETED,356.18
TRANSFER,Current,2025-05-27 02:13:43,2025-05-27 02:13:43,To EUR Savings,-0.01,0,EUR,COMPLETED,356.17
CARD_PAYMENT,Current,2025-05-26 11:16:41,2025-05-27 03:54:56,Anthropic,-22.14,0,EUR,COMPLETED,334.03
CARD_PAYMENT,Current,2025-05-24 12:28:10,2025-05-27 12:35:07,Uber Eats,-18.22,0,EUR,COMPLETED,315.81
CARD_PAYMENT,Current,2025-05-26 12:40:24,2025-05-27 14:45:48,CLAUDE,-10.86,0,EUR,COMPLETED,304.95
CARD_PAYMENT,Current,2025-05-26 15:31:56,2025-05-27 14:46:13,CLAUDE,-27.14,0,EUR,COMPLETED,277.81
TRANSFER,Current,2025-05-27 17:28:13,2025-05-27 17:28:13,To EUR Savings,-0.74,0,EUR,COMPLETED,277.07
CARD_PAYMENT,Current,2025-05-27 02:13:43,2025-05-28 13:07:13,Netflix,-12.99,0,EUR,COMPLETED,264.08
CARD_PAYMENT,Current,2025-05-27 17:28:13,2025-05-28 15:24:39,CLAUDE,-27.26,0,EUR,COMPLETED,236.82
TRANSFER,Current,2025-05-29 05:52:28,2025-05-29 05:52:28,To EUR Savings,-0.51,0,EUR,COMPLETED,236.31
TRANSFER,Current,2025-05-29 12:29:42,2025-05-29 12:29:42,To EUR Savings,-0.05,0,EUR,COMPLETED,236.26
TOPUP,Current,2025-05-29 12:30:49,2025-05-29 12:30:50,Apple Pay Top-Up by *0264,200,0,EUR,COMPLETED,436.26
TRANSFER,Current,2025-05-29 12:31:31,2025-05-29 12:31:31,To EUR Savings,-0.44,0,EUR,COMPLETED,435.82
TRANSFER,Current,2025-05-29 14:18:49,2025-05-29 14:18:49,To EUR Savings,-0.29,0,EUR,COMPLETED,435.53
TRANSFER,Current,2025-05-29 17:40:44,2025-05-29 17:40:44,To EUR Savings,-1,0,EUR,COMPLETED,434.53
TRANSFER,Current,2025-05-30 02:55:33,2025-05-30 02:55:33,To EUR Savings,-0.05,0,EUR,COMPLETED,434.48
CARD_PAYMENT,Current,2025-05-29 05:52:28,2025-05-30 11:18:15,Apple,-5.49,0,EUR,COMPLETED,428.99
CARD_PAYMENT,Current,2025-05-29 17:40:43,2025-05-30 16:33:36,Hospital Da Luz Oeir,-30,0,EUR,COMPLETED,398.99
CARD_PAYMENT,Current,2025-05-29 12:29:42,2025-05-30 17:19:27,CLAUDE,-10.95,0,EUR,COMPLETED,388.04
CARD_PAYMENT,Current,2025-05-29 14:18:48,2025-05-30 17:19:40,Cursor,-17.71,0,EUR,COMPLETED,370.33
TRANSFER,Current,2025-05-31 07:58:08,2025-05-31 07:58:08,To EUR Savings,-1,0,EUR,COMPLETED,369.33
TOPUP,Current,2025-05-31 08:15:18,2025-05-31 08:15:19,Apple Pay Top-Up by *0264,200,0,EUR,COMPLETED,569.33
TRANSFER,Current,2025-05-31 09:08:42,2025-05-31 09:08:42,To EUR Savings,-0.3,0,EUR,COMPLETED,569.03
TRANSFER,Current,2025-05-31 10:44:01,2025-05-31 10:44:01,To EUR Savings,-0.52,0,EUR,COMPLETED,568.51
TRANSFER,Current,2025-05-31 20:07:22,2025-05-31 20:07:22,To EUR Savings,-0.15,0,EUR,COMPLETED,568.36
TRANSFER,Current,2025-06-01 02:25:27,2025-06-01 02:25:27,To EUR Rainy day,-50,0,EUR,COMPLETED,518.36
CARD_PAYMENT,Current,2025-05-31 10:44:01,2025-06-01 05:56:48,Farmacia Sta Rita,-0.48,0,EUR,COMPLETED,517.88
CARD_PAYMENT,Current,2025-05-31 09:08:42,2025-06-01 06:08:21,Intermarché,-3.7,0,EUR,COMPLETED,514.18
CARD_PAYMENT,Current,2025-05-31 07:58:08,2025-06-01 06:08:24,Repsol,-20,0,EUR,COMPLETED,494.18
TRANSFER,Current,2025-06-01 07:43:36,2025-06-01 07:43:36,To EUR Savings,-0.5,0,EUR,COMPLETED,493.68
TRANSFER,Current,2025-06-01 08:18:53,2025-06-01 08:18:53,To EUR Savings,-0.72,0,EUR,COMPLETED,492.96
CARD_PAYMENT,Current,2025-05-29 12:31:31,2025-06-01 11:22:31,Uber Eats,-35.56,0,EUR,COMPLETED,457.4
CARD_PAYMENT,Current,2025-05-30 02:55:32,2025-06-01 11:23:44,Apple,-21.95,0,EUR,COMPLETED,435.45
TRANSFER,Current,2025-06-01 12:41:23,2025-06-01 12:41:23,To EUR Savings,-1,0,EUR,COMPLETED,434.45
TRANSFER,Current,2025-06-01 12:52:48,2025-06-01 12:52:48,To EUR Savings,-0.6,0,EUR,COMPLETED,433.85
TRANSFER,Current,2025-06-01 13:31:58,2025-06-01 13:31:58,To EUR Savings,-0.7,0,EUR,COMPLETED,433.15
CARD_PAYMENT,Current,2025-05-31 20:07:21,2025-06-01 15:32:49,IKEA,-17.85,0,EUR,COMPLETED,415.3
TRANSFER,Current,2025-06-02 03:00:40,2025-06-02 03:00:40,To EUR Savings,-20,0,EUR,COMPLETED,395.3
CARD_PAYMENT,Current,2025-06-01 07:43:36,2025-06-02 05:56:10,A Padaria Portuguesa,-2.5,0,EUR,COMPLETED,392.8
CARD_PAYMENT,Current,2025-06-01 12:41:22,2025-06-02 05:56:12,Saisish,-28,0,EUR,COMPLETED,364.8
CARD_PAYMENT,Current,2025-06-01 08:18:52,2025-06-02 09:15:21,Pingo Doce,-35.28,0,EUR,COMPLETED,329.52
CARD_PAYMENT,Current,2025-06-01 12:52:47,2025-06-02 09:15:30,Mercado de Algés,-13.4,0,EUR,COMPLETED,316.12
CARD_PAYMENT,Current,2025-06-01 13:31:57,2025-06-02 09:15:30,Mercado de Algés,-3.3,0,EUR,COMPLETED,312.82
TRANSFER,Current,2025-06-02 12:16:13,2025-06-02 12:16:13,To EUR Savings,-0.01,0,EUR,COMPLETED,312.81
TRANSFER,Current,2025-06-02 15:57:50,2025-06-02 15:57:50,To EUR Savings,-1,0,EUR,COMPLETED,311.81
TOPUP,Current,2025-06-02 15:58:43,2025-06-02 15:58:44,Apple Pay Top-Up by *0264,200,0,EUR,COMPLETED,511.81
CARD_PAYMENT,Current,2025-06-02 15:57:49,2025-06-03 14:06:55,Hospital Da Luz Oeir,-64,0,EUR,COMPLETED,447.81
CARD_PAYMENT,Current,2025-06-02 12:16:10,2025-06-04 10:26:08,PlayStation,-8.99,0,EUR,COMPLETED,438.82
TRANSFER,Current,2025-06-04 12:34:48,2025-06-04 12:34:48,To EUR Savings,-0.78,0,EUR,COMPLETED,438.04
TRANSFER,Current,2025-06-04 13:42:04,2025-06-04 13:42:04,To EUR Savings,-1,0,EUR,COMPLETED,437.04
TRANSFER,Current,2025-06-04 16:40:12,2025-06-04 16:40:12,To EUR Savings,-0.41,0,EUR,COMPLETED,436.63
CARD_PAYMENT,Current,2025-06-04 16:40:11,2025-06-05 06:21:25,Apreslar Unip.lda,-160.59,0,EUR,COMPLETED,276.04
TOPUP,Current,2025-06-05 07:14:32,2025-06-05 07:14:33,Apple Pay Top-Up by *0264,200,0,EUR,COMPLETED,476.04
CARD_PAYMENT,Current,2025-06-04 13:42:04,2025-06-05 10:27:21,Hospitaldal,-16,0,EUR,COMPLETED,460.04
TRANSFER,Current,2025-06-05 12:02:47,2025-06-05 12:02:47,To EUR Savings,-0.34,0,EUR,COMPLETED,459.7
TRANSFER,Current,2025-06-05 12:27:28,2025-06-05 12:27:28,To EUR Savings,-0.41,0,EUR,COMPLETED,459.29
TRANSFER,Current,2025-06-05 12:48:45,2025-06-05 12:48:45,To EUR Savings,-0.48,0,EUR,COMPLETED,458.81
TRANSFER,Current,2025-06-05 16:00:51,2025-06-05 16:00:51,To EUR Savings,-1,0,EUR,COMPLETED,457.81
CARD_PAYMENT,Current,2025-06-05 12:27:28,2025-06-06 16:24:32,Cursor,-17.59,0,EUR,COMPLETED,440.22
TRANSFER,Current,2025-06-06 19:02:58,2025-06-06 19:02:58,To EUR Savings,-0.62,0,EUR,COMPLETED,439.6
TRANSFER,Current,2025-06-06 20:08:57,2025-06-06 20:08:57,To EUR Savings,-0.03,0,EUR,COMPLETED,439.57
TRANSFER,Current,2025-06-07 07:19:41,2025-06-07 07:19:41,To EUR Savings,-0.5,0,EUR,COMPLETED,439.07
CARD_PAYMENT,Current,2025-06-04 12:34:48,2025-06-07 12:42:40,Uber Eats,-18.22,0,EUR,COMPLETED,420.85
CARD_PAYMENT,Current,2025-06-05 16:00:50,2025-06-07 12:42:43,Hospitaldal,-16,0,EUR,COMPLETED,404.85
CARD_PAYMENT,Current,2025-06-05 12:48:44,2025-06-07 12:42:44,Uber,-7.52,0,EUR,COMPLETED,397.33
CARD_PAYMENT,Current,2025-06-05 12:02:47,2025-06-07 12:58:35,Uber Eats,-31.66,0,EUR,COMPLETED,365.67
TRANSFER,Current,2025-06-07 14:10:09,2025-06-07 14:10:09,To EUR Savings,-0.5,0,EUR,COMPLETED,365.17
CARD_PAYMENT,Current,2025-06-07 14:10:08,2025-06-08 05:50:20,Tertulia Delirante,-27.5,0,EUR,COMPLETED,337.67
CARD_PAYMENT,Current,2025-06-07 07:19:40,2025-06-08 06:36:00,A Padaria Portuguesa,-2.5,0,EUR,COMPLETED,335.17
TRANSFER,Current,2025-06-08 08:31:56,2025-06-08 08:31:56,To EUR Savings,-0.5,0,EUR,COMPLETED,334.67
TRANSFER,Current,2025-06-08 13:46:18,2025-06-08 13:46:18,To EUR Savings,-0.65,0,EUR,COMPLETED,334.02
TRANSFER,Current,2025-06-08 15:29:27,2025-06-08 15:29:27,To EUR Savings,-0.41,0,EUR,COMPLETED,333.61
TOPUP,Current,2025-06-08 15:29:57,2025-06-08 15:29:58,Apple Pay Top-Up by *0264,400,0,EUR,COMPLETED,733.61
TRANSFER,Current,2025-06-08 23:21:35,2025-06-08 23:21:35,To EUR Savings,-0.02,0,EUR,COMPLETED,733.59
TRANSFER,Current,2025-06-09 02:59:19,2025-06-09 02:59:19,To EUR Savings,-20,0,EUR,COMPLETED,713.59
CARD_PAYMENT,Current,2025-06-08 23:21:34,2025-06-09 05:41:59,Mocha Eats 2,-2.98,0,EUR,COMPLETED,710.61
CARD_PAYMENT,Current,2025-06-08 08:31:56,2025-06-09 05:43:19,A Padaria Portuguesa,-2.5,0,EUR,COMPLETED,708.11
CARD_PAYMENT,Current,2025-06-08 13:46:18,2025-06-09 05:43:21,Feito Portugal,-6.35,0,EUR,COMPLETED,701.76
CARD_REFUND,Current,2025-06-07 14:36:37,2025-06-09 06:01:02,Tertulia Delirante,1,0,EUR,COMPLETED,702.76
CARD_PAYMENT,Current,2025-06-09 00:59:59,2025-06-09 12:34:07,Transport for London,-3.35,0,EUR,COMPLETED,699.41
TRANSFER,Current,2025-06-09 12:34:08,2025-06-09 12:34:08,To EUR Savings,-0.65,0,EUR,COMPLETED,698.76
CARD_PAYMENT,Current,2025-06-06 20:08:57,2025-06-09 14:11:14,Uber Eats,-11.97,0,EUR,COMPLETED,686.79
CARD_PAYMENT,Current,2025-06-06 19:02:57,2025-06-09 16:13:33,GitHub,-34.38,0,EUR,COMPLETED,652.41
TRANSFER,Current,2025-06-09 21:16:57,2025-06-09 21:16:57,To EUR Savings,-0.02,0,EUR,COMPLETED,652.39
CARD_PAYMENT,Current,2025-06-09 21:16:57,2025-06-10 06:24:57,Mocha Eats 2,-2.98,0,EUR,COMPLETED,649.41
CARD_PAYMENT,Current,2025-06-10 00:59:59,2025-06-10 15:14:48,Transport for London,-10.57,0,EUR,COMPLETED,638.84
TRANSFER,Current,2025-06-10 15:14:48,2025-06-10 15:14:48,To EUR Savings,-0.43,0,EUR,COMPLETED,638.41
CARD_PAYMENT,Current,2025-06-08 15:29:26,2025-06-11 14:37:32,Heathrowexp,-47.59,0.48,EUR,COMPLETED,590.34
TRANSFER,Current,2025-06-11 16:15:51,2025-06-11 16:15:51,To EUR Savings,-0.03,0,EUR,COMPLETED,590.31
TRANSFER,Current,2025-06-11 21:40:10,2025-06-11 21:40:10,To EUR Savings,-0.16,0,EUR,COMPLETED,590.15
TRANSFER,Current,2025-06-11 23:07:29,2025-06-11 23:07:29,To EUR Savings,-0.16,0,EUR,COMPLETED,589.99
CARD_PAYMENT,Current,2025-06-11 21:40:09,2025-06-12 03:08:55,Square,-60.84,0,EUR,COMPLETED,529.15
CARD_PAYMENT,Current,2025-06-11 16:15:50,2025-06-12 03:12:28,Aveba Ltd,-2.97,0,EUR,COMPLETED,526.18
CARD_PAYMENT,Current,2025-06-11 23:07:29,2025-06-12 12:05:08,TAP Air Portugal,-59.84,0,EUR,COMPLETED,466.34
CARD_PAYMENT,Current,2025-06-11 00:59:59,2025-06-12 12:06:50,Transport for London,-6.83,0,EUR,COMPLETED,459.51
TRANSFER,Current,2025-06-12 12:06:51,2025-06-12 12:06:51,To EUR Savings,-0.17,0,EUR,COMPLETED,459.34
CARD_PAYMENT,Current,2025-06-12 00:59:59,2025-06-12 12:07:00,Transport for London,-10,0,EUR,COMPLETED,449.34
TRANSFER,Current,2025-06-12 12:07:00,2025-06-12 12:07:00,To EUR Savings,-1,0,EUR,COMPLETED,448.34
TRANSFER,Current,2025-06-12 12:11:19,2025-06-12 12:11:19,To EUR Savings,-0.7,0,EUR,COMPLETED,447.64
TRANSFER,Current,2025-06-12 13:54:52,2025-06-12 13:54:52,To EUR Savings,-0.85,0,EUR,COMPLETED,446.79
TRANSFER,Current,2025-06-12 18:01:50,2025-06-12 18:01:50,To EUR Savings,-0.9,0,EUR,COMPLETED,445.89
TRANSFER,Current,2025-06-13 08:59:23,2025-06-13 08:59:23,To EUR Savings,-0.5,0,EUR,COMPLETED,445.39
CARD_PAYMENT,Current,2025-06-13 12:40:17,,Uber Eats,-21.09,0,EUR,PENDING,
TRANSFER,Current,2025-06-13 12:40:18,2025-06-13 12:40:18,To EUR Savings,-0.91,0,EUR,COMPLETED,444.48
CARD_PAYMENT,Current,2025-06-12 12:11:18,2025-06-13 15:19:52,DoubleTree by Hilton,-5.3,0,EUR,COMPLETED,439.18
CARD_PAYMENT,Current,2025-06-12 13:54:48,2025-06-13 15:19:52,DoubleTree by Hilton,-25.15,0,EUR,COMPLETED,414.03
CARD_PAYMENT,Current,2025-06-12 18:01:49,2025-06-13 15:20:59,Pret A Manger,-18.1,0,EUR,COMPLETED,395.93
CARD_PAYMENT,Current,2025-06-13 00:59:59,2025-06-13 16:09:20,Transport for London,-3.31,0,EUR,COMPLETED,392.62
TRANSFER,Current,2025-06-13 16:09:20,2025-06-13 16:09:20,To EUR Savings,-0.69,0,EUR,COMPLETED,391.93
TRANSFER,Current,2025-06-13 20:13:33,2025-06-13 20:13:33,To EUR Savings,-1,0,EUR,COMPLETED,390.93
CARD_PAYMENT,Current,2025-06-13 08:59:22,2025-06-14 05:30:39,A Padaria Portuguesa,-2.5,0,EUR,COMPLETED,388.43
TRANSFER,Current,2025-06-14 08:11:55,2025-06-14 08:11:55,To EUR Savings,-0.5,0,EUR,COMPLETED,387.93
TRANSFER,Current,2025-06-14 09:20:27,2025-06-14 09:20:27,To EUR Savings,-0.25,0,EUR,COMPLETED,387.68
TRANSFER,Current,2025-06-14 15:25:29,2025-06-14 15:25:29,To EUR Savings,-0.9,0,EUR,COMPLETED,386.78
TOPUP,Current,2025-06-14 16:10:42,2025-06-14 16:10:43,Apple Pay Top-Up by *0264,200,0,EUR,COMPLETED,586.78
CARD_PAYMENT,Current,2025-06-13 20:13:32,2025-06-14 16:37:46,IKEA,-15,0,EUR,COMPLETED,571.78
CARD_PAYMENT,Current,2025-06-14 23:24:36,,Amazon,-172.82,0,EUR,PENDING,
TRANSFER,Current,2025-06-14 23:24:36,2025-06-14 23:24:36,To EUR Savings,-0.18,0,EUR,COMPLETED,571.6
CARD_PAYMENT,Current,2025-06-14 08:11:55,2025-06-15 07:07:25,A Padaria Portuguesa,-2.5,0,EUR,COMPLETED,569.1
CARD_PAYMENT,Current,2025-06-15 07:18:40,,A Padaria Portuguesa,-2.5,0,EUR,PENDING,
TRANSFER,Current,2025-06-15 07:18:41,2025-06-15 07:18:41,To EUR Savings,-0.5,0,EUR,COMPLETED,568.6
TOPUP,Current,2025-06-15 07:19:02,2025-06-15 07:19:03,Apple Pay Top-Up by *0264,200,0,EUR,COMPLETED,768.6
CARD_PAYMENT,Current,2025-06-14 09:14:32,2025-06-15 09:02:59,Pingo Doce,-17.75,0,EUR,COMPLETED,750.85
CARD_PAYMENT,Current,2025-06-14 15:25:28,2025-06-15 09:03:11,Rest Pigmeu,-183.1,0,EUR,COMPLETED,567.75
CARD_PAYMENT,Current,2025-06-15 11:57:22,,Lenovo,-44.81,0,EUR,REVERTED,
TRANSFER,Current,2025-06-15 11:57:22,2025-06-15 11:57:22,To EUR Savings,-0.19,0,EUR,COMPLETED,567.56
CARD_PAYMENT,Current,2025-06-15 12:21:57,,Lenovo,-44.81,0,EUR,PENDING,
TRANSFER,Current,2025-06-15 12:21:58,2025-06-15 12:21:58,To EUR Savings,-0.19,0,EUR,COMPLETED,567.37
TRANSFER,Savings,2025-04-01 02:16:05,2025-04-01 02:16:05,To EUR Rainy day,50,0,EUR,COMPLETED,6913.5
TRANSFER,Savings,2025-04-02 12:15:41,2025-04-02 12:15:41,To EUR Savings,0.01,0,EUR,COMPLETED,6913.51
TRANSFER,Savings,2025-04-02 18:04:02,2025-04-02 18:04:02,To EUR Savings,1,0,EUR,COMPLETED,6914.51
TRANSFER,Savings,2025-04-03 12:01:21,2025-04-03 12:01:21,To EUR Savings,0.34,0,EUR,COMPLETED,6914.85
TRANSFER,Savings,2025-04-05 07:36:03,2025-04-05 07:36:03,To EUR Savings,0.17,0,EUR,COMPLETED,6915.02
TRANSFER,Savings,2025-04-05 07:59:22,2025-04-05 07:59:22,To EUR Savings,0.5,0,EUR,COMPLETED,6915.52
TRANSFER,Savings,2025-04-06 08:17:50,2025-04-06 08:17:50,To EUR Savings,0.5,0,EUR,COMPLETED,6916.02
TRANSFER,Savings,2025-04-06 09:41:05,2025-04-06 09:41:05,To EUR Savings,0.1,0,EUR,COMPLETED,6916.12
TRANSFER,Savings,2025-04-06 18:36:17,2025-04-06 18:36:17,To EUR Savings,0.09,0,EUR,COMPLETED,6916.21
TRANSFER,Savings,2025-04-07 02:50:05,2025-04-07 02:50:05,To EUR Savings,20,0,EUR,COMPLETED,6936.21
TRANSFER,Savings,2025-04-08 17:56:12,2025-04-08 17:56:12,To EUR Savings,0.23,0,EUR,COMPLETED,6936.44
TRANSFER,Savings,2025-04-09 12:42:10,2025-04-09 12:42:10,To EUR Savings,1,0,EUR,COMPLETED,6937.44
TRANSFER,Savings,2025-04-10 09:01:21,2025-04-10 09:01:21,To EUR Savings,0.4,0,EUR,COMPLETED,6937.84
TRANSFER,Savings,2025-04-10 12:07:08,2025-04-10 12:07:08,To EUR Savings,0.34,0,EUR,COMPLETED,6938.18
TRANSFER,Savings,2025-04-12 06:47:24,2025-04-12 06:47:24,To EUR Savings,0.4,0,EUR,COMPLETED,6938.58
TRANSFER,Savings,2025-04-12 07:01:41,2025-04-12 07:01:41,To EUR Savings,1,0,EUR,COMPLETED,6939.58
TRANSFER,Savings,2025-04-12 12:57:58,2025-04-12 12:57:58,To EUR Savings,0.1,0,EUR,COMPLETED,6939.68
TRANSFER,Savings,2025-04-12 21:50:29,2025-04-12 21:50:29,To EUR Savings,0.8,0,EUR,COMPLETED,6940.48
TRANSFER,Savings,2025-04-13 08:21:47,2025-04-13 08:21:47,To EUR Savings,0.3,0,EUR,COMPLETED,6940.78
TRANSFER,Savings,2025-04-13 13:18:13,2025-04-13 13:18:13,To EUR Savings,0.1,0,EUR,COMPLETED,6940.88
TRANSFER,Savings,2025-04-14 03:05:14,2025-04-14 03:05:14,To EUR Savings,20,0,EUR,COMPLETED,6960.88
TRANSFER,Savings,2025-04-14 14:29:12,2025-04-14 14:29:12,To EUR Savings,0.72,0,EUR,COMPLETED,6961.6
TRANSFER,Savings,2025-04-14 19:28:15,2025-04-14 19:28:15,To EUR Savings,0.47,0,EUR,COMPLETED,6962.07
TRANSFER,Savings,2025-04-15 08:10:11,2025-04-15 08:10:11,To EUR Savings,0.41,0,EUR,COMPLETED,6962.48
TRANSFER,Savings,2025-04-15 22:16:43,2025-04-15 22:16:43,To EUR Savings,1,0,EUR,COMPLETED,6963.48
TRANSFER,Savings,2025-04-16 11:01:27,2025-04-16 11:01:27,To EUR Savings,1,0,EUR,COMPLETED,6964.48
TRANSFER,Savings,2025-04-17 13:00:03,2025-04-17 13:00:03,To EUR Savings,0.34,0,EUR,COMPLETED,6964.82
TRANSFER,Savings,2025-04-18 08:17:41,2025-04-18 08:17:41,To EUR Savings,0.5,0,EUR,COMPLETED,6965.32
TRANSFER,Savings,2025-04-18 23:59:19,2025-04-18 23:59:19,To EUR Savings,0.01,0,EUR,COMPLETED,6965.33
TRANSFER,Savings,2025-04-19 08:35:44,2025-04-19 08:35:44,To EUR Savings,0.5,0,EUR,COMPLETED,6965.83
TRANSFER,Savings,2025-04-19 12:46:00,2025-04-19 12:46:00,To EUR Savings,0.34,0,EUR,COMPLETED,6966.17
TRANSFER,Savings,2025-04-19 17:07:36,2025-04-19 17:07:36,To EUR Savings,0.57,0,EUR,COMPLETED,6966.74
TRANSFER,Savings,2025-04-20 08:34:51,2025-04-20 08:34:51,To EUR Savings,0.5,0,EUR,COMPLETED,6967.24
TRANSFER,Savings,2025-04-20 09:41:23,2025-04-20 09:41:23,To EUR Savings,0.35,0,EUR,COMPLETED,6967.59
TRANSFER,Savings,2025-04-20 13:10:03,2025-04-20 13:10:03,To EUR Savings,0.01,0,EUR,COMPLETED,6967.6
TRANSFER,Savings,2025-04-21 02:47:15,2025-04-21 02:47:15,To EUR Savings,20,0,EUR,COMPLETED,6987.6
TRANSFER,Savings,2025-04-21 18:49:37,2025-04-21 18:49:37,To EUR Savings,1,0,EUR,COMPLETED,6988.6
TRANSFER,Savings,2025-04-22 15:01:04,2025-04-22 15:01:04,To EUR Savings,0.12,0,EUR,COMPLETED,6988.72
TRANSFER,Savings,2025-04-23 07:16:03,2025-04-23 07:16:03,To EUR Savings,0.8,0,EUR,COMPLETED,6989.52
TRANSFER,Savings,2025-04-23 07:23:52,2025-04-23 07:23:52,To EUR Savings,0.05,0,EUR,COMPLETED,6989.57
TRANSFER,Savings,2025-04-23 08:12:26,2025-04-23 08:12:26,To EUR Savings,0.01,0,EUR,COMPLETED,6989.58
TRANSFER,Savings,2025-04-23 13:23:23,2025-04-23 13:23:23,To EUR Savings,0.1,0,EUR,COMPLETED,6989.68
TRANSFER,Savings,2025-04-23 19:15:07,2025-04-23 19:15:07,To EUR Savings,0.24,0,EUR,COMPLETED,6989.92
TRANSFER,Savings,2025-04-23 20:04:06,2025-04-23 20:04:06,To EUR Savings,0.6,0,EUR,COMPLETED,6990.52
TRANSFER,Savings,2025-04-24 08:43:57,2025-04-24 08:43:57,To EUR Savings,0.3,0,EUR,COMPLETED,6990.82
TRANSFER,Savings,2025-04-24 09:04:29,2025-04-24 09:04:29,To EUR Savings,0.01,0,EUR,COMPLETED,6990.83
TRANSFER,Savings,2025-04-24 12:45:04,2025-04-24 12:45:04,To EUR Savings,0.8,0,EUR,COMPLETED,6991.63
TRANSFER,Savings,2025-04-24 19:51:00,2025-04-24 19:51:00,To EUR Savings,0.35,0,EUR,COMPLETED,6991.98
TRANSFER,Savings,2025-04-24 20:59:46,2025-04-24 20:59:46,To EUR Savings,0.1,0,EUR,COMPLETED,6992.08
TRANSFER,Savings,2025-04-25 09:13:28,2025-04-25 09:13:28,To EUR Savings,0.18,0,EUR,COMPLETED,6992.26
TRANSFER,Savings,2025-04-25 09:31:30,2025-04-25 09:31:30,To EUR Savings,1,0,EUR,COMPLETED,6993.26
TRANSFER,Savings,2025-04-25 09:51:32,2025-04-25 09:51:32,To EUR Savings,0.35,0,EUR,COMPLETED,6993.61
TRANSFER,Savings,2025-04-25 10:05:22,2025-04-25 10:05:22,To EUR Savings,1,0,EUR,COMPLETED,6994.61
TRANSFER,Savings,2025-04-25 10:55:12,2025-04-25 10:55:12,To EUR Savings,0.67,0,EUR,COMPLETED,6995.28
TRANSFER,Savings,2025-04-25 19:04:44,2025-04-25 19:04:44,To EUR Savings,0.48,0,EUR,COMPLETED,6995.76
TRANSFER,Savings,2025-04-25 20:16:28,2025-04-25 20:16:28,To EUR Savings,0.4,0,EUR,COMPLETED,6996.16
TRANSFER,Savings,2025-04-26 08:30:30,2025-04-26 08:30:30,To EUR Savings,0.3,0,EUR,COMPLETED,6996.46
TRANSFER,Savings,2025-04-26 09:50:34,2025-04-26 09:50:34,To EUR Savings,0.36,0,EUR,COMPLETED,6996.82
TRANSFER,Savings,2025-04-26 12:55:12,2025-04-26 12:55:12,To EUR Savings,0.85,0,EUR,COMPLETED,6997.67
TRANSFER,Savings,2025-04-26 18:16:39,2025-04-26 18:16:39,To EUR Savings,0.6,0,EUR,COMPLETED,6998.27
TRANSFER,Savings,2025-04-26 18:57:14,2025-04-26 18:57:14,To EUR Savings,0.33,0,EUR,COMPLETED,6998.6
TRANSFER,Savings,2025-04-27 03:21:59,2025-04-27 03:21:59,To EUR Savings,0.01,0,EUR,COMPLETED,6998.61
TRANSFER,Savings,2025-04-27 08:40:46,2025-04-27 08:40:46,To EUR Savings,0.55,0,EUR,COMPLETED,6999.16
TRANSFER,Savings,2025-04-27 20:15:10,2025-04-27 20:15:10,To EUR Savings,0.46,0,EUR,COMPLETED,6999.62
TRANSFER,Savings,2025-04-28 03:00:10,2025-04-28 03:00:10,To EUR Savings,20,0,EUR,COMPLETED,7019.62
TRANSFER,Savings,2025-04-28 09:09:36,2025-04-28 09:09:36,To EUR Savings,0.03,0,EUR,COMPLETED,7019.65
TRANSFER,Savings,2025-04-28 20:08:20,2025-04-28 20:08:20,To EUR Savings,0.77,0,EUR,COMPLETED,7020.42
TRANSFER,Savings,2025-04-29 05:53:21,2025-04-29 05:53:21,To EUR Savings,0.51,0,EUR,COMPLETED,7020.93
TRANSFER,Savings,2025-04-29 18:16:03,2025-04-29 18:16:03,To EUR Savings,1,0,EUR,COMPLETED,7021.93
TRANSFER,Savings,2025-04-30 02:53:35,2025-04-30 02:53:35,To EUR Savings,0.05,0,EUR,COMPLETED,7021.98
TRANSFER,Savings,2025-04-30 12:05:08,2025-04-30 12:05:08,To EUR Savings,0.44,0,EUR,COMPLETED,7022.42
TRANSFER,Savings,2025-05-01 02:27:35,2025-05-01 02:27:35,To EUR Rainy day,50,0,EUR,COMPLETED,7072.42
TRANSFER,Savings,2025-05-01 08:09:31,2025-05-01 08:09:31,To EUR Savings,0.5,0,EUR,COMPLETED,7072.92
TRANSFER,Savings,2025-05-01 12:51:04,2025-05-01 12:51:04,To EUR Savings,0.67,0,EUR,COMPLETED,7073.59
TRANSFER,Savings,2025-05-01 14:13:17,2025-05-01 14:13:17,To EUR Savings,0.6,0,EUR,COMPLETED,7074.19
TRANSFER,Savings,2025-05-01 16:15:43,2025-05-01 16:15:43,To EUR Savings,0.63,0,EUR,COMPLETED,7074.82
TRANSFER,Savings,2025-05-02 12:16:22,2025-05-02 12:16:22,To EUR Savings,0.01,0,EUR,COMPLETED,7074.83
TRANSFER,Savings,2025-05-03 08:38:24,2025-05-03 08:38:24,To EUR Savings,0.41,0,EUR,COMPLETED,7075.24
TRANSFER,Savings,2025-05-03 10:29:03,2025-05-03 10:29:03,To EUR Savings,0.8,0,EUR,COMPLETED,7076.04
TRANSFER,Savings,2025-05-03 18:25:31,2025-05-03 18:25:31,To EUR Savings,0.55,0,EUR,COMPLETED,7076.59
TRANSFER,Savings,2025-05-03 18:26:24,2025-05-03 18:26:24,To EUR Savings,1,0,EUR,COMPLETED,7077.59
TRANSFER,Savings,2025-05-04 08:33:35,2025-05-04 08:33:35,To EUR Savings,0.5,0,EUR,COMPLETED,7078.09
TRANSFER,Savings,2025-05-04 09:20:35,2025-05-04 09:20:35,To EUR Savings,0.52,0,EUR,COMPLETED,7078.61
TRANSFER,Savings,2025-05-04 14:52:02,2025-05-04 14:52:02,To EUR Savings,1,0,EUR,COMPLETED,7079.61
TRANSFER,Savings,2025-05-04 17:49:42,2025-05-04 17:49:42,To EUR Savings,0.4,0,EUR,COMPLETED,7080.01
TRANSFER,Savings,2025-05-05 03:04:50,2025-05-05 03:04:50,To EUR Savings,20,0,EUR,COMPLETED,7100.01
TRANSFER,Savings,2025-05-06 19:37:02,2025-05-06 19:37:02,To EUR Savings,0.69,0,EUR,COMPLETED,7100.7
TRANSFER,Savings,2025-05-08 12:00:51,2025-05-08 12:00:51,To EUR Savings,0.47,0,EUR,COMPLETED,7101.17
TRANSFER,Savings,2025-05-08 19:23:01,2025-05-08 19:23:01,To EUR Savings,0.71,0,EUR,COMPLETED,7101.88
TRANSFER,Savings,2025-05-09 08:16:46,2025-05-09 08:16:46,To EUR Savings,0.09,0,EUR,COMPLETED,7101.97
TRANSFER,Savings,2025-05-09 15:17:55,2025-05-09 15:17:55,To EUR Savings,0.64,0,EUR,COMPLETED,7102.61
TRANSFER,Savings,2025-05-10 03:38:13,2025-05-10 03:38:13,To EUR Savings,1,0,EUR,COMPLETED,7103.61
TRANSFER,Savings,2025-05-10 08:19:47,2025-05-10 08:19:47,To EUR Savings,0.5,0,EUR,COMPLETED,7104.11
TRANSFER,Savings,2025-05-10 17:17:36,2025-05-10 17:17:36,To EUR Savings,0.99,0,EUR,COMPLETED,7105.1
TRANSFER,Savings,2025-05-11 07:52:24,2025-05-11 07:52:24,To EUR Savings,0.5,0,EUR,COMPLETED,7105.6
TRANSFER,Savings,2025-05-11 12:43:35,2025-05-11 12:43:35,To EUR Savings,0.16,0,EUR,COMPLETED,7105.76
TRANSFER,Savings,2025-05-11 14:05:41,2025-05-11 14:05:41,To EUR Savings,0.61,0,EUR,COMPLETED,7106.37
TRANSFER,Savings,2025-05-11 21:14:01,2025-05-11 21:14:01,To EUR Savings,0.5,0,EUR,COMPLETED,7106.87
TRANSFER,Savings,2025-05-12 03:14:10,2025-05-12 03:14:10,To EUR Savings,20,0,EUR,COMPLETED,7126.87
TRANSFER,Savings,2025-05-12 07:53:04,2025-05-12 07:53:04,To EUR Savings,0.5,0,EUR,COMPLETED,7127.37
TRANSFER,Savings,2025-05-12 11:09:06,2025-05-12 11:09:06,To EUR Savings,0.4,0,EUR,COMPLETED,7127.77
TRANSFER,Savings,2025-05-12 11:30:10,2025-05-12 11:30:10,To EUR Savings,1,0,EUR,COMPLETED,7128.77
TRANSFER,Savings,2025-05-12 21:19:52,2025-05-12 21:19:52,To EUR Savings,0.9,0,EUR,COMPLETED,7129.67
TRANSFER,Savings,2025-05-13 10:14:36,2025-05-13 10:14:36,To EUR Savings,0.9,0,EUR,COMPLETED,7130.57
TRANSFER,Savings,2025-05-13 13:44:34,2025-05-13 13:44:34,To EUR Savings,0.4,0,EUR,COMPLETED,7130.97
TRANSFER,Savings,2025-05-13 13:55:41,2025-05-13 13:55:41,To EUR Savings,0.19,0,EUR,COMPLETED,7131.16
TRANSFER,Savings,2025-05-13 17:50:57,2025-05-13 17:50:57,To EUR Savings,1,0,EUR,COMPLETED,7132.16
TRANSFER,Savings,2025-05-13 21:09:15,2025-05-13 21:09:15,To EUR Savings,0.6,0,EUR,COMPLETED,7132.76
TRANSFER,Savings,2025-05-14 13:53:11,2025-05-14 13:53:11,To EUR Savings,0.7,0,EUR,COMPLETED,7133.46
TRANSFER,Savings,2025-05-14 14:07:42,2025-05-14 14:07:42,To EUR Savings,0.02,0,EUR,COMPLETED,7133.48
TRANSFER,Savings,2025-05-14 17:17:15,2025-05-14 17:17:15,To EUR Savings,0.13,0,EUR,COMPLETED,7133.61
TRANSFER,Savings,2025-05-14 17:50:35,2025-05-14 17:50:35,To EUR Savings,1,0,EUR,COMPLETED,7134.61
TRANSFER,Savings,2025-05-14 19:35:02,2025-05-14 19:35:02,To EUR Savings,0.8,0,EUR,COMPLETED,7135.41
TRANSFER,Savings,2025-05-15 15:34:23,2025-05-15 15:34:23,To EUR Savings,1,0,EUR,COMPLETED,7136.41
TRANSFER,Savings,2025-05-15 17:02:39,2025-05-15 17:02:39,To EUR Savings,1,0,EUR,COMPLETED,7137.41
TRANSFER,Savings,2025-05-15 17:57:51,2025-05-15 17:57:51,To EUR Savings,0.6,0,EUR,COMPLETED,7138.01
TRANSFER,Savings,2025-05-16 12:20:26,2025-05-16 12:20:26,To EUR Savings,0.5,0,EUR,COMPLETED,7138.51
TRANSFER,Savings,2025-05-16 19:43:05,2025-05-16 19:43:05,To EUR Savings,0.31,0,EUR,COMPLETED,7138.82
TRANSFER,Savings,2025-05-17 07:54:31,2025-05-17 07:54:31,To EUR Savings,0.5,0,EUR,COMPLETED,7139.32
TRANSFER,Savings,2025-05-17 09:42:41,2025-05-17 09:42:41,To EUR Savings,0.24,0,EUR,COMPLETED,7139.56
TRANSFER,Savings,2025-05-18 08:25:32,2025-05-18 08:25:32,To EUR Savings,0.5,0,EUR,COMPLETED,7140.06
TRANSFER,Savings,2025-05-18 09:03:26,2025-05-18 09:03:26,To EUR Savings,0.13,0,EUR,COMPLETED,7140.19
TRANSFER,Savings,2025-05-19 03:03:53,2025-05-19 03:03:53,To EUR Savings,20,0,EUR,COMPLETED,7160.19
TRANSFER,Savings,2025-05-19 07:46:35,2025-05-19 07:46:35,To EUR Savings,0.87,0,EUR,COMPLETED,7161.06
TRANSFER,Savings,2025-05-19 07:50:51,2025-05-19 07:50:51,To EUR Savings,0.87,0,EUR,COMPLETED,7161.93
TRANSFER,Savings,2025-05-19 08:22:20,2025-05-19 08:22:20,To EUR Savings,0.26,0,EUR,COMPLETED,7162.19
TRANSFER,Savings,2025-05-19 11:15:32,2025-05-19 11:15:32,To EUR Savings,0.52,0,EUR,COMPLETED,7162.71
TRANSFER,Savings,2025-05-20 13:10:03,2025-05-20 13:10:03,To EUR Savings,0.01,0,EUR,COMPLETED,7162.72
TRANSFER,Savings,2025-05-20 15:38:08,2025-05-20 15:38:08,To EUR Savings,0.05,0,EUR,COMPLETED,7162.77
TRANSFER,Savings,2025-05-21 09:01:40,2025-05-21 09:01:40,To EUR Savings,0.85,0,EUR,COMPLETED,7163.62
TRANSFER,Savings,2025-05-21 17:37:48,2025-05-21 17:37:48,To EUR Savings,0.83,0,EUR,COMPLETED,7164.45
TRANSFER,Savings,2025-05-22 12:47:37,2025-05-22 12:47:37,To EUR Savings,0.6,0,EUR,COMPLETED,7165.05
TRANSFER,Savings,2025-05-23 08:12:26,2025-05-23 08:12:26,To EUR Savings,0.01,0,EUR,COMPLETED,7165.06
TRANSFER,Savings,2025-05-23 20:13:23,2025-05-23 20:13:23,To EUR Savings,1,0,EUR,COMPLETED,7166.06
TRANSFER,Savings,2025-05-24 08:17:40,2025-05-24 08:17:40,To EUR Savings,0.5,0,EUR,COMPLETED,7166.56
TRANSFER,Savings,2025-05-24 10:23:44,2025-05-24 10:23:44,To EUR Savings,0.01,0,EUR,COMPLETED,7166.57
TRANSFER,Savings,2025-05-24 12:28:10,2025-05-24 12:28:10,To EUR Savings,0.78,0,EUR,COMPLETED,7167.35
TRANSFER,Savings,2025-05-24 17:13:13,2025-05-24 17:13:13,To EUR Savings,0.26,0,EUR,COMPLETED,7167.61
TRANSFER,Savings,2025-05-25 07:14:15,2025-05-25 07:14:15,To EUR Savings,0.5,0,EUR,COMPLETED,7168.11
TRANSFER,Savings,2025-05-25 08:14:48,2025-05-25 08:14:48,To EUR Savings,0.33,0,EUR,COMPLETED,7168.44
TRANSFER,Savings,2025-05-25 09:16:42,2025-05-25 09:16:42,To EUR Savings,0.95,0,EUR,COMPLETED,7169.39
TRANSFER,Savings,2025-05-26 03:01:51,2025-05-26 03:01:51,To EUR Savings,20,0,EUR,COMPLETED,7189.39
TRANSFER,Savings,2025-05-26 11:16:42,2025-05-26 11:16:42,To EUR Savings,0.86,0,EUR,COMPLETED,7190.25
TRANSFER,Savings,2025-05-26 12:40:25,2025-05-26 12:40:25,To EUR Savings,0.14,0,EUR,COMPLETED,7190.39
TRANSFER,Savings,2025-05-26 15:31:56,2025-05-26 15:31:56,To EUR Savings,0.86,0,EUR,COMPLETED,7191.25
TRANSFER,Savings,2025-05-27 02:13:43,2025-05-27 02:13:43,To EUR Savings,0.01,0,EUR,COMPLETED,7191.26
TRANSFER,Savings,2025-05-27 17:28:13,2025-05-27 17:28:13,To EUR Savings,0.74,0,EUR,COMPLETED,7192
TRANSFER,Savings,2025-05-29 05:52:28,2025-05-29 05:52:28,To EUR Savings,0.51,0,EUR,COMPLETED,7192.51
TRANSFER,Savings,2025-05-29 12:29:42,2025-05-29 12:29:42,To EUR Savings,0.05,0,EUR,COMPLETED,7192.56
TRANSFER,Savings,2025-05-29 12:31:31,2025-05-29 12:31:31,To EUR Savings,0.44,0,EUR,COMPLETED,7193
TRANSFER,Savings,2025-05-29 14:18:49,2025-05-29 14:18:49,To EUR Savings,0.29,0,EUR,COMPLETED,7193.29
TRANSFER,Savings,2025-05-29 17:40:44,2025-05-29 17:40:44,To EUR Savings,1,0,EUR,COMPLETED,7194.29
TRANSFER,Savings,2025-05-30 02:55:33,2025-05-30 02:55:33,To EUR Savings,0.05,0,EUR,COMPLETED,7194.34
TRANSFER,Savings,2025-05-31 07:58:08,2025-05-31 07:58:08,To EUR Savings,1,0,EUR,COMPLETED,7195.34
TRANSFER,Savings,2025-05-31 09:08:42,2025-05-31 09:08:42,To EUR Savings,0.3,0,EUR,COMPLETED,7195.64
TRANSFER,Savings,2025-05-31 10:44:01,2025-05-31 10:44:01,To EUR Savings,0.52,0,EUR,COMPLETED,7196.16
TRANSFER,Savings,2025-05-31 20:07:22,2025-05-31 20:07:22,To EUR Savings,0.15,0,EUR,COMPLETED,7196.31
TRANSFER,Savings,2025-06-01 02:25:27,2025-06-01 02:25:27,To EUR Rainy day,50,0,EUR,COMPLETED,7246.31
TRANSFER,Savings,2025-06-01 07:43:36,2025-06-01 07:43:36,To EUR Savings,0.5,0,EUR,COMPLETED,7246.81
TRANSFER,Savings,2025-06-01 08:18:53,2025-06-01 08:18:53,To EUR Savings,0.72,0,EUR,COMPLETED,7247.53
TRANSFER,Savings,2025-06-01 12:41:23,2025-06-01 12:41:23,To EUR Savings,1,0,EUR,COMPLETED,7248.53
TRANSFER,Savings,2025-06-01 12:52:48,2025-06-01 12:52:48,To EUR Savings,0.6,0,EUR,COMPLETED,7249.13
TRANSFER,Savings,2025-06-01 13:31:58,2025-06-01 13:31:58,To EUR Savings,0.7,0,EUR,COMPLETED,7249.83
TRANSFER,Savings,2025-06-02 03:00:40,2025-06-02 03:00:40,To EUR Savings,20,0,EUR,COMPLETED,7269.83
TRANSFER,Savings,2025-06-02 12:16:13,2025-06-02 12:16:13,To EUR Savings,0.01,0,EUR,COMPLETED,7269.84
TRANSFER,Savings,2025-06-02 15:57:50,2025-06-02 15:57:50,To EUR Savings,1,0,EUR,COMPLETED,7270.84
TRANSFER,Savings,2025-06-04 12:34:48,2025-06-04 12:34:48,To EUR Savings,0.78,0,EUR,COMPLETED,7271.62
TRANSFER,Savings,2025-06-04 13:42:04,2025-06-04 13:42:04,To EUR Savings,1,0,EUR,COMPLETED,7272.62
TRANSFER,Savings,2025-06-04 16:40:12,2025-06-04 16:40:12,To EUR Savings,0.41,0,EUR,COMPLETED,7273.03
TRANSFER,Savings,2025-06-05 12:02:47,2025-06-05 12:02:47,To EUR Savings,0.34,0,EUR,COMPLETED,7273.37
TRANSFER,Savings,2025-06-05 12:27:28,2025-06-05 12:27:28,To EUR Savings,0.41,0,EUR,COMPLETED,7273.78
TRANSFER,Savings,2025-06-05 12:48:45,2025-06-05 12:48:45,To EUR Savings,0.48,0,EUR,COMPLETED,7274.26
TRANSFER,Savings,2025-06-05 16:00:51,2025-06-05 16:00:51,To EUR Savings,1,0,EUR,COMPLETED,7275.26
TRANSFER,Savings,2025-06-06 19:02:58,2025-06-06 19:02:58,To EUR Savings,0.62,0,EUR,COMPLETED,7275.88
TRANSFER,Savings,2025-06-06 20:08:57,2025-06-06 20:08:57,To EUR Savings,0.03,0,EUR,COMPLETED,7275.91
TRANSFER,Savings,2025-06-07 07:19:41,2025-06-07 07:19:41,To EUR Savings,0.5,0,EUR,COMPLETED,7276.41
TRANSFER,Savings,2025-06-07 14:10:09,2025-06-07 14:10:09,To EUR Savings,0.5,0,EUR,COMPLETED,7276.91
TRANSFER,Savings,2025-06-08 08:31:56,2025-06-08 08:31:56,To EUR Savings,0.5,0,EUR,COMPLETED,7277.41
TRANSFER,Savings,2025-06-08 13:46:18,2025-06-08 13:46:18,To EUR Savings,0.65,0,EUR,COMPLETED,7278.06
TRANSFER,Savings,2025-06-08 15:29:27,2025-06-08 15:29:27,To EUR Savings,0.41,0,EUR,COMPLETED,7278.47
TRANSFER,Savings,2025-06-08 23:21:35,2025-06-08 23:21:35,To EUR Savings,0.02,0,EUR,COMPLETED,7278.49
TRANSFER,Savings,2025-06-09 02:59:19,2025-06-09 02:59:19,To EUR Savings,20,0,EUR,COMPLETED,7298.49
TRANSFER,Savings,2025-06-09 12:34:08,2025-06-09 12:34:08,To EUR Savings,0.65,0,EUR,COMPLETED,7299.14
TRANSFER,Savings,2025-06-09 21:16:57,2025-06-09 21:16:57,To EUR Savings,0.02,0,EUR,COMPLETED,7299.16
TRANSFER,Savings,2025-06-10 15:14:48,2025-06-10 15:14:48,To EUR Savings,0.43,0,EUR,COMPLETED,7299.59
TRANSFER,Savings,2025-06-11 16:15:51,2025-06-11 16:15:51,To EUR Savings,0.03,0,EUR,COMPLETED,7299.62
TRANSFER,Savings,2025-06-11 21:40:10,2025-06-11 21:40:10,To EUR Savings,0.16,0,EUR,COMPLETED,7299.78
TRANSFER,Savings,2025-06-11 23:07:29,2025-06-11 23:07:29,To EUR Savings,0.16,0,EUR,COMPLETED,7299.94
TRANSFER,Savings,2025-06-12 12:06:51,2025-06-12 12:06:51,To EUR Savings,0.17,0,EUR,COMPLETED,7300.11
TRANSFER,Savings,2025-06-12 12:07:00,2025-06-12 12:07:00,To EUR Savings,1,0,EUR,COMPLETED,7301.11
TRANSFER,Savings,2025-06-12 12:11:19,2025-06-12 12:11:19,To EUR Savings,0.7,0,EUR,COMPLETED,7301.81
TRANSFER,Savings,2025-06-12 13:54:52,2025-06-12 13:54:52,To EUR Savings,0.85,0,EUR,COMPLETED,7302.66
TRANSFER,Savings,2025-06-12 18:01:50,2025-06-12 18:01:50,To EUR Savings,0.9,0,EUR,COMPLETED,7303.56
TRANSFER,Savings,2025-06-13 08:59:23,2025-06-13 08:59:23,To EUR Savings,0.5,0,EUR,COMPLETED,7304.06
TRANSFER,Savings,2025-06-13 12:40:18,2025-06-13 12:40:18,To EUR Savings,0.91,0,EUR,COMPLETED,7304.97
TRANSFER,Savings,2025-06-13 16:09:20,2025-06-13 16:09:20,To EUR Savings,0.69,0,EUR,COMPLETED,7305.66
TRANSFER,Savings,2025-06-13 20:13:33,2025-06-13 20:13:33,To EUR Savings,1,0,EUR,COMPLETED,7306.66
TRANSFER,Savings,2025-06-14 08:11:55,2025-06-14 08:11:55,To EUR Savings,0.5,0,EUR,COMPLETED,7307.16
TRANSFER,Savings,2025-06-14 09:20:27,2025-06-14 09:20:27,To EUR Savings,0.25,0,EUR,COMPLETED,7307.41
TRANSFER,Savings,2025-06-14 15:25:29,2025-06-14 15:25:29,To EUR Savings,0.9,0,EUR,COMPLETED,7308.31
TRANSFER,Savings,2025-06-14 23:24:36,2025-06-14 23:24:36,To EUR Savings,0.18,0,EUR,COMPLETED,7308.49
TRANSFER,Savings,2025-06-15 07:18:41,2025-06-15 07:18:41,To EUR Savings,0.5,0,EUR,COMPLETED,7308.99
TRANSFER,Savings,2025-06-15 11:57:22,2025-06-15 11:57:22,To EUR Savings,0.19,0,EUR,COMPLETED,7309.18
TRANSFER,Savings,2025-06-15 12:21:58,2025-06-15 12:21:58,To EUR Savings,0.19,0,EUR,COMPLETED,7309.37