Type,Product,Started Date,Completed Date,Description,Amount,Fee,Currency,State,Balance
Transfer,Savings,2025-05-01 02:27:35,2025-05-01 02:27:35,To pocket EUR Rainy day from EUR,50,0,EUR,COMPLETED,7072.42
Transfer,Savings,2025-05-01 08:09:31,2025-05-01 08:09:31,To pocket EUR Savings from EUR,0.5,0,EUR,COMPLETED,7072.92
Transfer,Savings,2025-05-01 12:51:04,2025-05-01 12:51:04,To pocket EUR Savings from EUR,0.67,0,EUR,COMPLETED,7073.59
Transfer,Savings,2025-05-01 14:13:17,2025-05-01 14:13:17,To pocket EUR Savings from EUR,0.6,0,EUR,COMPLETED,7074.19
Transfer,Savings,2025-05-01 16:15:43,2025-05-01 16:15:43,To pocket EUR Savings from EUR,0.63,0,EUR,COMPLETED,7074.82
Transfer,Savings,2025-05-02 12:16:22,2025-05-02 12:16:22,To pocket EUR Savings from EUR,0.01,0,EUR,COMPLETED,7074.83
Transfer,Savings,2025-05-03 08:38:24,2025-05-03 08:38:24,To pocket EUR Savings from EUR,0.41,0,EUR,COMPLETED,7075.24
Transfer,Savings,2025-05-03 10:29:03,2025-05-03 10:29:03,To pocket EUR Savings from EUR,0.8,0,EUR,COMPLETED,7076.04
Transfer,Savings,2025-05-03 18:25:31,2025-05-03 18:25:31,To pocket EUR Savings from EUR,0.55,0,EUR,COMPLETED,7076.59
Transfer,Savings,2025-05-03 18:26:24,2025-05-03 18:26:24,To pocket EUR Savings from EUR,1,0,EUR,COMPLETED,7077.59
Transfer,Savings,2025-05-04 08:33:35,2025-05-04 08:33:35,To pocket EUR Savings from EUR,0.5,0,EUR,COMPLETED,7078.09
Transfer,Savings,2025-05-04 09:20:35,2025-05-04 09:20:35,To pocket EUR Savings from EUR,0.52,0,EUR,COMPLETED,7078.61
Transfer,Savings,2025-05-04 14:52:02,2025-05-04 14:52:02,To pocket EUR Savings from EUR,1,0,EUR,COMPLETED,7079.61
Transfer,Savings,2025-05-04 17:49:42,2025-05-04 17:49:42,To pocket EUR Savings from EUR,0.4,0,EUR,COMPLETED,7080.01
Transfer,Savings,2025-05-05 03:04:50,2025-05-05 03:04:50,To pocket EUR Savings from EUR,20,0,EUR,COMPLETED,7100.01
Transfer,Savings,2025-05-06 19:37:02,2025-05-06 19:37:02,To pocket EUR Savings from EUR,0.69,0,EUR,COMPLETED,7100.7
Transfer,Savings,2025-05-08 12:00:51,2025-05-08 12:00:51,To pocket EUR Savings from EUR,0.47,0,EUR,COMPLETED,7101.17
Transfer,Savings,2025-05-08 19:23:01,2025-05-08 19:23:01,To pocket EUR Savings from EUR,0.71,0,EUR,COMPLETED,7101.88
Transfer,Savings,2025-05-09 08:16:46,2025-05-09 08:16:46,To pocket EUR Savings from EUR,0.09,0,EUR,COMPLETED,7101.97
Transfer,Savings,2025-05-09 15:17:55,2025-05-09 15:17:55,To pocket EUR Savings from EUR,0.64,0,EUR,COMPLETED,7102.61
Transfer,Savings,2025-05-10 03:38:13,2025-05-10 03:38:13,To pocket EUR Savings from EUR,1,0,EUR,COMPLETED,7103.61
Transfer,Savings,2025-05-10 08:19:47,2025-05-10 08:19:47,To pocket EUR Savings from EUR,0.5,0,EUR,COMPLETED,7104.11
Transfer,Savings,2025-05-10 17:17:36,2025-05-10 17:17:36,To pocket EUR Savings from EUR,0.99,0,EUR,COMPLETED,7105.1
Transfer,Savings,2025-05-11 07:52:24,2025-05-11 07:52:24,To pocket EUR Savings from EUR,0.5,0,EUR,COMPLETED,7105.6
Transfer,Savings,2025-05-11 12:43:35,2025-05-11 12:43:35,To pocket EUR Savings from EUR,0.16,0,EUR,COMPLETED,7105.76
Transfer,Savings,2025-05-11 14:05:41,2025-05-11 14:05:41,To pocket EUR Savings from EUR,0.61,0,EUR,COMPLETED,7106.37
Transfer,Savings,2025-05-11 21:14:01,2025-05-11 21:14:01,To pocket EUR Savings from EUR,0.5,0,EUR,COMPLETED,7106.87
Transfer,Savings,2025-05-12 03:14:10,2025-05-12 03:14:10,To pocket EUR Savings from EUR,20,0,EUR,COMPLETED,7126.87
Transfer,Savings,2025-05-12 07:53:04,2025-05-12 07:53:04,To pocket EUR Savings from EUR,0.5,0,EUR,COMPLETED,7127.37
Transfer,Savings,2025-05-12 11:09:06,2025-05-12 11:09:06,To pocket EUR Savings from EUR,0.4,0,EUR,COMPLETED,7127.77
Transfer,Savings,2025-05-12 11:30:10,2025-05-12 11:30:10,To pocket EUR Savings from EUR,1,0,EUR,COMPLETED,7128.77
Transfer,Savings,2025-05-12 21:19:52,2025-05-12 21:19:52,To pocket EUR Savings from EUR,0.9,0,EUR,COMPLETED,7129.67
Transfer,Savings,2025-05-13 10:14:36,2025-05-13 10:14:36,To pocket EUR Savings from EUR,0.9,0,EUR,COMPLETED,7130.57
Transfer,Savings,2025-05-13 13:44:34,2025-05-13 13:44:34,To pocket EUR Savings from EUR,0.4,0,EUR,COMPLETED,7130.97
Transfer,Savings,2025-05-13 13:55:41,2025-05-13 13:55:41,To pocket EUR Savings from EUR,0.19,0,EUR,COMPLETED,7131.16
Transfer,Savings,2025-05-13 17:50:57,2025-05-13 17:50:57,To pocket EUR Savings from EUR,1,0,EUR,COMPLETED,7132.16
Transfer,Savings,2025-05-13 21:09:15,2025-05-13 21:09:15,To pocket EUR Savings from EUR,0.6,0,EUR,COMPLETED,7132.76
Transfer,Savings,2025-05-14 13:53:11,2025-05-14 13:53:11,To pocket EUR Savings from EUR,0.7,0,EUR,COMPLETED,7133.46
Transfer,Savings,2025-05-14 14:07:42,2025-05-14 14:07:42,To pocket EUR Savings from EUR,0.02,0,EUR,COMPLETED,7133.48
Transfer,Savings,2025-05-14 17:17:15,2025-05-14 17:17:15,To pocket EUR Savings from EUR,0.13,0,EUR,COMPLETED,7133.61
Transfer,Savings,2025-05-14 17:50:35,2025-05-14 17:50:35,To pocket EUR Savings from EUR,1,0,EUR,COMPLETED,7134.61
Transfer,Savings,2025-05-14 19:35:02,2025-05-14 19:35:02,To pocket EUR Savings from EUR,0.8,0,EUR,COMPLETED,7135.41
Transfer,Savings,2025-05-15 15:34:23,2025-05-15 15:34:23,To pocket EUR Savings from EUR,1,0,EUR,COMPLETED,7136.41
Transfer,Savings,2025-05-15 17:02:39,2025-05-15 17:02:39,To pocket EUR Savings from EUR,1,0,EUR,COMPLETED,7137.41
Transfer,Savings,2025-05-15 17:57:51,2025-05-15 17:57:51,To pocket EUR Savings from EUR,0.6,0,EUR,COMPLETED,7138.01
Transfer,Savings,2025-05-16 12:20:26,2025-05-16 12:20:26,To pocket EUR Savings from EUR,0.5,0,EUR,COMPLETED,7138.51
Transfer,Savings,2025-05-16 19:43:05,2025-05-16 19:43:05,To pocket EUR Savings from EUR,0.31,0,EUR,COMPLETED,7138.82
Transfer,Savings,2025-05-17 07:54:31,2025-05-17 07:54:31,To pocket EUR Savings from EUR,0.5,0,EUR,COMPLETED,7139.32
Transfer,Savings,2025-05-17 09:42:41,2025-05-17 09:42:41,To pocket EUR Savings from EUR,0.24,0,EUR,COMPLETED,7139.56
Transfer,Savings,2025-05-18 08:25:32,2025-05-18 08:25:32,To pocket EUR Savings from EUR,0.5,0,EUR,COMPLETED,7140.06
Transfer,Savings,2025-05-18 09:03:26,2025-05-18 09:03:26,To pocket EUR Savings from EUR,0.13,0,EUR,COMPLETED,7140.19
Transfer,Savings,2025-05-19 03:03:53,2025-05-19 03:03:53,To pocket EUR Savings from EUR,20,0,EUR,COMPLETED,7160.19
Transfer,Savings,2025-05-19 07:46:35,2025-05-19 07:46:35,To pocket EUR Savings from EUR,0.87,0,EUR,COMPLETED,7161.06
Transfer,Savings,2025-05-19 07:50:51,2025-05-19 07:50:51,To pocket EUR Savings from EUR,0.87,0,EUR,COMPLETED,7161.93
Transfer,Savings,2025-05-19 08:22:20,2025-05-19 08:22:20,To pocket EUR Savings from EUR,0.26,0,EUR,COMPLETED,7162.19
Transfer,Savings,2025-05-19 11:15:32,2025-05-19 11:15:32,To pocket EUR Savings from EUR,0.52,0,EUR,COMPLETED,7162.71
Transfer,Savings,2025-05-20 13:10:03,2025-05-20 13:10:03,To pocket EUR Savings from EUR,0.01,0,EUR,COMPLETED,7162.72
Transfer,Savings,2025-05-20 15:38:08,2025-05-20 15:38:08,To pocket EUR Savings from EUR,0.05,0,EUR,COMPLETED,7162.77
Transfer,Savings,2025-05-21 09:01:40,2025-05-21 09:01:40,To pocket EUR Savings from EUR,0.85,0,EUR,COMPLETED,7163.62
Transfer,Savings,2025-05-21 17:37:48,2025-05-21 17:37:48,To pocket EUR Savings from EUR,0.83,0,EUR,COMPLETED,7164.45
Transfer,Savings,2025-05-22 12:47:37,2025-05-22 12:47:37,To pocket EUR Savings from EUR,0.6,0,EUR,COMPLETED,7165.05
Transfer,Savings,2025-05-23 08:12:26,2025-05-23 08:12:26,To pocket EUR Savings from EUR,0.01,0,EUR,COMPLETED,7165.06
Transfer,Savings,2025-05-23 20:13:23,2025-05-23 20:13:23,To pocket EUR Savings from EUR,1,0,EUR,COMPLETED,7166.06
Transfer,Savings,2025-05-24 08:17:40,2025-05-24 08:17:40,To pocket EUR Savings from EUR,0.5,0,EUR,COMPLETED,7166.56
Transfer,Savings,2025-05-24 10:23:44,2025-05-24 10:23:44,To pocket EUR Savings from EUR,0.01,0,EUR,COMPLETED,7166.57
Transfer,Savings,2025-05-24 12:28:10,2025-05-24 12:28:10,To pocket EUR Savings from EUR,0.78,0,EUR,COMPLETED,7167.35
Transfer,Savings,2025-05-24 17:13:13,2025-05-24 17:13:13,To pocket EUR Savings from EUR,0.26,0,EUR,COMPLETED,7167.61
Transfer,Savings,2025-05-25 07:14:15,2025-05-25 07:14:15,To pocket EUR Savings from EUR,0.5,0,EUR,COMPLETED,7168.11
Transfer,Savings,2025-05-25 08:14:48,2025-05-25 08:14:48,To pocket EUR Savings from EUR,0.33,0,EUR,COMPLETED,7168.44
Transfer,Savings,2025-05-25 09:16:42,2025-05-25 09:16:42,To pocket EUR Savings from EUR,0.95,0,EUR,COMPLETED,7169.39
Transfer,Savings,2025-05-26 03:01:51,2025-05-26 03:01:51,To pocket EUR Savings from EUR,20,0,EUR,COMPLETED,7189.39
Transfer,Savings,2025-05-26 11:16:42,2025-05-26 11:16:42,To pocket EUR Savings from EUR,0.86,0,EUR,COMPLETED,7190.25
Transfer,Savings,2025-05-26 12:40:25,2025-05-26 12:40:25,To pocket EUR Savings from EUR,0.14,0,EUR,COMPLETED,7190.39
Transfer,Savings,2025-05-26 15:31:56,2025-05-26 15:31:56,To pocket EUR Savings from EUR,0.86,0,EUR,COMPLETED,7191.25
Transfer,Savings,2025-05-27 02:13:43,2025-05-27 02:13:43,To pocket EUR Savings from EUR,0.01,0,EUR,COMPLETED,7191.26
Transfer,Savings,2025-05-27 17:28:13,2025-05-27 17:28:13,To pocket EUR Savings from EUR,0.74,0,EUR,COMPLETED,7192
Transfer,Savings,2025-05-29 05:52:28,2025-05-29 05:52:28,To pocket EUR Savings from EUR,0.51,0,EUR,COMPLETED,7192.51
Transfer,Savings,2025-05-29 12:29:42,2025-05-29 12:29:42,To pocket EUR Savings from EUR,0.05,0,EUR,COMPLETED,7192.56
Transfer,Savings,2025-05-29 12:31:31,2025-05-29 12:31:31,To pocket EUR Savings from EUR,0.44,0,EUR,COMPLETED,7193
Transfer,Savings,2025-05-29 14:18:49,2025-05-29 14:18:49,To pocket EUR Savings from EUR,0.29,0,EUR,COMPLETED,7193.29
Transfer,Savings,2025-05-29 17:40:44,2025-05-29 17:40:44,To pocket EUR Savings from EUR,1,0,EUR,COMPLETED,7194.29
Transfer,Savings,2025-05-30 02:55:33,2025-05-30 02:55:33,To pocket EUR Savings from EUR,0.05,0,EUR,COMPLETED,7194.34
Transfer,Savings,2025-05-31 07:58:08,2025-05-31 07:58:08,To pocket EUR Savings from EUR,1,0,EUR,COMPLETED,7195.34
Transfer,Savings,2025-05-31 09:08:42,2025-05-31 09:08:42,To pocket EUR Savings from EUR,0.3,0,EUR,COMPLETED,7195.64
Transfer,Savings,2025-05-31 10:44:01,2025-05-31 10:44:01,To pocket EUR Savings from EUR,0.52,0,EUR,COMPLETED,7196.16
Transfer,Savings,2025-05-31 20:07:22,2025-05-31 20:07:22,To pocket EUR Savings from EUR,0.15,0,EUR,COMPLETED,7196.31
Transfer,Savings,2025-06-01 02:25:27,2025-06-01 02:25:27,To pocket EUR Rainy day from EUR,50,0,EUR,COMPLETED,7246.31
Transfer,Savings,2025-06-01 07:43:36,2025-06-01 07:43:36,To pocket EUR Savings from EUR,0.5,0,EUR,COMPLETED,7246.81
Transfer,Savings,2025-06-01 08:18:53,2025-06-01 08:18:53,To pocket EUR Savings from EUR,0.72,0,EUR,COMPLETED,7247.53
Transfer,Savings,2025-06-01 12:41:23,2025-06-01 12:41:23,To pocket EUR Savings from EUR,1,0,EUR,COMPLETED,7248.53
Transfer,Savings,2025-06-01 12:52:48,2025-06-01 12:52:48,To pocket EUR Savings from EUR,0.6,0,EUR,COMPLETED,7249.13
Transfer,Savings,2025-06-01 13:31:58,2025-06-01 13:31:58,To pocket EUR Savings from EUR,0.7,0,EUR,COMPLETED,7249.83
Transfer,Savings,2025-06-02 03:00:40,2025-06-02 03:00:40,To pocket EUR Savings from EUR,20,0,EUR,COMPLETED,7269.83
Transfer,Savings,2025-06-02 12:16:13,2025-06-02 12:16:13,To pocket EUR Savings from EUR,0.01,0,EUR,COMPLETED,7269.84
Transfer,Savings,2025-06-02 15:57:50,2025-06-02 15:57:50,To pocket EUR Savings from EUR,1,0,EUR,COMPLETED,7270.84
Transfer,Savings,2025-06-04 12:34:48,2025-06-04 12:34:48,To pocket EUR Savings from EUR,0.78,0,EUR,COMPLETED,7271.62
Transfer,Savings,2025-06-04 13:42:04,2025-06-04 13:42:04,To pocket EUR Savings from EUR,1,0,EUR,COMPLETED,7272.62
Transfer,Savings,2025-06-04 16:40:12,2025-06-04 16:40:12,To pocket EUR Savings from EUR,0.41,0,EUR,COMPLETED,7273.03
Transfer,Savings,2025-06-05 12:02:47,2025-06-05 12:02:47,To pocket EUR Savings from EUR,0.34,0,EUR,COMPLETED,7273.37
Transfer,Savings,2025-06-05 12:27:28,2025-06-05 12:27:28,To pocket EUR Savings from EUR,0.41,0,EUR,COMPLETED,7273.78
Transfer,Savings,2025-06-05 12:48:45,2025-06-05 12:48:45,To pocket EUR Savings from EUR,0.48,0,EUR,COMPLETED,7274.26
Transfer,Savings,2025-06-05 16:00:51,2025-06-05 16:00:51,To pocket EUR Savings from EUR,1,0,EUR,COMPLETED,7275.26
Transfer,Savings,2025-06-06 19:02:58,2025-06-06 19:02:58,To pocket EUR Savings from EUR,0.62,0,EUR,COMPLETED,7275.88
Transfer,Savings,2025-06-06 20:08:57,2025-06-06 20:08:57,To pocket EUR Savings from EUR,0.03,0,EUR,COMPLETED,7275.91
Transfer,Savings,2025-06-07 07:19:41,2025-06-07 07:19:41,To pocket EUR Savings from EUR,0.5,0,EUR,COMPLETED,7276.41
Transfer,Savings,2025-06-07 14:10:09,2025-06-07 14:10:09,To pocket EUR Savings from EUR,0.5,0,EUR,COMPLETED,7276.91
Transfer,Savings,2025-06-08 08:31:56,2025-06-08 08:31:56,To pocket EUR Savings from EUR,0.5,0,EUR,COMPLETED,7277.41
Transfer,Savings,2025-06-08 13:46:18,2025-06-08 13:46:18,To pocket EUR Savings from EUR,0.65,0,EUR,COMPLETED,7278.06
Transfer,Savings,2025-06-08 15:29:27,2025-06-08 15:29:27,To pocket EUR Savings from EUR,0.41,0,EUR,COMPLETED,7278.47
Transfer,Savings,2025-06-08 23:21:35,2025-06-08 23:21:35,To pocket EUR Savings from EUR,0.02,0,EUR,COMPLETED,7278.49
Transfer,Savings,2025-06-09 02:59:19,2025-06-09 02:59:19,To pocket EUR Savings from EUR,20,0,EUR,COMPLETED,7298.49
Transfer,Savings,2025-06-09 12:34:08,2025-06-09 12:34:08,To pocket EUR Savings from EUR,0.65,0,EUR,COMPLETED,7299.14
Transfer,Savings,2025-06-09 21:16:57,2025-06-09 21:16:57,To pocket EUR Savings from EUR,0.02,0,EUR,COMPLETED,7299.16
Transfer,Savings,2025-06-10 15:14:48,2025-06-10 15:14:48,To pocket EUR Savings from EUR,0.43,0,EUR,COMPLETED,7299.59
Transfer,Savings,2025-06-11 16:15:51,2025-06-11 16:15:51,To pocket EUR Savings from EUR,0.03,0,EUR,COMPLETED,7299.62
Transfer,Savings,2025-06-11 21:40:10,2025-06-11 21:40:10,To pocket EUR Savings from EUR,0.16,0,EUR,COMPLETED,7299.78
Transfer,Savings,2025-06-11 23:07:29,2025-06-11 23:07:29,To pocket EUR Savings from EUR,0.16,0,EUR,COMPLETED,7299.94
Transfer,Savings,2025-06-12 12:06:51,2025-06-12 12:06:51,To pocket EUR Savings from EUR,0.17,0,EUR,COMPLETED,7300.11
Transfer,Savings,2025-06-12 12:07:00,2025-06-12 12:07:00,To pocket EUR Savings from EUR,1,0,EUR,COMPLETED,7301.11
Transfer,Savings,2025-06-12 12:11:19,2025-06-12 12:11:19,To pocket EUR Savings from EUR,0.7,0,EUR,COMPLETED,7301.81
Transfer,Savings,2025-06-12 13:54:52,2025-06-12 13:54:52,To pocket EUR Savings from EUR,0.85,0,EUR,COMPLETED,7302.66
Transfer,Savings,2025-06-12 18:01:50,2025-06-12 18:01:50,To pocket EUR Savings from EUR,0.9,0,EUR,COMPLETED,7303.56
Transfer,Savings,2025-06-13 08:59:23,2025-06-13 08:59:23,To pocket EUR Savings from EUR,0.5,0,EUR,COMPLETED,7304.06
Transfer,Savings,2025-06-13 12:40:18,2025-06-13 12:40:18,To pocket EUR Savings from EUR,0.91,0,EUR,COMPLETED,7304.97
Transfer,Savings,2025-06-13 16:09:20,2025-06-13 16:09:20,To pocket EUR Savings from EUR,0.69,0,EUR,COMPLETED,7305.66
Transfer,Savings,2025-06-13 20:13:33,2025-06-13 20:13:33,To pocket EUR Savings from EUR,1,0,EUR,COMPLETED,7306.66
Transfer,Savings,2025-06-14 08:11:55,2025-06-14 08:11:55,To pocket EUR Savings from EUR,0.5,0,EUR,COMPLETED,7307.16
Transfer,Savings,2025-06-14 09:20:27,2025-06-14 09:20:27,To pocket EUR Savings from EUR,0.25,0,EUR,COMPLETED,7307.41
Transfer,Savings,2025-06-14 15:25:29,2025-06-14 15:25:29,To pocket EUR Savings from EUR,0.9,0,EUR,COMPLETED,7308.31
Transfer,Savings,2025-06-14 23:24:36,2025-06-14 23:24:36,To pocket EUR Savings from EUR,0.18,0,EUR,COMPLETED,7308.49
Transfer,Savings,2025-06-15 07:18:41,2025-06-15 07:18:41,To pocket EUR Savings from EUR,0.5,0,EUR,COMPLETED,7308.99
Transfer,Savings,2025-06-15 11:57:22,2025-06-15 11:57:22,To pocket EUR Savings from EUR,0.19,0,EUR,COMPLETED,7309.18
Transfer,Savings,2025-06-15 12:21:58,2025-06-15 12:21:58,To pocket EUR Savings from EUR,0.19,0,EUR,COMPLETED,7309.37
Transfer,Savings,2025-06-15 17:12:48,2025-06-15 17:12:48,To pocket EUR Savings from EUR,0.01,0,EUR,COMPLETED,7309.38
Transfer,Savings,2025-06-16 09:04:23,2025-06-16 09:04:23,To pocket EUR Savings from EUR,20,0,EUR,COMPLETED,7329.38
Transfer,Savings,2025-06-18 11:54:02,2025-06-18 11:54:02,To pocket EUR Savings from EUR,1,0,EUR,COMPLETED,7330.38
Transfer,Savings,2025-06-18 12:41:29,2025-06-18 12:41:29,To pocket EUR Savings from EUR,0.86,0,EUR,COMPLETED,7331.24
Transfer,Savings,2025-06-18 14:05:01,2025-06-18 14:05:01,To pocket EUR Savings from EUR,0.03,0,EUR,COMPLETED,7331.27
Transfer,Savings,2025-06-19 07:49:26,2025-06-19 07:49:26,To pocket EUR Savings from EUR,0.5,0,EUR,COMPLETED,7331.77
Transfer,Savings,2025-06-19 12:46:31,2025-06-19 12:46:31,To pocket EUR Savings from EUR,0.47,0,EUR,COMPLETED,7332.24
Transfer,Savings,2025-06-19 16:23:40,2025-06-19 16:23:40,To pocket EUR Savings from EUR,0.09,0,EUR,COMPLETED,7332.33
Transfer,Savings,2025-06-20 13:10:03,2025-06-20 13:10:03,To pocket EUR Savings from EUR,0.01,0,EUR,COMPLETED,7332.34
Transfer,Savings,2025-06-20 13:24:40,2025-06-20 13:24:40,To pocket EUR Savings from EUR,0.36,0,EUR,COMPLETED,7332.7
Transfer,Savings,2025-06-21 08:09:12,2025-06-21 08:09:12,To pocket EUR Savings from EUR,0.5,0,EUR,COMPLETED,7333.2
Transfer,Savings,2025-06-22 11:17:57,2025-06-22 11:17:57,To pocket EUR Savings from EUR,0.9,0,EUR,COMPLETED,7334.1
Transfer,Savings,2025-06-22 11:20:26,2025-06-22 11:20:26,To pocket EUR Savings from EUR,1,0,EUR,COMPLETED,7335.1
Transfer,Savings,2025-06-22 14:46:30,2025-06-22 14:46:30,To pocket EUR Savings from EUR,0.9,0,EUR,COMPLETED,7336
Transfer,Savings,2025-06-22 15:13:54,2025-06-22 15:13:54,To pocket EUR Savings from EUR,0.41,0,EUR,COMPLETED,7336.41
Transfer,Savings,2025-06-22 18:56:48,2025-06-22 18:56:48,To pocket EUR Savings from EUR,0.4,0,EUR,COMPLETED,7336.81
Transfer,Savings,2025-06-23 02:57:46,2025-06-23 02:57:46,To pocket EUR Savings from EUR,20,0,EUR,COMPLETED,7356.81
Transfer,Savings,2025-06-23 07:50:28,2025-06-23 07:50:28,To pocket EUR Savings from EUR,0.53,0,EUR,COMPLETED,7357.34
Transfer,Savings,2025-06-23 08:12:25,2025-06-23 08:12:25,To pocket EUR Savings from EUR,0.01,0,EUR,COMPLETED,7357.35
Transfer,Savings,2025-06-23 13:32:11,2025-06-23 13:32:11,To pocket EUR Savings from EUR,1,0,EUR,COMPLETED,7358.35
Transfer,Savings,2025-06-23 14:00:02,2025-06-23 14:00:02,To pocket EUR Savings from EUR,0.56,0,EUR,COMPLETED,7358.91
Transfer,Savings,2025-06-23 14:28:54,2025-06-23 14:28:54,To pocket EUR Savings from EUR,0.99,0,EUR,COMPLETED,7359.9
Transfer,Savings,2025-06-23 14:29:09,2025-06-23 14:29:09,To pocket EUR Savings from EUR,0.29,0,EUR,COMPLETED,7360.19
Transfer,Savings,2025-06-24 11:56:31,2025-06-24 11:56:31,To pocket EUR Savings from EUR,0.23,0,EUR,COMPLETED,7360.42
Transfer,Savings,2025-06-24 12:16:10,2025-06-24 12:16:10,To pocket EUR Savings from EUR,0.01,0,EUR,COMPLETED,7360.43
Transfer,Savings,2025-06-24 12:24:23,2025-06-24 12:24:23,To pocket EUR Savings from EUR,0.26,0,EUR,COMPLETED,7360.69
Transfer,Savings,2025-06-24 17:04:29,2025-06-24 17:04:29,To pocket EUR Savings from EUR,0.01,0,EUR,COMPLETED,7360.7
Transfer,Savings,2025-06-25 07:50:26,2025-06-25 07:50:26,To pocket EUR Savings from EUR,0.3,0,EUR,COMPLETED,7361
Transfer,Savings,2025-06-25 09:35:08,2025-06-25 09:35:08,To pocket EUR Savings from EUR,0.01,0,EUR,COMPLETED,7361.01
Transfer,Savings,2025-06-25 10:35:20,2025-06-25 10:35:20,To pocket EUR Savings from EUR,0.27,0,EUR,COMPLETED,7361.28
Transfer,Savings,2025-06-25 13:50:06,2025-06-25 13:50:06,To pocket EUR Savings from EUR,0.4,0,EUR,COMPLETED,7361.68
Transfer,Savings,2025-06-25 17:17:16,2025-06-25 17:17:16,To pocket EUR Savings from EUR,1,0,EUR,COMPLETED,7362.68
Transfer,Savings,2025-06-26 12:35:06,2025-06-26 12:35:06,To pocket EUR Savings from EUR,0.86,0,EUR,COMPLETED,7363.54
Transfer,Savings,2025-06-26 18:48:18,2025-06-26 18:48:18,To pocket EUR Savings from EUR,0.01,0,EUR,COMPLETED,7363.55
Transfer,Savings,2025-06-27 03:15:51,2025-06-27 03:15:51,To pocket EUR Savings from EUR,0.01,0,EUR,COMPLETED,7363.56
Transfer,Savings,2025-06-27 12:32:01,2025-06-27 12:32:01,To pocket EUR Savings from EUR,0.91,0,EUR,COMPLETED,7364.47
Transfer,Savings,2025-06-28 07:47:09,2025-06-28 07:47:09,To pocket EUR Savings from EUR,0.5,0,EUR,COMPLETED,7364.97
Transfer,Savings,2025-06-28 08:29:30,2025-06-28 08:29:30,To pocket EUR Savings from EUR,0.09,0,EUR,COMPLETED,7365.06
Transfer,Savings,2025-06-28 11:12:27,2025-06-28 11:12:27,To pocket EUR Savings from EUR,1,0,EUR,COMPLETED,7366.06
Transfer,Savings,2025-06-28 11:26:58,2025-06-28 11:26:58,To pocket EUR Savings from EUR,1,0,EUR,COMPLETED,7367.06
Transfer,Savings,2025-06-28 13:56:59,2025-06-28 13:56:59,To pocket EUR Savings from EUR,0.74,0,EUR,COMPLETED,7367.8
Transfer,Savings,2025-06-29 05:52:08,2025-06-29 05:52:08,To pocket EUR Savings from EUR,0.51,0,EUR,COMPLETED,7368.31
Transfer,Savings,2025-06-29 10:58:00,2025-06-29 10:58:00,To pocket EUR Savings from EUR,0.8,0,EUR,COMPLETED,7369.11
Transfer,Savings,2025-06-29 14:25:35,2025-06-29 14:25:35,To pocket EUR Savings from EUR,0.85,0,EUR,COMPLETED,7369.96
Transfer,Savings,2025-06-29 14:44:31,2025-06-29 14:44:31,To pocket EUR Savings from EUR,0.12,0,EUR,COMPLETED,7370.08
Transfer,Savings,2025-06-30 02:56:17,2025-06-30 02:56:17,To pocket EUR Savings from EUR,0.05,0,EUR,COMPLETED,7370.13
Transfer,Savings,2025-06-30 03:13:13,2025-06-30 03:13:13,To pocket EUR Savings from EUR,20,0,EUR,COMPLETED,7390.13
Transfer,Savings,2025-06-30 14:14:31,2025-06-30 14:14:31,To pocket EUR Savings from EUR,0.5,0,EUR,COMPLETED,7390.63
Transfer,Savings,2025-06-30 18:21:02,2025-06-30 18:21:02,To pocket EUR Savings from EUR,0.18,0,EUR,COMPLETED,7390.81
Transfer,Savings,2025-07-01 02:16:19,2025-07-01 02:16:19,To pocket EUR Rainy day from EUR,50,0,EUR,COMPLETED,7440.81
Transfer,Savings,2025-07-01 09:52:41,2025-07-01 09:52:41,To pocket EUR Savings from EUR,1,0,EUR,COMPLETED,7441.81
Transfer,Savings,2025-07-01 10:11:58,2025-07-01 10:11:58,To pocket EUR Savings from EUR,0.35,0,EUR,COMPLETED,7442.16
Transfer,Savings,2025-07-01 10:15:33,2025-07-01 10:15:33,To pocket EUR Savings from EUR,0.42,0,EUR,COMPLETED,7442.58
Transfer,Savings,2025-07-02 08:36:59,2025-07-02 08:36:59,To pocket EUR Savings from EUR,0.6,0,EUR,COMPLETED,7443.18
Transfer,Savings,2025-07-02 12:16:08,2025-07-02 12:16:08,To pocket EUR Savings from EUR,0.01,0,EUR,COMPLETED,7443.19
Transfer,Savings,2025-07-02 14:37:06,2025-07-02 14:37:06,To pocket EUR Savings from EUR,0.8,0,EUR,COMPLETED,7443.99
Transfer,Savings,2025-07-02 17:02:31,2025-07-02 17:02:31,To pocket EUR Savings from EUR,0.44,0,EUR,COMPLETED,7444.43
Transfer,Savings,2025-07-02 19:15:45,2025-07-02 19:15:45,To pocket EUR Savings from EUR,0.42,0,EUR,COMPLETED,7444.85
Transfer,Savings,2025-07-02 21:52:46,2025-07-02 21:52:46,To pocket EUR Savings from EUR,0.6,0,EUR,COMPLETED,7445.45
Transfer,Savings,2025-07-03 04:10:50,2025-07-03 04:10:50,To pocket EUR Savings from EUR,1,0,EUR,COMPLETED,7446.45
Transfer,Savings,2025-07-03 12:41:05,2025-07-03 12:41:05,To pocket EUR Savings from EUR,0.83,0,EUR,COMPLETED,7447.28
Transfer,Savings,2025-07-03 12:47:27,2025-07-03 12:47:27,To pocket EUR Savings from EUR,1,0,EUR,COMPLETED,7448.28
Transfer,Savings,2025-07-04 08:53:47,2025-07-04 08:53:47,To pocket EUR Savings from EUR,0.15,0,EUR,COMPLETED,7448.43
Transfer,Savings,2025-07-04 14:55:01,2025-07-04 14:55:01,To pocket EUR Savings from EUR,0.05,0,EUR,COMPLETED,7448.48
Transfer,Savings,2025-07-04 18:22:08,2025-07-04 18:22:08,To pocket EUR Savings from EUR,0.7,0,EUR,COMPLETED,7449.18
Transfer,Savings,2025-07-05 08:36:23,2025-07-05 08:36:23,To pocket EUR Savings from EUR,0.85,0,EUR,COMPLETED,7450.03
Transfer,Savings,2025-07-06 09:06:50,2025-07-06 09:06:50,To pocket EUR Savings from EUR,0.5,0,EUR,COMPLETED,7450.53
Transfer,Savings,2025-07-06 10:09:45,2025-07-06 10:09:45,To pocket EUR Savings from EUR,0.26,0,EUR,COMPLETED,7450.79
Transfer,Savings,2025-07-06 10:31:14,2025-07-06 10:31:14,To pocket EUR Savings from EUR,0.12,0,EUR,COMPLETED,7450.91
Transfer,Savings,2025-07-07 03:35:49,2025-07-07 03:35:49,To pocket EUR Savings from EUR,20,0,EUR,COMPLETED,7470.91
Transfer,Savings,2025-07-07 13:54:22,2025-07-07 13:54:22,To pocket EUR Savings from EUR,0.7,0,EUR,COMPLETED,7471.61
Transfer,Savings,2025-07-10 11:00:16,2025-07-10 11:00:16,To pocket EUR Savings from EUR,0.86,0,EUR,COMPLETED,7472.47
Transfer,Savings,2025-07-10 11:32:19,2025-07-10 11:32:19,To pocket EUR Savings from EUR,1,0,EUR,COMPLETED,7473.47
Transfer,Savings,2025-07-10 12:39:05,2025-07-10 12:39:05,To pocket EUR Savings from EUR,0.86,0,EUR,COMPLETED,7474.33
Transfer,Savings,2025-07-10 14:10:22,2025-07-10 14:10:22,To pocket EUR Savings from EUR,1,0,EUR,COMPLETED,7475.33
Transfer,Savings,2025-07-12 08:24:36,2025-07-12 08:24:36,To pocket EUR Savings from EUR,0.5,0,EUR,COMPLETED,7475.83
Transfer,Savings,2025-07-12 11:28:33,2025-07-12 11:28:33,To pocket EUR Savings from EUR,0.74,0,EUR,COMPLETED,7476.57
Transfer,Savings,2025-07-13 07:53:09,2025-07-13 07:53:09,To pocket EUR Savings from EUR,0.5,0,EUR,COMPLETED,7477.07
Transfer,Savings,2025-07-13 08:25:42,2025-07-13 08:25:42,To pocket EUR Savings from EUR,0.38,0,EUR,COMPLETED,7477.45
Transfer,Savings,2025-07-14 03:28:18,2025-07-14 03:28:18,To pocket EUR Savings from EUR,20,0,EUR,COMPLETED,7497.45
Transfer,Savings,2025-07-14 12:48:52,2025-07-14 12:48:52,To pocket EUR Savings from EUR,0.45,0,EUR,COMPLETED,7497.9
Transfer,Savings,2025-07-17 12:44:08,2025-07-17 12:44:08,To pocket EUR Savings from EUR,0.34,0,EUR,COMPLETED,7498.24
Transfer,Savings,2025-07-18 10:33:07,2025-07-18 10:33:07,To pocket EUR Savings from EUR,0.51,0,EUR,COMPLETED,7498.75
Transfer,Savings,2025-07-18 12:45:35,2025-07-18 12:45:35,To pocket EUR Savings from EUR,0.78,0,EUR,COMPLETED,7499.53
Transfer,Savings,2025-07-19 00:44:44,2025-07-19 00:44:44,To pocket EUR Savings from EUR,0.5,0,EUR,COMPLETED,7500.03
Transfer,Savings,2025-07-19 07:57:10,2025-07-19 07:57:10,To pocket EUR Savings from EUR,0.5,0,EUR,COMPLETED,7500.53
Transfer,Savings,2025-07-19 12:46:31,2025-07-19 12:46:31,To pocket EUR Savings from EUR,0.76,0,EUR,COMPLETED,7501.29
Transfer,Savings,2025-07-19 12:51:24,2025-07-19 12:51:24,To pocket EUR Savings from EUR,0.06,0,EUR,COMPLETED,7501.35
Transfer,Savings,2025-07-20 08:08:43,2025-07-20 08:08:43,To pocket EUR Savings from EUR,0.5,0,EUR,COMPLETED,7501.85
Transfer,Savings,2025-07-20 08:56:27,2025-07-20 08:56:27,To pocket EUR Savings from EUR,0.22,0,EUR,COMPLETED,7502.07
Transfer,Savings,2025-07-20 13:10:03,2025-07-20 13:10:03,To pocket EUR Savings from EUR,0.01,0,EUR,COMPLETED,7502.08
Transfer,Savings,2025-07-20 17:46:53,2025-07-20 17:46:53,To pocket EUR Savings from EUR,0.4,0,EUR,COMPLETED,7502.48
Transfer,Savings,2025-07-20 20:45:25,2025-07-20 20:45:25,To pocket EUR Savings from EUR,0.3,0,EUR,COMPLETED,7502.78
Transfer,Savings,2025-07-21 03:21:09,2025-07-21 03:21:09,To pocket EUR Savings from EUR,20,0,EUR,COMPLETED,7522.78
Transfer,Savings,2025-07-21 13:24:50,2025-07-21 13:24:50,To pocket EUR Savings from EUR,0.16,0,EUR,COMPLETED,7522.94
Transfer,Savings,2025-07-21 14:38:13,2025-07-21 14:38:13,To pocket EUR Savings from EUR,0.93,0,EUR,COMPLETED,7523.87
Transfer,Savings,2025-07-21 17:13:09,2025-07-21 17:13:09,To pocket EUR Savings from EUR,1,0,EUR,COMPLETED,7524.87
Transfer,Savings,2025-07-23 08:12:25,2025-07-23 08:12:25,To pocket EUR Savings from EUR,0.01,0,EUR,COMPLETED,7524.88
Transfer,Savings,2025-07-23 12:29:33,2025-07-23 12:29:33,To pocket EUR Savings from EUR,0.34,0,EUR,COMPLETED,7525.22
Transfer,Savings,2025-07-23 16:02:45,2025-07-23 16:02:45,To pocket EUR Savings from EUR,0.1,0,EUR,COMPLETED,7525.32
Transfer,Savings,2025-07-23 17:22:15,2025-07-23 17:22:15,To pocket EUR Savings from EUR,0.8,0,EUR,COMPLETED,7526.12
Transfer,Savings,2025-07-24 12:49:57,2025-07-24 12:49:57,To pocket EUR Savings from EUR,0.34,0,EUR,COMPLETED,7526.46
Transfer,Savings,2025-07-25 12:47:01,2025-07-25 12:47:01,To pocket EUR Savings from EUR,0.78,0,EUR,COMPLETED,7527.24
Transfer,Savings,2025-07-26 07:37:12,2025-07-26 07:37:12,To pocket EUR Savings from EUR,0.5,0,EUR,COMPLETED,7527.74
Transfer,Savings,2025-07-26 14:38:28,2025-07-26 14:38:28,To pocket EUR Savings from EUR,0.5,0,EUR,COMPLETED,7528.24
Transfer,Savings,2025-07-27 02:20:16,2025-07-27 02:20:16,To pocket EUR Savings from EUR,0.01,0,EUR,COMPLETED,7528.25
Transfer,Savings,2025-07-27 07:55:52,2025-07-27 07:55:52,To pocket EUR Savings from EUR,0.5,0,EUR,COMPLETED,7528.75
Transfer,Savings,2025-07-27 08:46:08,2025-07-27 08:46:08,To pocket EUR Savings from EUR,0.82,0,EUR,COMPLETED,7529.57
Transfer,Savings,2025-07-27 09:12:56,2025-07-27 09:12:56,To pocket EUR Savings from EUR,0.86,0,EUR,COMPLETED,7530.43
Transfer,Savings,2025-07-28 03:34:04,2025-07-28 03:34:04,To pocket EUR Savings from EUR,20,0,EUR,COMPLETED,7550.43
Transfer,Savings,2025-07-29 05:52:55,2025-07-29 05:52:55,To pocket EUR Savings from EUR,0.51,0,EUR,COMPLETED,7550.94
Transfer,Savings,2025-07-29 10:22:59,2025-07-29 10:22:59,To pocket EUR Savings from EUR,0.89,0,EUR,COMPLETED,7551.83
Transfer,Savings,2025-07-29 16:11:13,2025-07-29 16:11:13,To pocket EUR Savings from EUR,0.93,0,EUR,COMPLETED,7552.76
Transfer,Savings,2025-07-30 02:54:01,2025-07-30 02:54:01,To pocket EUR Savings from EUR,0.05,0,EUR,COMPLETED,7552.81
Transfer,Savings,2025-07-30 07:41:44,2025-07-30 07:41:44,To pocket EUR Savings from EUR,0.25,0,EUR,COMPLETED,7553.06
Transfer,Savings,2025-07-30 10:05:37,2025-07-30 10:05:37,To pocket EUR Savings from EUR,1,0,EUR,COMPLETED,7554.06
Transfer,Savings,2025-07-30 18:55:53,2025-07-30 18:55:53,To pocket EUR Savings from EUR,0.19,0,EUR,COMPLETED,7554.25
Transfer,Savings,2025-07-30 19:02:36,2025-07-30 19:02:36,To pocket EUR Savings from EUR,0.4,0,EUR,COMPLETED,7554.65
Transfer,Savings,2025-07-31 07:59:38,2025-07-31 07:59:38,To pocket EUR Savings from EUR,0.3,0,EUR,COMPLETED,7554.95
Transfer,Savings,2025-08-01 02:59:36,2025-08-01 02:59:36,To pocket EUR Rainy day from EUR,50,0,EUR,COMPLETED,7604.95
Transfer,Savings,2025-08-01 08:00:30,2025-08-01 08:00:30,To pocket EUR Savings from EUR,0.3,0,EUR,COMPLETED,7605.25
Transfer,Savings,2025-08-01 13:14:42,2025-08-01 13:14:42,To pocket EUR Savings from EUR,0.4,0,EUR,COMPLETED,7605.65
Transfer,Savings,2025-08-02 08:07:11,2025-08-02 08:07:11,To pocket EUR Savings from EUR,0.3,0,EUR,COMPLETED,7605.95
Transfer,Savings,2025-08-02 09:00:14,2025-08-02 09:00:14,To pocket EUR Savings from EUR,0.1,0,EUR,COMPLETED,7606.05
Transfer,Savings,2025-08-02 09:23:31,2025-08-02 09:23:31,To pocket EUR Savings from EUR,0.88,0,EUR,COMPLETED,7606.93
Transfer,Savings,2025-08-02 09:40:03,2025-08-02 09:40:03,To pocket EUR Savings from EUR,0.99,0,EUR,COMPLETED,7607.92
Transfer,Savings,2025-08-02 12:17:37,2025-08-02 12:17:37,To pocket EUR Savings from EUR,0.01,0,EUR,COMPLETED,7607.93
Transfer,Savings,2025-08-02 13:59:40,2025-08-02 13:59:40,To pocket EUR Savings from EUR,0.8,0,EUR,COMPLETED,7608.73
Transfer,Savings,2025-08-02 18:47:51,2025-08-02 18:47:51,To pocket EUR Savings from EUR,0.61,0,EUR,COMPLETED,7609.34
Transfer,Savings,2025-08-02 18:59:38,2025-08-02 18:59:38,To pocket EUR Savings from EUR,0.9,0,EUR,COMPLETED,7610.24
Transfer,Savings,2025-08-03 12:18:01,2025-08-03 12:18:01,To pocket EUR Savings from EUR,0.9,0,EUR,COMPLETED,7611.14
Transfer,Savings,2025-08-03 15:08:56,2025-08-03 15:08:56,To pocket EUR Savings from EUR,0.58,0,EUR,COMPLETED,7611.72
Transfer,Savings,2025-08-03 19:16:07,2025-08-03 19:16:07,To pocket EUR Savings from EUR,0.55,0,EUR,COMPLETED,7612.27
Transfer,Savings,2025-08-03 19:30:06,2025-08-03 19:30:06,To pocket EUR Savings from EUR,0.7,0,EUR,COMPLETED,7612.97
Transfer,Savings,2025-08-04 03:25:20,2025-08-04 03:25:20,To pocket EUR Savings from EUR,20,0,EUR,COMPLETED,7632.97
Transfer,Savings,2025-08-06 08:34:22,2025-08-06 08:34:22,To pocket EUR Savings from EUR,0.45,0,EUR,COMPLETED,7633.42
Transfer,Savings,2025-08-06 09:06:04,2025-08-06 09:06:04,To pocket EUR Savings from EUR,0.01,0,EUR,COMPLETED,7633.43
Transfer,Savings,2025-08-06 09:09:43,2025-08-06 09:09:43,To pocket EUR Savings from EUR,0.01,0,EUR,COMPLETED,7633.44
Transfer,Savings,2025-08-06 14:39:58,2025-08-06 14:39:58,To pocket EUR Savings from EUR,0.35,0,EUR,COMPLETED,7633.79
Transfer,Savings,2025-08-07 12:41:06,2025-08-07 12:41:06,To pocket EUR Savings from EUR,0.86,0,EUR,COMPLETED,7634.65
Transfer,Savings,2025-08-07 14:16:11,2025-08-07 14:16:11,To pocket EUR Savings from EUR,1,0,EUR,COMPLETED,7635.65
Transfer,Savings,2025-08-07 19:23:49,2025-08-07 19:23:49,To pocket EUR Savings from EUR,0.25,0,EUR,COMPLETED,7635.9
Transfer,Savings,2025-08-08 19:17:39,2025-08-08 19:17:39,To pocket EUR Savings from EUR,0.6,0,EUR,COMPLETED,7636.5
Transfer,Savings,2025-08-09 07:26:20,2025-08-09 07:26:20,To pocket EUR Savings from EUR,0.5,0,EUR,COMPLETED,7637
Transfer,Savings,2025-08-09 09:30:56,2025-08-09 09:30:56,To pocket EUR Savings from EUR,0.79,0,EUR,COMPLETED,7637.79
Transfer,Savings,2025-08-09 20:54:13,2025-08-09 20:54:13,To pocket EUR Savings from EUR,0.4,0,EUR,COMPLETED,7638.19
Transfer,Savings,2025-08-10 07:32:16,2025-08-10 07:32:16,To pocket EUR Savings from EUR,0.5,0,EUR,COMPLETED,7638.69
Transfer,Savings,2025-08-10 08:16:52,2025-08-10 08:16:52,To pocket EUR Savings from EUR,0.16,0,EUR,COMPLETED,7638.85
Transfer,Savings,2025-08-10 14:16:30,2025-08-10 14:16:30,To pocket EUR Savings from EUR,0.1,0,EUR,COMPLETED,7638.95
Transfer,Savings,2025-08-11 03:21:37,2025-08-11 03:21:37,To pocket EUR Savings from EUR,20,0,EUR,COMPLETED,7658.95
Transfer,Savings,2025-08-12 12:44:11,2025-08-12 12:44:11,To pocket EUR Savings from EUR,0.78,0,EUR,COMPLETED,7659.73
Transfer,Savings,2025-08-14 12:48:35,2025-08-14 12:48:35,To pocket EUR Savings from EUR,0.91,0,EUR,COMPLETED,7660.64
Transfer,Savings,2025-08-14 14:04:59,2025-08-14 14:04:59,To pocket EUR Savings from EUR,0.02,0,EUR,COMPLETED,7660.66
Transfer,Savings,2025-08-15 08:03:33,2025-08-15 08:03:33,To pocket EUR Savings from EUR,0.5,0,EUR,COMPLETED,7661.16
Transfer,Savings,2025-08-15 15:13:19,2025-08-15 15:13:19,To pocket EUR Savings from EUR,0.75,0,EUR,COMPLETED,7661.91
Transfer,Savings,2025-08-15 15:44:25,2025-08-15 15:44:25,To pocket EUR Savings from EUR,0.2,0,EUR,COMPLETED,7662.11
Transfer,Savings,2025-08-16 07:46:45,2025-08-16 07:46:45,To pocket EUR Savings from EUR,0.5,0,EUR,COMPLETED,7662.61
Transfer,Savings,2025-08-16 08:28:21,2025-08-16 08:28:21,To pocket EUR Savings from EUR,0.89,0,EUR,COMPLETED,7663.5
Transfer,Savings,2025-08-16 10:46:22,2025-08-16 10:46:22,To pocket EUR Savings from EUR,1,0,EUR,COMPLETED,7664.5
Transfer,Savings,2025-08-16 11:33:32,2025-08-16 11:33:32,To pocket EUR Savings from EUR,0.06,0,EUR,COMPLETED,7664.56
Transfer,Savings,2025-08-17 07:49:25,2025-08-17 07:49:25,To pocket EUR Savings from EUR,0.5,0,EUR,COMPLETED,7665.06
Transfer,Savings,2025-08-17 08:43:40,2025-08-17 08:43:40,To pocket EUR Savings from EUR,0.37,0,EUR,COMPLETED,7665.43
Transfer,Savings,2025-08-17 12:57:51,2025-08-17 12:57:51,To pocket EUR Savings from EUR,0.1,0,EUR,COMPLETED,7665.53
Transfer,Savings,2025-08-17 13:00:06,2025-08-17 13:00:06,To pocket EUR Savings from EUR,0.01,0,EUR,COMPLETED,7665.54
Transfer,Savings,2025-08-17 14:30:03,2025-08-17 14:30:03,To pocket EUR Savings from EUR,0.01,0,EUR,COMPLETED,7665.55
Transfer,Savings,2025-08-18 03:15:24,2025-08-18 03:15:24,To pocket EUR Savings from EUR,20,0,EUR,COMPLETED,7685.55
Transfer,Savings,2025-08-18 08:32:10,2025-08-18 08:32:10,To pocket EUR Savings from EUR,0.84,0,EUR,COMPLETED,7686.39
Transfer,Savings,2025-08-18 20:24:53,2025-08-18 20:24:53,To pocket EUR Savings from EUR,1,0,EUR,COMPLETED,7687.39
Transfer,Savings,2025-08-19 12:46:28,2025-08-19 12:46:28,To pocket EUR Savings from EUR,0.84,0,EUR,COMPLETED,7688.23
Transfer,Savings,2025-08-20 13:10:03,2025-08-20 13:10:03,To pocket EUR Savings from EUR,0.01,0,EUR,COMPLETED,7688.24
Transfer,Savings,2025-08-21 12:51:02,2025-08-21 12:51:02,To pocket EUR Savings from EUR,0.86,0,EUR,COMPLETED,7689.1
Transfer,Savings,2025-08-21 14:06:57,2025-08-21 14:06:57,To pocket EUR Savings from EUR,0.09,0,EUR,COMPLETED,7689.19
Transfer,Savings,2025-08-21 17:24:31,2025-08-21 17:24:31,To pocket EUR Savings from EUR,0.27,0,EUR,COMPLETED,7689.46
Transfer,Savings,2025-08-22 12:53:49,2025-08-22 12:53:49,To pocket EUR Savings from EUR,0.78,0,EUR,COMPLETED,7690.24
Transfer,Savings,2025-08-23 08:07:28,2025-08-23 08:07:28,To pocket EUR Savings from EUR,0.5,0,EUR,COMPLETED,7690.74
Transfer,Savings,2025-08-23 08:12:26,2025-08-23 08:12:26,To pocket EUR Savings from EUR,0.01,0,EUR,COMPLETED,7690.75
Transfer,Savings,2025-08-23 11:29:28,2025-08-23 11:29:28,To pocket EUR Savings from EUR,0.94,0,EUR,COMPLETED,7691.69
Transfer,Savings,2025-08-23 20:14:08,2025-08-23 20:14:08,To pocket EUR Savings from EUR,0.13,0,EUR,COMPLETED,7691.82
Transfer,Savings,2025-08-24 07:53:22,2025-08-24 07:53:22,To pocket EUR Savings from EUR,0.5,0,EUR,COMPLETED,7692.32
Transfer,Savings,2025-08-24 10:05:22,2025-08-24 10:05:22,To pocket EUR Savings from EUR,1,0,EUR,COMPLETED,7693.32
Transfer,Savings,2025-08-24 15:55:14,2025-08-24 15:55:14,To pocket EUR Savings from EUR,0.75,0,EUR,COMPLETED,7694.07
Transfer,Savings,2025-08-25 03:18:53,2025-08-25 03:18:53,To pocket EUR Savings from EUR,20,0,EUR,COMPLETED,7714.07
Transfer,Savings,2025-08-25 12:44:05,2025-08-25 12:44:05,To pocket EUR Savings from EUR,0.7,0,EUR,COMPLETED,7714.77
Transfer,Savings,2025-08-25 12:57:52,2025-08-25 12:57:52,To pocket EUR Savings from EUR,0.77,0,EUR,COMPLETED,7715.54
Transfer,Savings,2025-08-25 19:31:59,2025-08-25 19:31:59,To pocket EUR Savings from EUR,0.83,0,EUR,COMPLETED,7716.37
Transfer,Savings,2025-08-26 04:10:41,2025-08-26 04:10:41,To pocket EUR Savings from EUR,1,0,EUR,COMPLETED,7717.37
Transfer,Savings,2025-08-26 09:48:27,2025-08-26 09:48:27,To pocket EUR Savings from EUR,0.34,0,EUR,COMPLETED,7717.71
Transfer,Savings,2025-08-26 10:28:29,2025-08-26 10:28:29,To pocket EUR Savings from EUR,1,0,EUR,COMPLETED,7718.71
Transfer,Savings,2025-08-26 12:17:34,2025-08-26 12:17:34,To pocket EUR Savings from EUR,0.86,0,EUR,COMPLETED,7719.57
Transfer,Savings,2025-08-27 02:44:57,2025-08-27 02:44:57,To pocket EUR Savings from EUR,0.01,0,EUR,COMPLETED,7719.58
Transfer,Savings,2025-08-27 11:28:37,2025-08-27 11:28:37,To pocket EUR Savings from EUR,0.8,0,EUR,COMPLETED,7720.38
Transfer,Savings,2025-08-27 20:41:14,2025-08-27 20:41:14,To pocket EUR Savings from EUR,0.4,0,EUR,COMPLETED,7720.78
Transfer,Savings,2025-08-28 09:47:55,2025-08-28 09:47:55,To pocket EUR Savings from EUR,1,0,EUR,COMPLETED,7721.78
Transfer,Savings,2025-08-28 10:57:54,2025-08-28 10:57:54,To pocket EUR Savings from EUR,0.64,0,EUR,COMPLETED,7722.42
Transfer,Savings,2025-08-28 11:17:24,2025-08-28 11:17:24,To pocket EUR Savings from EUR,0.5,0,EUR,COMPLETED,7722.92
Transfer,Savings,2025-08-28 11:36:41,2025-08-28 11:36:41,To pocket EUR Savings from EUR,0.68,0,EUR,COMPLETED,7723.6
Transfer,Savings,2025-08-28 20:38:25,2025-08-28 20:38:25,To pocket EUR Savings from EUR,0.5,0,EUR,COMPLETED,7724.1
Transfer,Savings,2025-08-29 05:52:33,2025-08-29 05:52:33,To pocket EUR Savings from EUR,0.51,0,EUR,COMPLETED,7724.61
Transfer,Savings,2025-08-29 11:19:37,2025-08-29 11:19:37,To pocket EUR Savings from EUR,0.8,0,EUR,COMPLETED,7725.41
Transfer,Savings,2025-08-29 11:23:51,2025-08-29 11:23:51,To pocket EUR Savings from EUR,0.3,0,EUR,COMPLETED,7725.71
Transfer,Savings,2025-08-29 11:42:18,2025-08-29 11:42:18,To pocket EUR Savings from EUR,0.77,0,EUR,COMPLETED,7726.48
Transfer,Savings,2025-08-29 19:20:07,2025-08-29 19:20:07,To pocket EUR Savings from EUR,0.4,0,EUR,COMPLETED,7726.88
Transfer,Savings,2025-08-30 02:53:44,2025-08-30 02:53:44,To pocket EUR Savings from EUR,0.05,0,EUR,COMPLETED,7726.93
Transfer,Savings,2025-08-31 12:04:38,2025-08-31 12:04:38,To pocket EUR Savings from EUR,1,0,EUR,COMPLETED,7727.93
Transfer,Savings,2025-08-31 15:15:08,2025-08-31 15:15:08,To pocket EUR Savings from EUR,1,0,EUR,COMPLETED,7728.93
Transfer,Savings,2025-08-31 15:42:35,2025-08-31 15:42:35,To pocket EUR Savings from EUR,0.2,0,EUR,COMPLETED,7729.13
Transfer,Savings,2025-08-31 16:34:43,2025-08-31 16:34:43,To pocket EUR Savings from EUR,0.85,0,EUR,COMPLETED,7729.98
Transfer,Savings,2025-08-31 16:47:08,2025-08-31 16:47:08,To pocket EUR Savings from EUR,0.97,0,EUR,COMPLETED,7730.95
Transfer,Savings,2025-08-31 16:54:03,2025-08-31 16:54:03,To pocket EUR Savings from EUR,1,0,EUR,COMPLETED,7731.95
Transfer,Savings,2025-09-01 03:48:53,2025-09-01 03:48:53,To pocket EUR Savings from EUR,20,0,EUR,COMPLETED,7751.95
Transfer,Savings,2025-09-01 03:48:53,2025-09-01 03:48:53,To pocket EUR Rainy day from EUR,50,0,EUR,COMPLETED,7801.95
Transfer,Savings,2025-09-01 08:02:41,2025-09-01 08:02:41,To pocket EUR Savings from EUR,0.01,0,EUR,COMPLETED,7801.96
Transfer,Savings,2025-09-02 12:16:05,2025-09-02 12:16:05,To pocket EUR Savings from EUR,0.01,0,EUR,COMPLETED,7801.97
Transfer,Savings,2025-09-04 08:43:31,2025-09-04 08:43:31,To pocket EUR Savings from EUR,0.3,0,EUR,COMPLETED,7802.27
Transfer,Savings,2025-09-04 14:59:02,2025-09-04 14:59:02,To pocket EUR Savings from EUR,1,0,EUR,COMPLETED,7803.27
Transfer,Savings,2025-09-04 15:00:23,2025-09-04 15:00:23,To pocket EUR Savings from EUR,1,0,EUR,COMPLETED,7804.27
Transfer,Savings,2025-09-04 15:01:49,2025-09-04 15:01:49,To pocket EUR Savings from EUR,1,0,EUR,COMPLETED,7805.27
Transfer,Savings,2025-09-04 15:07:33,2025-09-04 15:07:33,To pocket EUR Savings from EUR,1,0,EUR,COMPLETED,7806.27
Transfer,Savings,2025-09-04 15:19:58,2025-09-04 15:19:58,To pocket EUR Savings from EUR,0.38,0,EUR,COMPLETED,7806.65
Transfer,Savings,2025-09-05 11:43:29,2025-09-05 11:43:29,To pocket EUR Savings from EUR,0.05,0,EUR,COMPLETED,7806.7
Transfer,Savings,2025-09-05 12:35:17,2025-09-05 12:35:17,To pocket EUR Savings from EUR,1,0,EUR,COMPLETED,7807.7
Transfer,Savings,2025-09-05 18:34:54,2025-09-05 18:34:54,To pocket EUR Savings from EUR,0.39,0,EUR,COMPLETED,7808.09
Transfer,Savings,2025-09-05 19:34:33,2025-09-05 19:34:33,To pocket EUR Savings from EUR,0.89,0,EUR,COMPLETED,7808.98
Transfer,Savings,2025-09-06 09:17:38,2025-09-06 09:17:38,To pocket EUR Savings from EUR,0.45,0,EUR,COMPLETED,7809.43
Transfer,Savings,2025-09-06 13:45:38,2025-09-06 13:45:38,To pocket EUR Savings from EUR,0.89,0,EUR,COMPLETED,7810.32
Transfer,Savings,2025-09-06 14:02:08,2025-09-06 14:02:08,To pocket EUR Savings from EUR,1,0,EUR,COMPLETED,7811.32
Transfer,Savings,2025-09-06 18:48:15,2025-09-06 18:48:15,To pocket EUR Savings from EUR,0.41,0,EUR,COMPLETED,7811.73
Transfer,Savings,2025-09-07 08:19:08,2025-09-07 08:19:08,To pocket EUR Savings from EUR,0.5,0,EUR,COMPLETED,7812.23
Transfer,Savings,2025-09-07 09:21:39,2025-09-07 09:21:39,To pocket EUR Savings from EUR,0.51,0,EUR,COMPLETED,7812.74
Transfer,Savings,2025-09-07 13:06:54,2025-09-07 13:06:54,To pocket EUR Savings from EUR,0.06,0,EUR,COMPLETED,7812.8
Transfer,Savings,2025-09-08 03:15:13,2025-09-08 03:15:13,To pocket EUR Savings from EUR,20,0,EUR,COMPLETED,7832.8
Transfer,Savings,2025-09-08 07:44:42,2025-09-08 07:44:42,To pocket EUR Savings from EUR,0.5,0,EUR,COMPLETED,7833.3
Transfer,Savings,2025-09-08 13:08:54,2025-09-08 13:08:54,To pocket EUR Savings from EUR,0.01,0,EUR,COMPLETED,7833.31
Transfer,Savings,2025-09-09 09:43:31,2025-09-09 09:43:31,To pocket EUR Savings from EUR,0.45,0,EUR,COMPLETED,7833.76
Transfer,Savings,2025-09-10 09:30:25,2025-09-10 09:30:25,To pocket EUR Savings from EUR,0.52,0,EUR,COMPLETED,7834.28
Transfer,Savings,2025-09-10 11:08:28,2025-09-10 11:08:28,To pocket EUR Savings from EUR,0.98,0,EUR,COMPLETED,7835.26
Transfer,Savings,2025-09-11 12:45:42,2025-09-11 12:45:42,To pocket EUR Savings from EUR,0.98,0,EUR,COMPLETED,7836.24
Transfer,Savings,2025-09-13 09:57:40,2025-09-13 09:57:40,To pocket EUR Savings from EUR,0.95,0,EUR,COMPLETED,7837.19
Transfer,Savings,2025-09-13 10:18:12,2025-09-13 10:18:12,To pocket EUR Savings from EUR,0.65,0,EUR,COMPLETED,7837.84
Transfer,Savings,2025-09-13 19:41:05,2025-09-13 19:41:05,To pocket EUR Savings from EUR,0.01,0,EUR,COMPLETED,7837.85
Transfer,Savings,2025-09-14 08:54:09,2025-09-14 08:54:09,To pocket EUR Savings from EUR,0.2,0,EUR,COMPLETED,7838.05
Transfer,Savings,2025-09-14 09:39:42,2025-09-14 09:39:42,To pocket EUR Savings from EUR,1,0,EUR,COMPLETED,7839.05
Transfer,Savings,2025-09-14 10:34:13,2025-09-14 10:34:13,To pocket EUR Savings from EUR,0.1,0,EUR,COMPLETED,7839.15
Transfer,Savings,2025-09-14 18:06:13,2025-09-14 18:06:13,To pocket EUR Savings from EUR,0.05,0,EUR,COMPLETED,7839.2
Transfer,Savings,2025-09-15 03:23:05,2025-09-15 03:23:05,To pocket EUR Savings from EUR,20,0,EUR,COMPLETED,7859.2
Transfer,Savings,2025-09-16 11:16:58,2025-09-16 11:16:58,To pocket EUR Savings from EUR,0.85,0,EUR,COMPLETED,7860.05
Transfer,Savings,2025-09-16 22:40:35,2025-09-16 22:40:35,To pocket EUR Savings from EUR,1,0,EUR,COMPLETED,7861.05
Transfer,Savings,2025-09-16 22:59:00,2025-09-16 22:59:00,To pocket EUR Savings from EUR,0.6,0,EUR,COMPLETED,7861.65
Transfer,Savings,2025-09-16 23:22:11,2025-09-16 23:22:11,To pocket EUR Savings from EUR,1,0,EUR,COMPLETED,7862.65
Transfer,Savings,2025-09-17 03:14:45,2025-09-17 03:14:45,To pocket EUR Savings from EUR,0.6,0,EUR,COMPLETED,7863.25
Transfer,Savings,2025-09-17 07:15:32,2025-09-17 07:15:32,To pocket EUR Savings from EUR,0.5,0,EUR,COMPLETED,7863.75
Transfer,Savings,2025-09-17 08:44:05,2025-09-17 08:44:05,To pocket EUR Savings from EUR,0.1,0,EUR,COMPLETED,7863.85
Transfer,Savings,2025-09-19 12:45:33,2025-09-19 12:45:33,To pocket EUR Savings from EUR,0.96,0,EUR,COMPLETED,7864.81
Transfer,Savings,2025-09-19 12:48:52,2025-09-19 12:48:52,To pocket EUR Savings from EUR,0.78,0,EUR,COMPLETED,7865.59
Transfer,Savings,2025-09-19 20:39:22,2025-09-19 20:39:22,To pocket EUR Savings from EUR,1,0,EUR,COMPLETED,7866.59
Transfer,Savings,2025-09-20 08:11:04,2025-09-20 08:11:04,To pocket EUR Savings from EUR,0.5,0,EUR,COMPLETED,7867.09
Transfer,Savings,2025-09-20 09:20:42,2025-09-20 09:20:42,To pocket EUR Savings from EUR,0.03,0,EUR,COMPLETED,7867.12
Transfer,Savings,2025-09-20 10:05:30,2025-09-20 10:05:30,To pocket EUR Savings from EUR,0.44,0,EUR,COMPLETED,7867.56
Transfer,Savings,2025-09-20 10:59:21,2025-09-20 10:59:21,To pocket EUR Savings from EUR,0.44,0,EUR,COMPLETED,7868
Transfer,Savings,2025-09-20 13:10:03,2025-09-20 13:10:03,To pocket EUR Savings from EUR,0.01,0,EUR,COMPLETED,7868.01
Transfer,Savings,2025-09-21 08:09:00,2025-09-21 08:09:00,To pocket EUR Savings from EUR,0.5,0,EUR,COMPLETED,7868.51
Transfer,Savings,2025-09-21 14:24:06,2025-09-21 14:24:06,To pocket EUR Savings from EUR,0.82,0,EUR,COMPLETED,7869.33
Transfer,Savings,2025-09-22 03:15:48,2025-09-22 03:15:48,To pocket EUR Savings from EUR,20,0,EUR,COMPLETED,7889.33
Transfer,Savings,2025-09-23 08:12:26,2025-09-23 08:12:26,To pocket EUR Savings from EUR,0.01,0,EUR,COMPLETED,7889.34
Transfer,Savings,2025-09-25 12:50:34,2025-09-25 12:50:34,To pocket EUR Savings from EUR,0.2,0,EUR,COMPLETED,7889.54
Transfer,Savings,2025-09-26 12:29:25,2025-09-26 12:29:25,To pocket EUR Savings from EUR,0.12,0,EUR,COMPLETED,7889.66
Transfer,Savings,2025-09-27 03:05:03,2025-09-27 03:05:03,To pocket EUR Savings from EUR,0.01,0,EUR,COMPLETED,7889.67
Transfer,Savings,2025-09-27 08:21:54,2025-09-27 08:21:54,To pocket EUR Savings from EUR,0.5,0,EUR,COMPLETED,7890.17
Transfer,Savings,2025-09-28 07:47:01,2025-09-28 07:47:01,To pocket EUR Savings from EUR,0.5,0,EUR,COMPLETED,7890.67
Transfer,Savings,2025-09-28 08:27:42,2025-09-28 08:27:42,To pocket EUR Savings from EUR,0.38,0,EUR,COMPLETED,7891.05
Transfer,Savings,2025-09-29 03:46:46,2025-09-29 03:46:46,To pocket EUR Savings from EUR,20,0,EUR,COMPLETED,7911.05
Transfer,Savings,2025-09-29 05:52:40,2025-09-29 05:52:40,To pocket EUR Savings from EUR,0.51,0,EUR,COMPLETED,7911.56
Transfer,Savings,2025-09-29 11:26:15,2025-09-29 11:26:15,To pocket EUR Savings from EUR,0.3,0,EUR,COMPLETED,7911.86
Transfer,Savings,2025-09-30 02:54:35,2025-09-30 02:54:35,To pocket EUR Savings from EUR,0.05,0,EUR,COMPLETED,7911.91
Transfer,Savings,2025-10-01 02:39:23,2025-10-01 02:39:23,To pocket EUR Rainy day from EUR,50,0,EUR,COMPLETED,7961.91
Transfer,Savings,2025-10-01 08:35:07,2025-10-01 08:35:07,To pocket EUR Savings from EUR,0.54,0,EUR,COMPLETED,7962.45
Transfer,Current,2025-05-01 02:27:35,2025-05-01 02:27:35,To pocket EUR Rainy day from EUR,-50,0,EUR,COMPLETED,428.17
Transfer,Current,2025-05-01 08:09:31,2025-05-01 08:09:31,To pocket EUR Savings from EUR,-0.5,0,EUR,COMPLETED,427.67
Card Payment,Current,2025-04-30 02:53:35,2025-05-01 09:39:31,Apple,-21.95,0,EUR,COMPLETED,405.72
Transfer,Current,2025-05-01 12:51:04,2025-05-01 12:51:04,To pocket EUR Savings from EUR,-0.67,0,EUR,COMPLETED,405.05
Transfer,Current,2025-05-01 14:13:17,2025-05-01 14:13:17,To pocket EUR Savings from EUR,-0.6,0,EUR,COMPLETED,404.45
Transfer,Current,2025-05-01 16:15:43,2025-05-01 16:15:43,To pocket EUR Savings from EUR,-0.63,0,EUR,COMPLETED,403.82
Card Payment,Current,2025-05-01 08:09:31,2025-05-02 05:52:34,A Padaria Portuguesa,-2.5,0,EUR,COMPLETED,401.32
Card Payment,Current,2025-05-01 14:13:17,2025-05-02 10:27:13,Uber Eats,-3.4,0,EUR,COMPLETED,397.92
Transfer,Current,2025-05-02 12:16:22,2025-05-02 12:16:22,To pocket EUR Savings from EUR,-0.01,0,EUR,COMPLETED,397.91
Card Payment,Current,2025-05-01 16:15:43,2025-05-02 15:31:45,Claude.ai,-27.37,0,EUR,COMPLETED,370.54
Deposit,Current,2025-05-02 17:57:22,2025-05-02 17:57:23,Apple Pay deposit by *0264,200,0,EUR,COMPLETED,570.54
Transfer,Current,2025-05-03 08:38:24,2025-05-03 08:38:24,To pocket EUR Savings from EUR,-0.41,0,EUR,COMPLETED,570.13
Transfer,Current,2025-05-03 10:29:03,2025-05-03 10:29:03,To pocket EUR Savings from EUR,-0.8,0,EUR,COMPLETED,569.33
Card Payment,Current,2025-04-30 12:05:08,2025-05-03 11:03:03,Uber Eats,-35.56,0,EUR,COMPLETED,533.77
Transfer,Current,2025-05-03 18:25:31,2025-05-03 18:25:31,To pocket EUR Savings from EUR,-0.55,0,EUR,COMPLETED,533.22
Transfer,Current,2025-05-03 18:26:24,2025-05-03 18:26:24,To pocket EUR Savings from EUR,-1,0,EUR,COMPLETED,532.22
Card Payment,Current,2025-05-03 18:25:30,2025-05-04 05:32:09,Cinemacity Alfragide,-14.45,0,EUR,COMPLETED,517.77
Card Payment,Current,2025-05-03 18:26:23,2025-05-04 05:32:09,Cinemacity Alfragide,-2,0,EUR,COMPLETED,515.77
Card Payment,Current,2025-05-03 10:29:02,2025-05-04 06:39:22,Talho Super Desconto,-33.2,0,EUR,COMPLETED,482.57
Transfer,Current,2025-05-04 08:33:35,2025-05-04 08:33:35,To pocket EUR Savings from EUR,-0.5,0,EUR,COMPLETED,482.07
Transfer,Current,2025-05-04 09:20:35,2025-05-04 09:20:35,To pocket EUR Savings from EUR,-0.52,0,EUR,COMPLETED,481.55
Card Payment,Current,2025-05-02 12:16:22,2025-05-04 13:40:19,PlayStation,-8.99,0,EUR,COMPLETED,472.56
Card Payment,Current,2025-05-01 12:51:03,2025-05-04 13:52:43,Uber Eats,-36.33,0,EUR,COMPLETED,436.23
Transfer,Current,2025-05-04 14:52:02,2025-05-04 14:52:02,To pocket EUR Savings from EUR,-1,0,EUR,COMPLETED,435.23
Transfer,Current,2025-05-04 17:49:42,2025-05-04 17:49:42,To pocket EUR Savings from EUR,-0.4,0,EUR,COMPLETED,434.83
Transfer,Current,2025-05-05 03:04:50,2025-05-05 03:04:50,To pocket EUR Savings from EUR,-20,0,EUR,COMPLETED,414.83
Card Payment,Current,2025-05-04 14:52:01,2025-05-05 06:07:17,Scut,-5,0,EUR,COMPLETED,409.83
Card Payment,Current,2025-05-04 08:33:34,2025-05-05 07:16:50,A Padaria Portuguesa,-2.5,0,EUR,COMPLETED,407.33
Card Payment,Current,2025-05-04 09:20:34,2025-05-05 10:21:31,Pingo Doce,-41.48,0,EUR,COMPLETED,365.85
Card Payment,Current,2025-05-04 17:49:41,2025-05-05 10:21:58,Pq Est Hosp Soerad,-3.6,0,EUR,COMPLETED,362.25
Card Payment,Current,2025-05-05 11:26:54,2025-05-06 16:06:12,Cursor,-17.73,0,EUR,COMPLETED,344.52
Card Payment,Current,2025-05-03 08:38:23,2025-05-06 19:08:16,Paddle,-24.59,0,EUR,COMPLETED,319.93
Transfer,Current,2025-05-06 19:37:02,2025-05-06 19:37:02,To pocket EUR Savings from EUR,-0.69,0,EUR,COMPLETED,319.24
Card Payment,Current,2025-05-06 19:37:02,2025-05-07 16:18:37,Codeium,-16.31,0,EUR,COMPLETED,302.93
Transfer,Current,2025-05-08 12:00:51,2025-05-08 12:00:51,To pocket EUR Savings from EUR,-0.47,0,EUR,COMPLETED,302.46
Transfer,Current,2025-05-08 19:23:01,2025-05-08 19:23:01,To pocket EUR Savings from EUR,-0.71,0,EUR,COMPLETED,301.75
Card Payment,Current,2025-05-08 19:23:00,2025-05-09 07:32:20,Minipreço,-3.29,0,EUR,COMPLETED,298.46
Transfer,Current,2025-05-09 08:16:46,2025-05-09 08:16:46,To pocket EUR Savings from EUR,-0.09,0,EUR,COMPLETED,298.37
Deposit,Current,2025-05-09 15:15:13,2025-05-09 15:15:15,Apple Pay deposit by *0264,200,0,EUR,COMPLETED,498.37
Transfer,Current,2025-05-09 15:17:55,2025-05-09 15:17:55,To pocket EUR Savings from EUR,-0.64,0,EUR,COMPLETED,497.73
Card Payment,Current,2025-05-08 12:00:51,2025-05-09 19:52:01,Uber Eats,-23.53,0,EUR,COMPLETED,474.2
Transfer,Current,2025-05-10 03:38:13,2025-05-10 03:38:13,To pocket EUR Savings from EUR,-1,0,EUR,COMPLETED,473.2
Transfer,Current,2025-05-10 08:19:47,2025-05-10 08:19:47,To pocket EUR Savings from EUR,-0.5,0,EUR,COMPLETED,472.7
Deposit,Current,2025-05-10 08:20:05,2025-05-10 08:20:06,Apple Pay deposit by *0264,200,0,EUR,COMPLETED,672.7
Transfer,Current,2025-05-10 17:17:36,2025-05-10 17:17:36,To pocket EUR Savings from EUR,-0.99,0,EUR,COMPLETED,671.71
Card Payment,Current,2025-05-09 15:17:54,2025-05-10 22:22:17,Codeium,-11.36,0,EUR,COMPLETED,660.35
Card Payment,Current,2025-05-10 17:17:36,2025-05-11 06:39:58,Minipreço,-15.01,0,EUR,COMPLETED,645.34
Card Payment,Current,2025-05-10 08:19:46,2025-05-11 06:58:25,A Padaria Portuguesa,-2.5,0,EUR,COMPLETED,642.84
Transfer,Current,2025-05-11 07:52:24,2025-05-11 07:52:24,To pocket EUR Savings from EUR,-0.5,0,EUR,COMPLETED,642.34
Card Refund,Current,2025-05-10 10:23:13,2025-05-11 09:15:03,Ikeaportuga 15,14,0,EUR,COMPLETED,656.34
Transfer,Current,2025-05-11 12:43:35,2025-05-11 12:43:35,To pocket EUR Savings from EUR,-0.16,0,EUR,COMPLETED,656.18
Transfer,Current,2025-05-11 14:05:41,2025-05-11 14:05:41,To pocket EUR Savings from EUR,-0.61,0,EUR,COMPLETED,655.57
Transfer,Current,2025-05-11 21:14:01,2025-05-11 21:14:01,To pocket EUR Savings from EUR,-0.5,0,EUR,COMPLETED,655.07
Transfer,Current,2025-05-12 03:14:10,2025-05-12 03:14:10,To pocket EUR Savings from EUR,-20,0,EUR,COMPLETED,635.07
Card Payment,Current,2025-05-11 07:52:24,2025-05-12 07:52:58,A Padaria Portuguesa,-2.5,0,EUR,COMPLETED,632.57
Transfer,Current,2025-05-12 07:53:04,2025-05-12 07:53:04,To pocket EUR Savings from EUR,-0.5,0,EUR,COMPLETED,632.07
Transfer,Current,2025-05-12 11:09:06,2025-05-12 11:09:06,To pocket EUR Savings from EUR,-0.4,0,EUR,COMPLETED,631.67
Transfer,Current,2025-05-12 11:30:10,2025-05-12 11:30:10,To pocket EUR Savings from EUR,-1,0,EUR,COMPLETED,630.67
Card Payment,Current,2025-05-09 08:16:45,2025-05-12 12:16:31,Ikeaportuga 15,-160.91,0,EUR,COMPLETED,469.76
Card Payment,Current,2025-05-11 14:05:41,2025-05-12 12:38:02,Uber Eats,-1.39,0,EUR,COMPLETED,468.37
Card Payment,Current,2025-05-10 03:38:12,2025-05-12 12:38:03,Publicocomu,-76,0,EUR,COMPLETED,392.37
Transfer,Current,2025-05-12 21:19:52,2025-05-12 21:19:52,To pocket EUR Savings from EUR,-0.9,0,EUR,COMPLETED,391.47
Card Payment,Current,2025-05-11 21:14:00,2025-05-13 05:36:14,Rest Sete Castelos,-22.5,0,EUR,COMPLETED,368.97
Card Payment,Current,2025-05-12 07:53:03,2025-05-13 07:01:23,A Padaria Portuguesa,-2.5,0,EUR,COMPLETED,366.47
Transfer,Current,2025-05-13 10:14:36,2025-05-13 10:14:36,To pocket EUR Savings from EUR,-0.9,0,EUR,COMPLETED,365.57
Card Payment,Current,2025-05-11 12:43:35,2025-05-13 10:29:34,Uber Eats,-14.84,0,EUR,COMPLETED,350.73
Card Refund,Current,2025-05-12 09:50:18,2025-05-13 10:30:02,Publicocomu,76,0,EUR,COMPLETED,426.73
Transfer,Current,2025-05-13 13:44:34,2025-05-13 13:44:34,To pocket EUR Savings from EUR,-0.4,0,EUR,COMPLETED,426.33
Transfer,Current,2025-05-13 13:55:41,2025-05-13 13:55:41,To pocket EUR Savings from EUR,-0.19,0,EUR,COMPLETED,426.14
Card Payment,Current,2025-05-12 11:09:05,2025-05-13 16:04:18,Music Factory,-8.6,0,EUR,COMPLETED,417.54
Card Payment,Current,2025-05-12 11:30:09,2025-05-13 17:06:37,IKEA,-45,0,EUR,COMPLETED,372.54
Transfer,Current,2025-05-13 17:50:57,2025-05-13 17:50:57,To pocket EUR Savings from EUR,-1,0,EUR,COMPLETED,371.54
Deposit,Current,2025-05-13 17:51:38,2025-05-13 17:51:40,Apple Pay deposit by *0264,200,0,EUR,COMPLETED,571.54
Transfer,Current,2025-05-13 21:09:15,2025-05-13 21:09:15,To pocket EUR Savings from EUR,-0.6,0,EUR,COMPLETED,570.94
Card Payment,Current,2025-05-13 13:55:40,2025-05-14 05:57:45,Minipreço,-6.81,0,EUR,COMPLETED,564.13
Card Payment,Current,2025-05-13 13:44:33,2025-05-14 05:57:45,Alvaros Cafe Unipess,-23.6,0,EUR,COMPLETED,540.53
Card Payment,Current,2025-05-13 10:14:35,2025-05-14 09:39:40,Brisa,-8.1,0,EUR,COMPLETED,532.43
Card Payment,Current,2025-05-12 21:19:51,2025-05-14 09:39:45,La Siesta Cocina Mexicana,-62.1,0,EUR,COMPLETED,470.33
Transfer,Current,2025-05-14 13:53:11,2025-05-14 13:53:11,To pocket EUR Savings from EUR,-0.7,0,EUR,COMPLETED,469.63
Transfer,Current,2025-05-14 14:07:42,2025-05-14 14:07:42,To pocket EUR Savings from EUR,-0.02,0,EUR,COMPLETED,469.61
Transfer,Current,2025-05-14 17:17:15,2025-05-14 17:17:15,To pocket EUR Savings from EUR,-0.13,0,EUR,COMPLETED,469.48
Transfer,Current,2025-05-14 17:50:35,2025-05-14 17:50:35,To pocket EUR Savings from EUR,-1,0,EUR,COMPLETED,468.48
Card Payment,Current,2025-05-13 17:50:56,2025-05-14 18:38:09,Hospitaldal,-30,0,EUR,COMPLETED,438.48
Transfer,Current,2025-05-14 19:35:02,2025-05-14 19:35:02,To pocket EUR Savings from EUR,-0.8,0,EUR,COMPLETED,437.68
Card Payment,Current,2025-05-14 13:53:10,2025-05-15 06:08:03,Cafe Rest Beira Rio,-23.3,0,EUR,COMPLETED,414.38
Card Payment,Current,2025-05-14 19:35:01,2025-05-15 06:08:03,Isabel Bandeira,-7.2,0,EUR,COMPLETED,407.18
Card Payment,Current,2025-05-14 14:07:41,2025-05-15 06:10:49,Minipreço,-4.98,0,EUR,COMPLETED,402.2
Card Payment,Current,2025-05-14 17:17:14,2025-05-15 06:10:49,Minipreço,-10.87,0,EUR,COMPLETED,391.33
Card Payment,Current,2025-05-13 21:09:14,2025-05-15 06:10:58,Alvaros,-30.4,0,EUR,COMPLETED,360.93
Transfer,Current,2025-05-15 15:34:23,2025-05-15 15:34:23,To pocket EUR Savings from EUR,-1,0,EUR,COMPLETED,359.93
Transfer,Current,2025-05-15 17:02:39,2025-05-15 17:02:39,To pocket EUR Savings from EUR,-1,0,EUR,COMPLETED,358.93
Transfer,Current,2025-05-15 17:57:51,2025-05-15 17:57:51,To pocket EUR Savings from EUR,-0.6,0,EUR,COMPLETED,358.33
Card Payment,Current,2025-05-14 17:50:35,2025-05-15 18:48:30,Zaask,-99,0,EUR,COMPLETED,259.33
Card Payment,Current,2025-05-15 17:57:50,2025-05-16 05:58:28,Cafe Rest Beira Rio,-5.4,0,EUR,COMPLETED,253.93
Card Payment,Current,2025-05-15 17:02:39,2025-05-16 11:23:53,Miió,-20,0,EUR,COMPLETED,233.93
Transfer,Current,2025-05-16 12:20:26,2025-05-16 12:20:26,To pocket EUR Savings from EUR,-0.5,0,EUR,COMPLETED,233.43
Transfer,Current,2025-05-16 19:43:05,2025-05-16 19:43:05,To pocket EUR Savings from EUR,-0.31,0,EUR,COMPLETED,233.12
Card Payment,Current,2025-05-15 15:34:23,2025-05-16 19:58:46,Miió,-20,0,EUR,COMPLETED,213.12
Card Payment,Current,2025-05-16 12:20:25,2025-05-17 05:40:06,C C Pombalinho,-12.5,0,EUR,COMPLETED,200.62
Transfer,Current,2025-05-17 07:54:31,2025-05-17 07:54:31,To pocket EUR Savings from EUR,-0.5,0,EUR,COMPLETED,200.12
Transfer,Current,2025-05-17 09:42:41,2025-05-17 09:42:41,To pocket EUR Savings from EUR,-0.24,0,EUR,COMPLETED,199.88
Card Payment,Current,2025-05-17 09:42:40,2025-05-18 05:32:32,Talho Super Desconto,-23.76,0,EUR,COMPLETED,176.12
Card Payment,Current,2025-05-17 07:54:31,2025-05-18 05:34:08,A Padaria Portuguesa,-2.5,0,EUR,COMPLETED,173.62
Transfer,Current,2025-05-18 08:25:32,2025-05-18 08:25:32,To pocket EUR Savings from EUR,-0.5,0,EUR,COMPLETED,173.12
Deposit,Current,2025-05-18 08:26:05,2025-05-18 08:26:06,Apple Pay deposit by *0264,200,0,EUR,COMPLETED,373.12
Transfer,Current,2025-05-18 09:03:26,2025-05-18 09:03:26,To pocket EUR Savings from EUR,-0.13,0,EUR,COMPLETED,372.99
Transfer,Current,2025-05-19 03:03:53,2025-05-19 03:03:53,To pocket EUR Savings from EUR,-20,0,EUR,COMPLETED,352.99
Card Payment,Current,2025-05-18 08:25:31,2025-05-19 07:02:20,A Padaria Portuguesa,-2.5,0,EUR,COMPLETED,350.49
Transfer,Current,2025-05-19 07:46:35,2025-05-19 07:46:35,To pocket EUR Savings from EUR,-0.87,0,EUR,COMPLETED,349.62
Transfer,Current,2025-05-19 07:50:51,2025-05-19 07:50:51,To pocket EUR Savings from EUR,-0.87,0,EUR,COMPLETED,348.75
Transfer,Current,2025-05-19 08:22:20,2025-05-19 08:22:20,To pocket EUR Savings from EUR,-0.26,0,EUR,COMPLETED,348.49
Transfer,Current,2025-05-19 11:15:32,2025-05-19 11:15:32,To pocket EUR Savings from EUR,-0.52,0,EUR,COMPLETED,347.97
Card Payment,Current,2025-05-18 09:03:26,2025-05-19 11:44:34,Pingo Doce,-55.87,0,EUR,COMPLETED,292.1
Card Payment,Current,2025-05-16 19:43:04,2025-05-19 13:45:22,Uber Eats,-17.69,0,EUR,COMPLETED,274.41
Card Payment,Current,2025-05-19 08:22:20,2025-05-20 06:13:12,UK Visas and Immigration,-19.74,0,EUR,COMPLETED,254.67
Transfer,Current,2025-05-20 13:10:03,2025-05-20 13:10:03,To pocket EUR Savings from EUR,-0.01,0,EUR,COMPLETED,254.66
Card Payment,Current,2025-05-19 07:46:34,2025-05-20 13:25:55,Worten,-39.13,0,EUR,COMPLETED,215.53
Card Payment,Current,2025-05-19 07:50:51,2025-05-20 13:25:55,Worten,-39.13,0,EUR,COMPLETED,176.4
Transfer,Current,2025-05-20 15:38:08,2025-05-20 15:38:08,To pocket EUR Savings from EUR,-0.05,0,EUR,COMPLETED,176.35
Card Payment,Current,2025-05-19 11:15:32,2025-05-20 18:32:49,Claude.ai,-5.48,0,EUR,COMPLETED,170.87
Transfer,Current,2025-05-21 09:01:40,2025-05-21 09:01:40,To pocket EUR Savings from EUR,-0.85,0,EUR,COMPLETED,170.02
Card Payment,Current,2025-05-20 13:10:03,2025-05-21 14:47:39,Uber,-4.99,0,EUR,COMPLETED,165.03
Card Payment,Current,2025-05-20 15:38:08,2025-05-21 17:37:34,OpenAI,-21.95,0,EUR,COMPLETED,143.08
Transfer,Current,2025-05-21 17:37:48,2025-05-21 17:37:48,To pocket EUR Savings from EUR,-0.83,0,EUR,COMPLETED,142.25
Transfer,Current,2025-05-22 12:47:37,2025-05-22 12:47:37,To pocket EUR Savings from EUR,-0.6,0,EUR,COMPLETED,141.65
Card Payment,Current,2025-05-21 09:01:40,2025-05-22 15:56:11,Uber,-8.15,0,EUR,COMPLETED,133.5
Card Payment,Current,2025-05-21 17:37:47,2025-05-22 15:56:13,Uber,-7.17,0,EUR,COMPLETED,126.33
Transfer,Current,2025-05-23 08:12:26,2025-05-23 08:12:26,To pocket EUR Savings from EUR,-0.01,0,EUR,COMPLETED,126.32
Transfer,Current,2025-05-23 20:13:23,2025-05-23 20:13:23,To pocket EUR Savings from EUR,-1,0,EUR,COMPLETED,125.32
Transfer,Current,2025-05-24 08:17:40,2025-05-24 08:17:40,To pocket EUR Savings from EUR,-0.5,0,EUR,COMPLETED,124.82
Deposit,Current,2025-05-24 08:18:08,2025-05-24 08:18:09,Apple Pay deposit by *0264,200,0,EUR,COMPLETED,324.82
Transfer,Current,2025-05-24 10:23:44,2025-05-24 10:23:44,To pocket EUR Savings from EUR,-0.01,0,EUR,COMPLETED,324.81
Transfer,Current,2025-05-24 12:28:10,2025-05-24 12:28:10,To pocket EUR Savings from EUR,-0.78,0,EUR,COMPLETED,324.03
Transfer,Current,2025-05-24 17:13:13,2025-05-24 17:13:13,To pocket EUR Savings from EUR,-0.26,0,EUR,COMPLETED,323.77
Card Payment,Current,2025-05-23 20:13:23,2025-05-24 18:24:32,GitHub,-4,0,EUR,COMPLETED,319.77
Card Payment,Current,2025-05-24 10:23:43,2025-05-25 05:53:05,Roady Sao Domingos D,-3.99,0,EUR,COMPLETED,315.78
Card Payment,Current,2025-05-24 08:17:39,2025-05-25 05:53:10,A Padaria Portuguesa,-2.5,0,EUR,COMPLETED,313.28
Transfer,Current,2025-05-25 07:14:15,2025-05-25 07:14:15,To pocket EUR Savings from EUR,-0.5,0,EUR,COMPLETED,312.78
Deposit,Current,2025-05-25 07:14:49,2025-05-25 07:14:50,Apple Pay deposit by *0264,200,0,EUR,COMPLETED,512.78
Transfer,Current,2025-05-25 08:14:48,2025-05-25 08:14:48,To pocket EUR Savings from EUR,-0.33,0,EUR,COMPLETED,512.45
Deposit,Current,2025-05-25 09:16:15,2025-05-25 09:16:17,Apple Pay deposit by *0264,500,0,EUR,COMPLETED,1012.45
Transfer,Current,2025-05-25 09:16:42,2025-05-25 09:16:42,To pocket EUR Savings from EUR,-0.95,0,EUR,COMPLETED,1011.5
Card Payment,Current,2025-05-22 12:47:37,2025-05-25 12:06:07,Uber Eats,-24.4,0,EUR,COMPLETED,987.1
Card Payment,Current,2025-05-23 08:12:25,2025-05-25 12:35:11,Google,-17.99,0,EUR,COMPLETED,969.11
Card Payment,Current,2025-05-24 17:13:13,2025-05-25 14:42:20,GitHub,-10.74,0.11,EUR,COMPLETED,958.26
Transfer,Current,2025-05-26 03:01:51,2025-05-26 03:01:51,To pocket EUR Savings from EUR,-20,0,EUR,COMPLETED,938.26
Card Payment,Current,2025-05-25 09:16:41,2025-05-26 06:07:59,Roady Sao Domingos D,-528.05,0,EUR,COMPLETED,410.21
Card Payment,Current,2025-05-25 07:14:15,2025-05-26 06:08:01,A Padaria Portuguesa,-2.5,0,EUR,COMPLETED,407.71
Transfer,Current,2025-05-26 11:16:42,2025-05-26 11:16:42,To pocket EUR Savings from EUR,-0.86,0,EUR,COMPLETED,406.85
Card Payment,Current,2025-05-25 08:14:47,2025-05-26 12:19:07,Pingo Doce,-49.67,0,EUR,COMPLETED,357.18
Transfer,Current,2025-05-26 12:40:25,2025-05-26 12:40:25,To pocket EUR Savings from EUR,-0.14,0,EUR,COMPLETED,357.04
Transfer,Current,2025-05-26 15:31:56,2025-05-26 15:31:56,To pocket EUR Savings from EUR,-0.86,0,EUR,COMPLETED,356.18
Transfer,Current,2025-05-27 02:13:43,2025-05-27 02:13:43,To pocket EUR Savings from EUR,-0.01,0,EUR,COMPLETED,356.17
Card Payment,Current,2025-05-26 11:16:41,2025-05-27 03:54:56,Anthropic,-22.14,0,EUR,COMPLETED,334.03
Card Payment,Current,2025-05-24 12:28:10,2025-05-27 12:35:07,Uber Eats,-18.22,0,EUR,COMPLETED,315.81
Card Payment,Current,2025-05-26 12:40:24,2025-05-27 14:45:48,Claude.ai,-10.86,0,EUR,COMPLETED,304.95
Card Payment,Current,2025-05-26 15:31:56,2025-05-27 14:46:13,Claude.ai,-27.14,0,EUR,COMPLETED,277.81
Transfer,Current,2025-05-27 17:28:13,2025-05-27 17:28:13,To pocket EUR Savings from EUR,-0.74,0,EUR,COMPLETED,277.07
Card Payment,Current,2025-05-27 02:13:43,2025-05-28 13:07:13,Netflix,-12.99,0,EUR,COMPLETED,264.08
Card Payment,Current,2025-05-27 17:28:13,2025-05-28 15:24:39,Claude.ai,-27.26,0,EUR,COMPLETED,236.82
Transfer,Current,2025-05-29 05:52:28,2025-05-29 05:52:28,To pocket EUR Savings from EUR,-0.51,0,EUR,COMPLETED,236.31
Transfer,Current,2025-05-29 12:29:42,2025-05-29 12:29:42,To pocket EUR Savings from EUR,-0.05,0,EUR,COMPLETED,236.26
Deposit,Current,2025-05-29 12:30:49,2025-05-29 12:30:50,Apple Pay deposit by *0264,200,0,EUR,COMPLETED,436.26
Transfer,Current,2025-05-29 12:31:31,2025-05-29 12:31:31,To pocket EUR Savings from EUR,-0.44,0,EUR,COMPLETED,435.82
Transfer,Current,2025-05-29 14:18:49,2025-05-29 14:18:49,To pocket EUR Savings from EUR,-0.29,0,EUR,COMPLETED,435.53
Transfer,Current,2025-05-29 17:40:44,2025-05-29 17:40:44,To pocket EUR Savings from EUR,-1,0,EUR,COMPLETED,434.53
Transfer,Current,2025-05-30 02:55:33,2025-05-30 02:55:33,To pocket EUR Savings from EUR,-0.05,0,EUR,COMPLETED,434.48
Card Payment,Current,2025-05-29 05:52:28,2025-05-30 11:18:15,Apple,-5.49,0,EUR,COMPLETED,428.99
Card Payment,Current,2025-05-29 17:40:43,2025-05-30 16:33:36,Hospital Da Luz Oeir,-30,0,EUR,COMPLETED,398.99
Card Payment,Current,2025-05-29 12:29:42,2025-05-30 17:19:27,Claude.ai,-10.95,0,EUR,COMPLETED,388.04
Card Payment,Current,2025-05-29 14:18:48,2025-05-30 17:19:40,Cursor,-17.71,0,EUR,COMPLETED,370.33
Transfer,Current,2025-05-31 07:58:08,2025-05-31 07:58:08,To pocket EUR Savings from EUR,-1,0,EUR,COMPLETED,369.33
Deposit,Current,2025-05-31 08:15:18,2025-05-31 08:15:19,Apple Pay deposit by *0264,200,0,EUR,COMPLETED,569.33
Transfer,Current,2025-05-31 09:08:42,2025-05-31 09:08:42,To pocket EUR Savings from EUR,-0.3,0,EUR,COMPLETED,569.03
Transfer,Current,2025-05-31 10:44:01,2025-05-31 10:44:01,To pocket EUR Savings from EUR,-0.52,0,EUR,COMPLETED,568.51
Transfer,Current,2025-05-31 20:07:22,2025-05-31 20:07:22,To pocket EUR Savings from EUR,-0.15,0,EUR,COMPLETED,568.36
Transfer,Current,2025-06-01 02:25:27,2025-06-01 02:25:27,To pocket EUR Rainy day from EUR,-50,0,EUR,COMPLETED,518.36
Card Payment,Current,2025-05-31 10:44:01,2025-06-01 05:56:48,Farmacia Sta Rita,-0.48,0,EUR,COMPLETED,517.88
Card Payment,Current,2025-05-31 09:08:42,2025-06-01 06:08:21,Intermarché,-3.7,0,EUR,COMPLETED,514.18
Card Payment,Current,2025-05-31 07:58:08,2025-06-01 06:08:24,Repsol,-20,0,EUR,COMPLETED,494.18
Transfer,Current,2025-06-01 07:43:36,2025-06-01 07:43:36,To pocket EUR Savings from EUR,-0.5,0,EUR,COMPLETED,493.68
Transfer,Current,2025-06-01 08:18:53,2025-06-01 08:18:53,To pocket EUR Savings from EUR,-0.72,0,EUR,COMPLETED,492.96
Card Payment,Current,2025-05-29 12:31:31,2025-06-01 11:22:31,Uber Eats,-35.56,0,EUR,COMPLETED,457.4
Card Payment,Current,2025-05-30 02:55:32,2025-06-01 11:23:44,Apple,-21.95,0,EUR,COMPLETED,435.45
Transfer,Current,2025-06-01 12:41:23,2025-06-01 12:41:23,To pocket EUR Savings from EUR,-1,0,EUR,COMPLETED,434.45
Transfer,Current,2025-06-01 12:52:48,2025-06-01 12:52:48,To pocket EUR Savings from EUR,-0.6,0,EUR,COMPLETED,433.85
Transfer,Current,2025-06-01 13:31:58,2025-06-01 13:31:58,To pocket EUR Savings from EUR,-0.7,0,EUR,COMPLETED,433.15
Card Payment,Current,2025-05-31 20:07:21,2025-06-01 15:32:49,IKEA,-17.85,0,EUR,COMPLETED,415.3
Transfer,Current,2025-06-02 03:00:40,2025-06-02 03:00:40,To pocket EUR Savings from EUR,-20,0,EUR,COMPLETED,395.3
Card Payment,Current,2025-06-01 07:43:36,2025-06-02 05:56:10,A Padaria Portuguesa,-2.5,0,EUR,COMPLETED,392.8
Card Payment,Current,2025-06-01 12:41:22,2025-06-02 05:56:12,Saisish,-28,0,EUR,COMPLETED,364.8
Card Payment,Current,2025-06-01 08:18:52,2025-06-02 09:15:21,Pingo Doce,-35.28,0,EUR,COMPLETED,329.52
Card Payment,Current,2025-06-01 12:52:47,2025-06-02 09:15:30,Mercado de Algés,-13.4,0,EUR,COMPLETED,316.12
Card Payment,Current,2025-06-01 13:31:57,2025-06-02 09:15:30,Mercado de Algés,-3.3,0,EUR,COMPLETED,312.82
Transfer,Current,2025-06-02 12:16:13,2025-06-02 12:16:13,To pocket EUR Savings from EUR,-0.01,0,EUR,COMPLETED,312.81
Transfer,Current,2025-06-02 15:57:50,2025-06-02 15:57:50,To pocket EUR Savings from EUR,-1,0,EUR,COMPLETED,311.81
Deposit,Current,2025-06-02 15:58:43,2025-06-02 15:58:44,Apple Pay deposit by *0264,200,0,EUR,COMPLETED,511.81
Card Payment,Current,2025-06-02 15:57:49,2025-06-03 14:06:55,Hospital Da Luz Oeir,-64,0,EUR,COMPLETED,447.81
Card Payment,Current,2025-06-02 12:16:10,2025-06-04 10:26:08,PlayStation,-8.99,0,EUR,COMPLETED,438.82
Transfer,Current,2025-06-04 12:34:48,2025-06-04 12:34:48,To pocket EUR Savings from EUR,-0.78,0,EUR,COMPLETED,438.04
Transfer,Current,2025-06-04 13:42:04,2025-06-04 13:42:04,To pocket EUR Savings from EUR,-1,0,EUR,COMPLETED,437.04
Transfer,Current,2025-06-04 16:40:12,2025-06-04 16:40:12,To pocket EUR Savings from EUR,-0.41,0,EUR,COMPLETED,436.63
Card Payment,Current,2025-06-04 16:40:11,2025-06-05 06:21:25,Apreslar Unip.lda,-160.59,0,EUR,COMPLETED,276.04
Deposit,Current,2025-06-05 07:14:32,2025-06-05 07:14:33,Apple Pay deposit by *0264,200,0,EUR,COMPLETED,476.04
Card Payment,Current,2025-06-04 13:42:04,2025-06-05 10:27:21,Hospitaldal,-16,0,EUR,COMPLETED,460.04
Transfer,Current,2025-06-05 12:02:47,2025-06-05 12:02:47,To pocket EUR Savings from EUR,-0.34,0,EUR,COMPLETED,459.7
Transfer,Current,2025-06-05 12:27:28,2025-06-05 12:27:28,To pocket EUR Savings from EUR,-0.41,0,EUR,COMPLETED,459.29
Transfer,Current,2025-06-05 12:48:45,2025-06-05 12:48:45,To pocket EUR Savings from EUR,-0.48,0,EUR,COMPLETED,458.81
Transfer,Current,2025-06-05 16:00:51,2025-06-05 16:00:51,To pocket EUR Savings from EUR,-1,0,EUR,COMPLETED,457.81
Card Payment,Current,2025-06-05 12:27:28,2025-06-06 16:24:32,Cursor,-17.59,0,EUR,COMPLETED,440.22
Transfer,Current,2025-06-06 19:02:58,2025-06-06 19:02:58,To pocket EUR Savings from EUR,-0.62,0,EUR,COMPLETED,439.6
Transfer,Current,2025-06-06 20:08:57,2025-06-06 20:08:57,To pocket EUR Savings from EUR,-0.03,0,EUR,COMPLETED,439.57
Transfer,Current,2025-06-07 07:19:41,2025-06-07 07:19:41,To pocket EUR Savings from EUR,-0.5,0,EUR,COMPLETED,439.07
Card Payment,Current,2025-06-04 12:34:48,2025-06-07 12:42:40,Uber Eats,-18.22,0,EUR,COMPLETED,420.85
Card Payment,Current,2025-06-05 16:00:50,2025-06-07 12:42:43,Hospitaldal,-16,0,EUR,COMPLETED,404.85
Card Payment,Current,2025-06-05 12:48:44,2025-06-07 12:42:44,Uber,-7.52,0,EUR,COMPLETED,397.33
Card Payment,Current,2025-06-05 12:02:47,2025-06-07 12:58:35,Uber Eats,-31.66,0,EUR,COMPLETED,365.67
Transfer,Current,2025-06-07 14:10:09,2025-06-07 14:10:09,To pocket EUR Savings from EUR,-0.5,0,EUR,COMPLETED,365.17
Card Payment,Current,2025-06-07 14:10:08,2025-06-08 05:50:20,Tertulia Delirante,-27.5,0,EUR,COMPLETED,337.67
Card Payment,Current,2025-06-07 07:19:40,2025-06-08 06:36:00,A Padaria Portuguesa,-2.5,0,EUR,COMPLETED,335.17
Transfer,Current,2025-06-08 08:31:56,2025-06-08 08:31:56,To pocket EUR Savings from EUR,-0.5,0,EUR,COMPLETED,334.67
Transfer,Current,2025-06-08 13:46:18,2025-06-08 13:46:18,To pocket EUR Savings from EUR,-0.65,0,EUR,COMPLETED,334.02
Transfer,Current,2025-06-08 15:29:27,2025-06-08 15:29:27,To pocket EUR Savings from EUR,-0.41,0,EUR,COMPLETED,333.61
Deposit,Current,2025-06-08 15:29:57,2025-06-08 15:29:58,Apple Pay deposit by *0264,400,0,EUR,COMPLETED,733.61
Transfer,Current,2025-06-08 23:21:35,2025-06-08 23:21:35,To pocket EUR Savings from EUR,-0.02,0,EUR,COMPLETED,733.59
Transfer,Current,2025-06-09 02:59:19,2025-06-09 02:59:19,To pocket EUR Savings from EUR,-20,0,EUR,COMPLETED,713.59
Card Payment,Current,2025-06-08 23:21:34,2025-06-09 05:41:59,Mocha Eats 2,-2.98,0,EUR,COMPLETED,710.61
Card Payment,Current,2025-06-08 08:31:56,2025-06-09 05:43:19,A Padaria Portuguesa,-2.5,0,EUR,COMPLETED,708.11
Card Payment,Current,2025-06-08 13:46:18,2025-06-09 05:43:21,Feito Portugal,-6.35,0,EUR,COMPLETED,701.76
Card Refund,Current,2025-06-07 14:36:37,2025-06-09 06:01:02,Tertulia Delirante,1,0,EUR,COMPLETED,702.76
Card Payment,Current,2025-06-09 00:59:59,2025-06-09 12:34:07,Transport for London,-3.35,0,EUR,COMPLETED,699.41
Transfer,Current,2025-06-09 12:34:08,2025-06-09 12:34:08,To pocket EUR Savings from EUR,-0.65,0,EUR,COMPLETED,698.76
Card Payment,Current,2025-06-06 20:08:57,2025-06-09 14:11:14,Uber Eats,-11.97,0,EUR,COMPLETED,686.79
Card Payment,Current,2025-06-06 19:02:57,2025-06-09 16:13:33,GitHub,-34.38,0,EUR,COMPLETED,652.41
Transfer,Current,2025-06-09 21:16:57,2025-06-09 21:16:57,To pocket EUR Savings from EUR,-0.02,0,EUR,COMPLETED,652.39
Card Payment,Current,2025-06-09 21:16:57,2025-06-10 06:24:57,Mocha Eats 2,-2.98,0,EUR,COMPLETED,649.41
Card Payment,Current,2025-06-10 00:59:59,2025-06-10 15:14:48,Transport for London,-10.57,0,EUR,COMPLETED,638.84
Transfer,Current,2025-06-10 15:14:48,2025-06-10 15:14:48,To pocket EUR Savings from EUR,-0.43,0,EUR,COMPLETED,638.41
Card Payment,Current,2025-06-08 15:29:26,2025-06-11 14:37:32,Heathrowexp,-47.59,0.48,EUR,COMPLETED,590.34
Transfer,Current,2025-06-11 16:15:51,2025-06-11 16:15:51,To pocket EUR Savings from EUR,-0.03,0,EUR,COMPLETED,590.31
Transfer,Current,2025-06-11 21:40:10,2025-06-11 21:40:10,To pocket EUR Savings from EUR,-0.16,0,EUR,COMPLETED,590.15
Transfer,Current,2025-06-11 23:07:29,2025-06-11 23:07:29,To pocket EUR Savings from EUR,-0.16,0,EUR,COMPLETED,589.99
Card Payment,Current,2025-06-11 21:40:09,2025-06-12 03:08:55,Kimchee Restaurant,-60.84,0,EUR,COMPLETED,529.15
Card Payment,Current,2025-06-11 16:15:50,2025-06-12 03:12:28,Aveba Ltd,-2.97,0,EUR,COMPLETED,526.18
Card Payment,Current,2025-06-11 23:07:29,2025-06-12 12:05:08,TAP Air Portugal,-59.84,0,EUR,COMPLETED,466.34
Card Payment,Current,2025-06-11 00:59:59,2025-06-12 12:06:50,Transport for London,-6.83,0,EUR,COMPLETED,459.51
Transfer,Current,2025-06-12 12:06:51,2025-06-12 12:06:51,To pocket EUR Savings from EUR,-0.17,0,EUR,COMPLETED,459.34
Card Payment,Current,2025-06-12 00:59:59,2025-06-12 12:07:00,Transport for London,-10,0,EUR,COMPLETED,449.34
Transfer,Current,2025-06-12 12:07:00,2025-06-12 12:07:00,To pocket EUR Savings from EUR,-1,0,EUR,COMPLETED,448.34
Transfer,Current,2025-06-12 12:11:19,2025-06-12 12:11:19,To pocket EUR Savings from EUR,-0.7,0,EUR,COMPLETED,447.64
Transfer,Current,2025-06-12 13:54:52,2025-06-12 13:54:52,To pocket EUR Savings from EUR,-0.85,0,EUR,COMPLETED,446.79
Transfer,Current,2025-06-12 18:01:50,2025-06-12 18:01:50,To pocket EUR Savings from EUR,-0.9,0,EUR,COMPLETED,445.89
Transfer,Current,2025-06-13 08:59:23,2025-06-13 08:59:23,To pocket EUR Savings from EUR,-0.5,0,EUR,COMPLETED,445.39
Transfer,Current,2025-06-13 12:40:18,2025-06-13 12:40:18,To pocket EUR Savings from EUR,-0.91,0,EUR,COMPLETED,444.48
Card Payment,Current,2025-06-12 12:11:18,2025-06-13 15:19:52,DoubleTree by Hilton,-5.3,0,EUR,COMPLETED,439.18
Card Payment,Current,2025-06-12 13:54:48,2025-06-13 15:19:52,DoubleTree by Hilton,-25.15,0,EUR,COMPLETED,414.03
Card Payment,Current,2025-06-12 18:01:49,2025-06-13 15:20:59,Pret A Manger,-18.1,0,EUR,COMPLETED,395.93
Card Payment,Current,2025-06-13 00:59:59,2025-06-13 16:09:20,Transport for London,-3.31,0,EUR,COMPLETED,392.62
Transfer,Current,2025-06-13 16:09:20,2025-06-13 16:09:20,To pocket EUR Savings from EUR,-0.69,0,EUR,COMPLETED,391.93
Transfer,Current,2025-06-13 20:13:33,2025-06-13 20:13:33,To pocket EUR Savings from EUR,-1,0,EUR,COMPLETED,390.93
Card Payment,Current,2025-06-13 08:59:22,2025-06-14 05:30:39,A Padaria Portuguesa,-2.5,0,EUR,COMPLETED,388.43
Transfer,Current,2025-06-14 08:11:55,2025-06-14 08:11:55,To pocket EUR Savings from EUR,-0.5,0,EUR,COMPLETED,387.93
Transfer,Current,2025-06-14 09:20:27,2025-06-14 09:20:27,To pocket EUR Savings from EUR,-0.25,0,EUR,COMPLETED,387.68
Transfer,Current,2025-06-14 15:25:29,2025-06-14 15:25:29,To pocket EUR Savings from EUR,-0.9,0,EUR,COMPLETED,386.78
Deposit,Current,2025-06-14 16:10:42,2025-06-14 16:10:43,Apple Pay deposit by *0264,200,0,EUR,COMPLETED,586.78
Card Payment,Current,2025-06-13 20:13:32,2025-06-14 16:37:46,IKEA,-15,0,EUR,COMPLETED,571.78
Transfer,Current,2025-06-14 23:24:36,2025-06-14 23:24:36,To pocket EUR Savings from EUR,-0.18,0,EUR,COMPLETED,571.6
Card Payment,Current,2025-06-14 08:11:55,2025-06-15 07:07:25,A Padaria Portuguesa,-2.5,0,EUR,COMPLETED,569.1
Transfer,Current,2025-06-15 07:18:41,2025-06-15 07:18:41,To pocket EUR Savings from EUR,-0.5,0,EUR,COMPLETED,568.6
Deposit,Current,2025-06-15 07:19:02,2025-06-15 07:19:03,Apple Pay deposit by *0264,200,0,EUR,COMPLETED,768.6
Card Payment,Current,2025-06-14 09:14:32,2025-06-15 09:02:59,Pingo Doce,-17.75,0,EUR,COMPLETED,750.85
Card Payment,Current,2025-06-14 15:25:28,2025-06-15 09:03:11,Rest Pigmeu,-183.1,0,EUR,COMPLETED,567.75
Card Payment,Current,2025-06-15 11:57:22,,Lenovo,-44.81,0,EUR,REVERTED,
Transfer,Current,2025-06-15 11:57:22,2025-06-15 11:57:22,To pocket EUR Savings from EUR,-0.19,0,EUR,COMPLETED,567.56
Transfer,Current,2025-06-15 12:21:58,2025-06-15 12:21:58,To pocket EUR Savings from EUR,-0.19,0,EUR,COMPLETED,567.37
Transfer,Current,2025-06-15 17:12:48,2025-06-15 17:12:48,To pocket EUR Savings from EUR,-0.01,0,EUR,COMPLETED,567.36
Card Payment,Current,2025-06-15 07:18:40,2025-06-16 06:41:35,A Padaria Portuguesa,-2.5,0,EUR,COMPLETED,564.86
Transfer,Current,2025-06-16 09:04:23,2025-06-16 09:04:23,To pocket EUR Savings from EUR,-20,0,EUR,COMPLETED,544.86
Card Payment,Current,2025-06-14 23:24:36,2025-06-16 09:45:42,Amazon,-172.82,0,EUR,COMPLETED,372.04
Card Payment,Current,2025-06-13 12:40:17,2025-06-16 10:34:03,Uber Eats,-21.09,0,EUR,COMPLETED,350.95
Card Payment,Current,2025-06-15 17:12:47,2025-06-16 10:47:14,Apple,-7.99,0,EUR,COMPLETED,342.96
Card Payment,Current,2025-06-15 12:21:57,2025-06-17 10:53:33,Lenovo,-44.81,0,EUR,COMPLETED,298.15
Transfer,Current,2025-06-18 11:54:02,2025-06-18 11:54:02,To pocket EUR Savings from EUR,-1,0,EUR,COMPLETED,297.15
Deposit,Current,2025-06-18 11:54:23,2025-06-18 11:54:25,Apple Pay deposit by *0264,200,0,EUR,COMPLETED,497.15
Transfer,Current,2025-06-18 12:41:29,2025-06-18 12:41:29,To pocket EUR Savings from EUR,-0.86,0,EUR,COMPLETED,496.29
Transfer,Current,2025-06-18 14:05:01,2025-06-18 14:05:01,To pocket EUR Savings from EUR,-0.03,0,EUR,COMPLETED,496.26
Deposit,Current,2025-06-18 14:05:51,2025-06-18 14:05:52,Apple Pay deposit by *0264,200,0,EUR,COMPLETED,696.26
Transfer,Current,2025-06-19 07:49:26,2025-06-19 07:49:26,To pocket EUR Savings from EUR,-0.5,0,EUR,COMPLETED,695.76
Card Payment,Current,2025-06-18 14:05:00,2025-06-19 09:35:53,Ikeaportuga 15265,-146.97,0,EUR,COMPLETED,548.79
Card Payment,Current,2025-06-18 11:54:02,2025-06-19 09:37:53,Hospitaldal,-21,0,EUR,COMPLETED,527.79
Transfer,Current,2025-06-19 12:46:31,2025-06-19 12:46:31,To pocket EUR Savings from EUR,-0.47,0,EUR,COMPLETED,527.32
Transfer,Current,2025-06-19 16:23:40,2025-06-19 16:23:40,To pocket EUR Savings from EUR,-0.09,0,EUR,COMPLETED,527.23
Card Payment,Current,2025-06-19 07:49:26,2025-06-20 05:35:33,A Padaria Portuguesa,-2.5,0,EUR,COMPLETED,524.73
Transfer,Current,2025-06-20 13:10:03,2025-06-20 13:10:03,To pocket EUR Savings from EUR,-0.01,0,EUR,COMPLETED,524.72
Transfer,Current,2025-06-20 13:24:40,2025-06-20 13:24:40,To pocket EUR Savings from EUR,-0.36,0,EUR,COMPLETED,524.36
Card Payment,Current,2025-06-19 12:46:31,2025-06-20 16:58:38,OpenAI,-21.53,0,EUR,COMPLETED,502.83
Transfer,Current,2025-06-21 08:09:12,2025-06-21 08:09:12,To pocket EUR Savings from EUR,-0.5,0,EUR,COMPLETED,502.33
Card Payment,Current,2025-06-20 13:24:40,2025-06-21 09:29:54,Amazon,-9.64,0,EUR,COMPLETED,492.69
Card Payment,Current,2025-06-19 16:23:40,2025-06-21 12:35:55,Amazon,-25.91,0,EUR,COMPLETED,466.78
Card Payment,Current,2025-06-18 12:41:29,2025-06-21 13:31:13,Uber Eats,-46.14,0,EUR,COMPLETED,420.64
Card Payment,Current,2025-06-20 13:10:03,2025-06-21 13:35:28,Uber,-4.99,0,EUR,COMPLETED,415.65
Card Payment,Current,2025-06-21 08:09:11,2025-06-22 05:25:10,A Padaria Portuguesa,-2.5,0,EUR,COMPLETED,413.15
Transfer,Current,2025-06-22 11:17:57,2025-06-22 11:17:57,To pocket EUR Savings from EUR,-0.9,0,EUR,COMPLETED,412.25
Transfer,Current,2025-06-22 11:20:26,2025-06-22 11:20:26,To pocket EUR Savings from EUR,-1,0,EUR,COMPLETED,411.25
Transfer,Current,2025-06-22 14:46:30,2025-06-22 14:46:30,To pocket EUR Savings from EUR,-0.9,0,EUR,COMPLETED,410.35
Transfer,Current,2025-06-22 15:13:54,2025-06-22 15:13:54,To pocket EUR Savings from EUR,-0.41,0,EUR,COMPLETED,409.94
Transfer,Current,2025-06-22 18:56:48,2025-06-22 18:56:48,To pocket EUR Savings from EUR,-0.4,0,EUR,COMPLETED,409.54
Transfer,Current,2025-06-23 02:57:46,2025-06-23 02:57:46,To pocket EUR Savings from EUR,-20,0,EUR,COMPLETED,389.54
Card Payment,Current,2025-06-22 18:56:47,2025-06-23 05:09:14,Cafe Rest Beira Rio,-3.6,0,EUR,COMPLETED,385.94
Card Payment,Current,2025-06-22 15:13:53,2025-06-23 05:09:49,Minipreço,-39.59,0,EUR,COMPLETED,346.35
Card Payment,Current,2025-06-22 14:46:29,2025-06-23 05:09:52,Fazenda Da Avo Thoma,-16.1,0,EUR,COMPLETED,330.25
Transfer,Current,2025-06-23 07:50:28,2025-06-23 07:50:28,To pocket EUR Savings from EUR,-0.53,0,EUR,COMPLETED,329.72
Transfer,Current,2025-06-23 08:12:25,2025-06-23 08:12:25,To pocket EUR Savings from EUR,-0.01,0,EUR,COMPLETED,329.71
Card Payment,Current,2025-06-22 11:17:56,2025-06-23 11:10:55,Brisa,-8.1,0,EUR,COMPLETED,321.61
Card Payment,Current,2025-06-22 11:20:25,2025-06-23 12:28:50,Miió,-20,0,EUR,COMPLETED,301.61
Transfer,Current,2025-06-23 13:32:11,2025-06-23 13:32:11,To pocket EUR Savings from EUR,-1,0,EUR,COMPLETED,300.61
Transfer,Current,2025-06-23 14:00:02,2025-06-23 14:00:02,To pocket EUR Savings from EUR,-0.56,0,EUR,COMPLETED,300.05
Card Payment,Current,2025-06-23 14:28:54,,Tunecore,-0.01,0,EUR,REVERTED,
Transfer,Current,2025-06-23 14:28:54,2025-06-23 14:28:54,To pocket EUR Savings from EUR,-0.99,0,EUR,COMPLETED,299.06
Transfer,Current,2025-06-23 14:29:09,2025-06-23 14:29:09,To pocket EUR Savings from EUR,-0.29,0,EUR,COMPLETED,298.77
Card Payment,Current,2025-06-23 14:00:01,2025-06-24 05:23:51,Minipreço,-18.44,0,EUR,COMPLETED,280.33
Card Payment,Current,2025-06-23 07:50:27,2025-06-24 05:23:52,C C Pombalinho,-7.47,0,EUR,COMPLETED,272.86
Card Payment,Current,2025-06-23 13:32:10,2025-06-24 05:24:05,Fazenda Da Avo Thoma,-15,0,EUR,COMPLETED,257.86
Deposit,Current,2025-06-24 10:26:32,2025-06-24 10:26:34,Apple Pay deposit by *0264,200,0,EUR,COMPLETED,457.86
Transfer,Current,2025-06-24 11:56:31,2025-06-24 11:56:31,To pocket EUR Savings from EUR,-0.23,0,EUR,COMPLETED,457.63
Transfer,Current,2025-06-24 12:16:10,2025-06-24 12:16:10,To pocket EUR Savings from EUR,-0.01,0,EUR,COMPLETED,457.62
Transfer,Current,2025-06-24 12:24:23,2025-06-24 12:24:23,To pocket EUR Savings from EUR,-0.26,0,EUR,COMPLETED,457.36
Transfer,Current,2025-06-24 17:04:29,2025-06-24 17:04:29,To pocket EUR Savings from EUR,-0.01,0,EUR,COMPLETED,457.35
Deposit,Current,2025-06-24 17:05:15,2025-06-24 17:05:16,Apple Pay deposit by *0264,200,0,EUR,COMPLETED,657.35
Card Payment,Current,2025-06-24 11:56:30,2025-06-25 05:34:40,Continente,-129.77,0,EUR,COMPLETED,527.58
Card Payment,Current,2025-06-24 12:16:09,2025-06-25 05:47:47,Lidl,-3.99,0,EUR,COMPLETED,523.59
Transfer,Current,2025-06-25 07:50:26,2025-06-25 07:50:26,To pocket EUR Savings from EUR,-0.3,0,EUR,COMPLETED,523.29
Card Payment,Current,2025-06-24 17:04:28,2025-06-25 09:22:11,PcComponentes.com,-129.99,0,EUR,COMPLETED,393.3
Transfer,Current,2025-06-25 09:35:08,2025-06-25 09:35:08,To pocket EUR Savings from EUR,-0.01,0,EUR,COMPLETED,393.29
Card Payment,Current,2025-06-23 08:12:25,2025-06-25 10:23:40,Google,-17.99,0,EUR,COMPLETED,375.3
Transfer,Current,2025-06-25 10:35:20,2025-06-25 10:35:20,To pocket EUR Savings from EUR,-0.27,0,EUR,COMPLETED,375.03
Transfer,Current,2025-06-25 13:50:06,2025-06-25 13:50:06,To pocket EUR Savings from EUR,-0.4,0,EUR,COMPLETED,374.63
Card Payment,Current,2025-06-23 14:29:08,2025-06-25 15:26:54,Tunecore,-22.71,0,EUR,COMPLETED,351.92
Transfer,Current,2025-06-25 17:17:16,2025-06-25 17:17:16,To pocket EUR Savings from EUR,-1,0,EUR,COMPLETED,350.92
Card Payment,Current,2025-06-25 13:50:05,2025-06-26 06:24:22,Alvaros Cafe Unipess,-19.6,0,EUR,COMPLETED,331.32
Card Payment,Current,2025-06-25 07:50:25,2025-06-26 06:24:22,C C Pombalinho,-6.7,0,EUR,COMPLETED,324.62
Card Payment,Current,2025-06-25 10:35:20,2025-06-26 10:57:20,Amazon,-45.73,0,EUR,COMPLETED,278.89
Card Payment,Current,2025-06-25 09:35:08,2025-06-26 11:01:12,Amazon,-12.99,0,EUR,COMPLETED,265.9
Transfer,Current,2025-06-26 12:35:06,2025-06-26 12:35:06,To pocket EUR Savings from EUR,-0.86,0,EUR,COMPLETED,265.04
Transfer,Current,2025-06-26 18:48:18,2025-06-26 18:48:18,To pocket EUR Savings from EUR,-0.01,0,EUR,COMPLETED,265.03
Deposit,Current,2025-06-26 20:54:40,2025-06-26 20:54:42,Apple Pay deposit by *0264,200,0,EUR,COMPLETED,465.03
Transfer,Current,2025-06-27 03:15:51,2025-06-27 03:15:51,To pocket EUR Savings from EUR,-0.01,0,EUR,COMPLETED,465.02
Card Payment,Current,2025-06-26 18:48:18,2025-06-27 11:16:35,PcComponentes.com,-129.99,0,EUR,COMPLETED,335.03
Transfer,Current,2025-06-27 12:32:01,2025-06-27 12:32:01,To pocket EUR Savings from EUR,-0.91,0,EUR,COMPLETED,334.12
Card Payment,Current,2025-06-26 12:35:05,2025-06-27 16:21:26,Claude.ai,-22.14,0,EUR,COMPLETED,311.98
Deposit,Current,2025-06-28 07:29:29,2025-06-28 07:29:31,Apple Pay deposit by *0264,200,0,EUR,COMPLETED,511.98
Transfer,Current,2025-06-28 07:47:09,2025-06-28 07:47:09,To pocket EUR Savings from EUR,-0.5,0,EUR,COMPLETED,511.48
Transfer,Current,2025-06-28 08:29:30,2025-06-28 08:29:30,To pocket EUR Savings from EUR,-0.09,0,EUR,COMPLETED,511.39
Transfer,Current,2025-06-28 11:12:27,2025-06-28 11:12:27,To pocket EUR Savings from EUR,-1,0,EUR,COMPLETED,510.39
Deposit,Current,2025-06-28 11:13:18,2025-06-28 11:13:20,Apple Pay deposit by *0264,200,0,EUR,COMPLETED,710.39
Transfer,Current,2025-06-28 11:26:58,2025-06-28 11:26:58,To pocket EUR Savings from EUR,-1,0,EUR,COMPLETED,709.39
Transfer,Current,2025-06-28 13:56:59,2025-06-28 13:56:59,To pocket EUR Savings from EUR,-0.74,0,EUR,COMPLETED,708.65
Card Payment,Current,2025-06-25 17:17:16,2025-06-28 14:37:44,Ikeaportuga 15278,-89,0,EUR,COMPLETED,619.65
Card Payment,Current,2025-06-27 03:15:50,2025-06-28 14:37:52,Netflix,-12.99,0,EUR,COMPLETED,606.66
Card Payment,Current,2025-06-28 07:47:08,2025-06-29 05:22:16,A Padaria Portuguesa,-2.5,0,EUR,COMPLETED,604.16
Transfer,Current,2025-06-29 05:52:08,2025-06-29 05:52:08,To pocket EUR Savings from EUR,-0.51,0,EUR,COMPLETED,603.65
Transfer,Current,2025-06-29 10:58:00,2025-06-29 10:58:00,To pocket EUR Savings from EUR,-0.8,0,EUR,COMPLETED,602.85
Card Payment,Current,2025-06-28 08:29:29,2025-06-29 11:16:35,Pingo Doce,-49.91,0,EUR,COMPLETED,552.94
Card Payment,Current,2025-06-28 11:26:57,2025-06-29 11:16:43,Music Factory,-9,0,EUR,COMPLETED,543.94
Card Refund,Current,2025-06-28 10:55:00,2025-06-29 13:23:46,Ikeaportuga 15278,39,0,EUR,COMPLETED,582.94
Transfer,Current,2025-06-29 14:25:35,2025-06-29 14:25:35,To pocket EUR Savings from EUR,-0.85,0,EUR,COMPLETED,582.09
Transfer,Current,2025-06-29 14:44:31,2025-06-29 14:44:31,To pocket EUR Savings from EUR,-0.12,0,EUR,COMPLETED,581.97
Transfer,Current,2025-06-30 02:56:17,2025-06-30 02:56:17,To pocket EUR Savings from EUR,-0.05,0,EUR,COMPLETED,581.92
Transfer,Current,2025-06-30 03:13:13,2025-06-30 03:13:13,To pocket EUR Savings from EUR,-20,0,EUR,COMPLETED,561.92
Card Payment,Current,2025-06-29 14:25:35,2025-06-30 05:22:59,Cafe Rest Beira Rio,-51.15,0,EUR,COMPLETED,510.77
Card Payment,Current,2025-06-29 14:44:30,2025-06-30 05:23:43,Minipreço,-16.88,0,EUR,COMPLETED,493.89
Card Payment,Current,2025-06-29 10:57:59,2025-06-30 11:14:11,Brisa,-16.2,0,EUR,COMPLETED,477.69
Card Payment,Current,2025-06-27 12:32:01,2025-06-30 12:22:50,Uber Eats,-21.09,0,EUR,COMPLETED,456.6
Card Payment,Current,2025-06-29 05:52:08,2025-06-30 12:22:58,Apple,-5.49,0,EUR,COMPLETED,451.11
Transfer,Current,2025-06-30 14:14:31,2025-06-30 14:14:31,To pocket EUR Savings from EUR,-0.5,0,EUR,COMPLETED,450.61
Card Payment,Current,2025-06-28 11:12:26,2025-06-30 16:46:47,IKEA,-110,0,EUR,COMPLETED,340.61
Transfer,Current,2025-06-30 18:21:02,2025-06-30 18:21:02,To pocket EUR Savings from EUR,-0.18,0,EUR,COMPLETED,340.43
Card Payment,Current,2025-06-24 12:24:22,2025-06-30 19:18:02,Continente,-16.74,0,EUR,COMPLETED,323.69
Transfer,Current,2025-07-01 02:16:19,2025-07-01 02:16:19,To pocket EUR Rainy day from EUR,-50,0,EUR,COMPLETED,273.69
Card Payment,Current,2025-06-30 18:21:02,2025-07-01 05:16:08,Minipreço,-31.82,0,EUR,COMPLETED,241.87
Card Payment,Current,2025-06-30 14:14:30,2025-07-01 05:16:10,Fazenda Da Avo Thoma,-30.5,0,EUR,COMPLETED,211.37
Transfer,Current,2025-07-01 09:52:41,2025-07-01 09:52:41,To pocket EUR Savings from EUR,-1,0,EUR,COMPLETED,210.37
Transfer,Current,2025-07-01 10:11:58,2025-07-01 10:11:58,To pocket EUR Savings from EUR,-0.35,0,EUR,COMPLETED,210.02
Transfer,Current,2025-07-01 10:15:33,2025-07-01 10:15:33,To pocket EUR Savings from EUR,-0.42,0,EUR,COMPLETED,209.6
Card Payment,Current,2025-06-28 13:56:58,2025-07-01 11:31:39,Uber Eats,-40.26,0,EUR,COMPLETED,169.34
Card Payment,Current,2025-07-01 10:15:32,2025-07-01 16:58:20,Continente,-14.58,0,EUR,COMPLETED,154.76
Card Payment,Current,2025-07-01 10:11:57,2025-07-02 05:45:50,Continente,-57.65,0,EUR,COMPLETED,97.11
Card Payment,Current,2025-07-01 09:52:40,2025-07-02 05:45:52,O Pao Quente,-19,0,EUR,COMPLETED,78.11
Transfer,Current,2025-07-02 08:36:59,2025-07-02 08:36:59,To pocket EUR Savings from EUR,-0.6,0,EUR,COMPLETED,77.51
Transfer,Current,2025-07-02 12:16:08,2025-07-02 12:16:08,To pocket EUR Savings from EUR,-0.01,0,EUR,COMPLETED,77.5
Card Payment,Current,2025-06-30 02:56:17,2025-07-02 12:47:11,Apple,-21.95,0,EUR,COMPLETED,55.55
Deposit,Current,2025-07-02 14:36:47,2025-07-02 14:36:48,Apple Pay deposit by *0264,200,0,EUR,COMPLETED,255.55
Transfer,Current,2025-07-02 14:37:06,2025-07-02 14:37:06,To pocket EUR Savings from EUR,-0.8,0,EUR,COMPLETED,254.75
Deposit,Current,2025-07-02 14:51:44,2025-07-02 14:51:45,Apple Pay deposit by *0264,200,0,EUR,COMPLETED,454.75
Transfer,Current,2025-07-02 17:02:31,2025-07-02 17:02:31,To pocket EUR Savings from EUR,-0.44,0,EUR,COMPLETED,454.31
Transfer,Current,2025-07-02 19:15:45,2025-07-02 19:15:45,To pocket EUR Savings from EUR,-0.42,0,EUR,COMPLETED,453.89
Transfer,Current,2025-07-02 21:52:46,2025-07-02 21:52:46,To pocket EUR Savings from EUR,-0.6,0,EUR,COMPLETED,453.29
Transfer,Current,2025-07-03 04:10:50,2025-07-03 04:10:50,To pocket EUR Savings from EUR,-1,0,EUR,COMPLETED,452.29
Card Payment,Current,2025-07-02 17:02:30,2025-07-03 05:37:40,Minipreço,-7.56,0,EUR,COMPLETED,444.73
Card Payment,Current,2025-07-02 14:37:05,2025-07-03 05:37:40,Alvaros,-66.2,0,EUR,COMPLETED,378.53
Card Payment,Current,2025-07-02 08:36:58,2025-07-03 05:37:41,C C Pombalinho,-16.4,0,EUR,COMPLETED,362.13
Card Payment,Current,2025-07-02 12:16:01,2025-07-03 10:43:29,PlayStation,-8.99,0,EUR,COMPLETED,353.14
Card Payment,Current,2025-07-03 04:10:50,2025-07-03 11:41:57,Miió,-20,0,EUR,COMPLETED,333.14
Transfer,Current,2025-07-03 12:41:05,2025-07-03 12:41:05,To pocket EUR Savings from EUR,-0.83,0,EUR,COMPLETED,332.31
Transfer,Current,2025-07-03 12:47:27,2025-07-03 12:47:27,To pocket EUR Savings from EUR,-1,0,EUR,COMPLETED,331.31
Card Payment,Current,2025-07-02 19:15:44,2025-07-03 16:09:25,LEROY MERLIN Coimbra,-42.58,0,EUR,COMPLETED,288.73
Deposit,Current,2025-07-03 17:28:10,2025-07-03 17:28:12,Apple Pay deposit by *0264,200,0,EUR,COMPLETED,488.73
Transfer,Current,2025-07-04 08:53:47,2025-07-04 08:53:47,To pocket EUR Savings from EUR,-0.15,0,EUR,COMPLETED,488.58
Card Payment,Current,2025-07-02 21:52:46,2025-07-04 12:34:37,Cafe Rest Beira Rio,-21.4,0,EUR,COMPLETED,467.18
Card Payment,Current,2025-07-03 12:47:27,2025-07-04 12:34:37,Cafe Rest Beira Rio,-7,0,EUR,COMPLETED,460.18
Card Payment,Current,2025-07-03 12:41:04,2025-07-04 12:35:55,Minipreço,-30.17,0,EUR,COMPLETED,430.01
Transfer,Current,2025-07-04 14:55:01,2025-07-04 14:55:01,To pocket EUR Savings from EUR,-0.05,0,EUR,COMPLETED,429.96
Transfer,Current,2025-07-04 18:22:08,2025-07-04 18:22:08,To pocket EUR Savings from EUR,-0.7,0,EUR,COMPLETED,429.26
Card Payment,Current,2025-07-04 14:55:00,2025-07-05 05:43:29,Isabel Bandeira,-40.95,0,EUR,COMPLETED,388.31
Card Payment,Current,2025-07-04 18:22:07,2025-07-05 05:44:36,Minipreço,-15.3,0,EUR,COMPLETED,373.01
Card Payment,Current,2025-07-04 08:53:46,2025-07-05 05:44:42,C C Pombalinho,-11.85,0,EUR,COMPLETED,361.16
Transfer,Current,2025-07-05 08:36:23,2025-07-05 08:36:23,To pocket EUR Savings from EUR,-0.85,0,EUR,COMPLETED,360.31
Card Refund,Current,2025-07-04 13:17:29,2025-07-05 12:26:53,PcComponentes.com,129.99,0,EUR,COMPLETED,490.3
Card Payment,Current,2025-07-05 08:36:22,2025-07-06 05:22:56,C C Pombalinho,-13.15,0,EUR,COMPLETED,477.15
Transfer,Current,2025-07-06 09:06:50,2025-07-06 09:06:50,To pocket EUR Savings from EUR,-0.5,0,EUR,COMPLETED,476.65
Transfer,Current,2025-07-06 10:09:45,2025-07-06 10:09:45,To pocket EUR Savings from EUR,-0.26,0,EUR,COMPLETED,476.39
Transfer,Current,2025-07-06 10:31:14,2025-07-06 10:31:14,To pocket EUR Savings from EUR,-0.12,0,EUR,COMPLETED,476.27
Card Payment,Current,2025-07-06 10:31:13,2025-07-06 15:28:17,Continente,-11.88,0,EUR,COMPLETED,464.39
Transfer,Current,2025-07-07 03:35:49,2025-07-07 03:35:49,To pocket EUR Savings from EUR,-20,0,EUR,COMPLETED,444.39
Card Payment,Current,2025-07-06 10:09:44,2025-07-07 05:25:01,Continente,-37.74,0,EUR,COMPLETED,406.65
Card Payment,Current,2025-07-06 09:06:49,2025-07-07 05:34:24,Oleigois,-10.5,0,EUR,COMPLETED,396.15
Transfer,Current,2025-07-07 13:54:22,2025-07-07 13:54:22,To pocket EUR Savings from EUR,-0.7,0,EUR,COMPLETED,395.45
Card Payment,Current,2025-07-07 13:54:21,2025-07-08 15:33:31,GitHub,-8.3,0,EUR,COMPLETED,387.15
Transfer,Current,2025-07-10 11:00:16,2025-07-10 11:00:16,To pocket EUR Savings from EUR,-0.86,0,EUR,COMPLETED,386.29
Transfer,Current,2025-07-10 11:32:19,2025-07-10 11:32:19,To pocket EUR Savings from EUR,-1,0,EUR,COMPLETED,385.29
Transfer,Current,2025-07-10 12:39:05,2025-07-10 12:39:05,To pocket EUR Savings from EUR,-0.86,0,EUR,COMPLETED,384.43
Transfer,Current,2025-07-10 14:10:22,2025-07-10 14:10:22,To pocket EUR Savings from EUR,-1,0,EUR,COMPLETED,383.43
Card Payment,Current,2025-07-10 11:32:19,2025-07-11 12:22:47,Hospitaldal,-21,0,EUR,COMPLETED,362.43
Card Payment,Current,2025-07-10 11:00:15,2025-07-11 14:42:54,Claude.ai,-22.14,0,EUR,COMPLETED,340.29
Transfer,Current,2025-07-12 08:24:36,2025-07-12 08:24:36,To pocket EUR Savings from EUR,-0.5,0,EUR,COMPLETED,339.79
Transfer,Current,2025-07-12 11:28:33,2025-07-12 11:28:33,To pocket EUR Savings from EUR,-0.74,0,EUR,COMPLETED,339.05
Deposit,Current,2025-07-12 11:34:45,2025-07-12 11:34:47,Apple Pay deposit by *0264,200,0,EUR,COMPLETED,539.05
Card Payment,Current,2025-07-12 11:28:32,2025-07-13 05:21:57,Talho Super Desconto,-37.26,0,EUR,COMPLETED,501.79
Card Payment,Current,2025-07-12 08:24:35,2025-07-13 05:23:02,A Padaria Portuguesa,-2.5,0,EUR,COMPLETED,499.29
Transfer,Current,2025-07-13 07:53:09,2025-07-13 07:53:09,To pocket EUR Savings from EUR,-0.5,0,EUR,COMPLETED,498.79
Transfer,Current,2025-07-13 08:25:42,2025-07-13 08:25:42,To pocket EUR Savings from EUR,-0.38,0,EUR,COMPLETED,498.41
Card Payment,Current,2025-07-10 14:10:21,2025-07-13 10:36:57,Uber Eats,-2,0,EUR,COMPLETED,496.41
Card Payment,Current,2025-07-10 12:39:04,2025-07-13 10:37:05,Uber Eats,-46.14,0,EUR,COMPLETED,450.27
Transfer,Current,2025-07-14 03:28:18,2025-07-14 03:28:18,To pocket EUR Savings from EUR,-20,0,EUR,COMPLETED,430.27
Card Payment,Current,2025-07-13 07:53:08,2025-07-14 05:41:14,A Padaria Portuguesa,-2.5,0,EUR,COMPLETED,427.77
Card Payment,Current,2025-07-13 08:25:41,2025-07-14 11:05:54,Pingo Doce,-39.62,0,EUR,COMPLETED,388.15
Transfer,Current,2025-07-14 12:48:52,2025-07-14 12:48:52,To pocket EUR Savings from EUR,-0.45,0,EUR,COMPLETED,387.7
Card Payment,Current,2025-07-14 12:48:51,2025-07-15 09:50:01,zooplus,-71.55,0,EUR,COMPLETED,316.15
Transfer,Current,2025-07-17 12:44:08,2025-07-17 12:44:08,To pocket EUR Savings from EUR,-0.34,0,EUR,COMPLETED,315.81
Deposit,Current,2025-07-17 12:46:11,2025-07-17 12:46:12,Apple Pay deposit by *0264,200,0,EUR,COMPLETED,515.81
Transfer,Current,2025-07-18 10:33:07,2025-07-18 10:33:07,To pocket EUR Savings from EUR,-0.51,0,EUR,COMPLETED,515.3
Transfer,Current,2025-07-18 12:45:35,2025-07-18 12:45:35,To pocket EUR Savings from EUR,-0.78,0,EUR,COMPLETED,514.52
Transfer,Current,2025-07-19 00:44:44,2025-07-19 00:44:44,To pocket EUR Savings from EUR,-0.5,0,EUR,COMPLETED,514.02
Transfer,Current,2025-07-19 07:57:10,2025-07-19 07:57:10,To pocket EUR Savings from EUR,-0.5,0,EUR,COMPLETED,513.52
Transfer,Current,2025-07-19 12:46:31,2025-07-19 12:46:31,To pocket EUR Savings from EUR,-0.76,0,EUR,COMPLETED,512.76
Transfer,Current,2025-07-19 12:51:24,2025-07-19 12:51:24,To pocket EUR Savings from EUR,-0.06,0,EUR,COMPLETED,512.7
Card Payment,Current,2025-07-19 07:57:10,2025-07-20 05:52:07,A Padaria Portuguesa,-2.5,0,EUR,COMPLETED,510.2
Transfer,Current,2025-07-20 08:08:43,2025-07-20 08:08:43,To pocket EUR Savings from EUR,-0.5,0,EUR,COMPLETED,509.7
Card Payment,Current,2025-07-19 12:51:23,2025-07-20 08:47:54,Uber Eats,-35.18,0,EUR,COMPLETED,474.52
Transfer,Current,2025-07-20 08:56:27,2025-07-20 08:56:27,To pocket EUR Savings from EUR,-0.22,0,EUR,COMPLETED,474.3
Card Payment,Current,2025-07-17 12:44:07,2025-07-20 11:28:25,Uber Eats,-31.66,0,EUR,COMPLETED,442.64
Card Payment,Current,2025-07-19 00:44:44,2025-07-20 11:28:31,Spitfireaud,-53.5,0,EUR,COMPLETED,389.14
Card Payment,Current,2025-07-19 12:46:31,2025-07-20 12:58:22,OpenAI,-21.24,0.21,EUR,COMPLETED,367.69
Transfer,Current,2025-07-20 13:10:03,2025-07-20 13:10:03,To pocket EUR Savings from EUR,-0.01,0,EUR,COMPLETED,367.68
Transfer,Current,2025-07-20 17:46:53,2025-07-20 17:46:53,To pocket EUR Savings from EUR,-0.4,0,EUR,COMPLETED,367.28
Transfer,Current,2025-07-20 20:45:25,2025-07-20 20:45:25,To pocket EUR Savings from EUR,-0.3,0,EUR,COMPLETED,366.98
Transfer,Current,2025-07-21 03:21:09,2025-07-21 03:21:09,To pocket EUR Savings from EUR,-20,0,EUR,COMPLETED,346.98
Card Payment,Current,2025-07-20 08:08:42,2025-07-21 06:09:32,A Padaria Portuguesa,-2.5,0,EUR,COMPLETED,344.48
Card Payment,Current,2025-07-18 10:33:06,2025-07-21 09:47:01,Amazon,-30.49,0,EUR,COMPLETED,313.99
Card Payment,Current,2025-07-18 12:45:35,2025-07-21 10:22:38,Uber Eats,-18.22,0,EUR,COMPLETED,295.77
Card Payment,Current,2025-07-20 13:10:03,2025-07-21 10:33:33,Uber,-4.99,0,EUR,COMPLETED,290.78
Card Payment,Current,2025-07-20 08:56:26,2025-07-21 12:32:12,Pingo Doce,-39.78,0,EUR,COMPLETED,251
Card Payment,Current,2025-07-20 17:46:52,2025-07-21 12:32:30,Cinemas NOS,-6.6,0,EUR,COMPLETED,244.4
Transfer,Current,2025-07-21 13:24:50,2025-07-21 13:24:50,To pocket EUR Savings from EUR,-0.16,0,EUR,COMPLETED,244.24
Deposit,Current,2025-07-21 13:26:10,2025-07-21 13:26:11,Apple Pay deposit by *0264,200,0,EUR,COMPLETED,444.24
Transfer,Current,2025-07-21 14:38:13,2025-07-21 14:38:13,To pocket EUR Savings from EUR,-0.93,0,EUR,COMPLETED,443.31
Transfer,Current,2025-07-21 17:13:09,2025-07-21 17:13:09,To pocket EUR Savings from EUR,-1,0,EUR,COMPLETED,442.31
Card Payment,Current,2025-07-21 13:24:49,2025-07-22 05:51:48,Minipreço,-11.84,0,EUR,COMPLETED,430.47
Card Payment,Current,2025-07-20 20:45:24,2025-07-22 06:07:08,h3,-20.7,0,EUR,COMPLETED,409.77
Transfer,Current,2025-07-23 08:12:25,2025-07-23 08:12:25,To pocket EUR Savings from EUR,-0.01,0,EUR,COMPLETED,409.76
Card Payment,Current,2025-07-21 14:38:12,2025-07-23 10:09:15,Amazon,-26.07,0,EUR,COMPLETED,383.69
Deposit,Current,2025-07-23 12:19:24,2025-07-23 12:19:26,Apple Pay deposit by *0264,200,0,EUR,COMPLETED,583.69
Transfer,Current,2025-07-23 12:29:33,2025-07-23 12:29:33,To pocket EUR Savings from EUR,-0.34,0,EUR,COMPLETED,583.35
Deposit,Current,2025-07-23 15:54:03,2025-07-23 15:54:04,Apple Pay deposit by *0264,855,0,EUR,COMPLETED,1438.35
Transfer,Current,2025-07-23 16:02:45,2025-07-23 16:02:45,To pocket EUR Savings from EUR,-0.1,0,EUR,COMPLETED,1438.25
Deposit,Current,2025-07-23 17:21:18,2025-07-23 17:21:19,Apple Pay deposit by *0264,463,0,EUR,COMPLETED,1901.25
Transfer,Current,2025-07-23 17:22:15,2025-07-23 17:22:15,To pocket EUR Savings from EUR,-0.8,0,EUR,COMPLETED,1900.45
Card Payment,Current,2025-07-21 17:13:09,2025-07-24 09:27:19,Bestservice,-119,0,EUR,COMPLETED,1781.45
Transfer,Current,2025-07-24 12:49:57,2025-07-24 12:49:57,To pocket EUR Savings from EUR,-0.34,0,EUR,COMPLETED,1781.11
Card Payment,Current,2025-07-23 08:12:25,2025-07-25 12:42:53,Google,-17.99,0,EUR,COMPLETED,1763.12
Transfer,Current,2025-07-25 12:47:01,2025-07-25 12:47:01,To pocket EUR Savings from EUR,-0.78,0,EUR,COMPLETED,1762.34
Deposit,Current,2025-07-25 12:55:07,2025-07-25 12:55:09,Apple Pay deposit by *0264,200,0,EUR,COMPLETED,1962.34
Transfer,Current,2025-07-26 07:37:12,2025-07-26 07:37:12,To pocket EUR Savings from EUR,-0.5,0,EUR,COMPLETED,1961.84
Card Payment,Current,2025-07-23 16:02:44,2025-07-26 12:21:04,Egitana Pt,-855.9,0,EUR,COMPLETED,1105.94
Card Payment,Current,2025-07-23 17:22:14,2025-07-26 12:21:08,Emma,-463.2,0,EUR,COMPLETED,642.74
Card Payment,Current,2025-07-23 12:29:33,2025-07-26 14:06:26,Amplesot2jl,-103.66,0,EUR,COMPLETED,539.08
Transfer,Current,2025-07-26 14:38:28,2025-07-26 14:38:28,To pocket EUR Savings from EUR,-0.5,0,EUR,COMPLETED,538.58
Transfer,Current,2025-07-27 02:20:16,2025-07-27 02:20:16,To pocket EUR Savings from EUR,-0.01,0,EUR,COMPLETED,538.57
Card Payment,Current,2025-07-26 14:38:27,2025-07-27 05:19:36,Quisque Dona,-13.5,0,EUR,COMPLETED,525.07
Card Payment,Current,2025-07-26 07:37:11,2025-07-27 05:20:33,A Padaria Portuguesa,-2.5,0,EUR,COMPLETED,522.57
Transfer,Current,2025-07-27 07:55:52,2025-07-27 07:55:52,To pocket EUR Savings from EUR,-0.5,0,EUR,COMPLETED,522.07
Transfer,Current,2025-07-27 08:46:08,2025-07-27 08:46:08,To pocket EUR Savings from EUR,-0.82,0,EUR,COMPLETED,521.25
Transfer,Current,2025-07-27 09:12:56,2025-07-27 09:12:56,To pocket EUR Savings from EUR,-0.86,0,EUR,COMPLETED,520.39
Card Payment,Current,2025-07-24 12:49:56,2025-07-27 10:25:52,Uber Eats,-31.66,0,EUR,COMPLETED,488.73
Transfer,Current,2025-07-28 03:34:04,2025-07-28 03:34:04,To pocket EUR Savings from EUR,-20,0,EUR,COMPLETED,468.73
Card Payment,Current,2025-07-27 07:55:52,2025-07-28 06:00:47,A Padaria Portuguesa,-2.5,0,EUR,COMPLETED,466.23
Card Payment,Current,2025-07-25 12:47:00,2025-07-28 09:47:47,Uber Eats,-18.22,0,EUR,COMPLETED,448.01
Card Payment,Current,2025-07-27 02:20:15,2025-07-28 09:47:53,Netflix,-12.99,0,EUR,COMPLETED,435.02
Card Payment,Current,2025-07-27 08:46:07,2025-07-28 11:44:09,Pingo Doce,-28.18,0,EUR,COMPLETED,406.84
Card Payment,Current,2025-07-27 09:12:56,2025-07-28 13:45:11,Claude.ai,-22.14,0,EUR,COMPLETED,384.7
Transfer,Current,2025-07-29 05:52:55,2025-07-29 05:52:55,To pocket EUR Savings from EUR,-0.51,0,EUR,COMPLETED,384.19
Transfer,Current,2025-07-29 10:22:59,2025-07-29 10:22:59,To pocket EUR Savings from EUR,-0.89,0,EUR,COMPLETED,383.3
Transfer,Current,2025-07-29 16:11:13,2025-07-29 16:11:13,To pocket EUR Savings from EUR,-0.93,0,EUR,COMPLETED,382.37
Transfer,Current,2025-07-30 02:54:01,2025-07-30 02:54:01,To pocket EUR Savings from EUR,-0.05,0,EUR,COMPLETED,382.32
Transfer,Current,2025-07-30 07:41:44,2025-07-30 07:41:44,To pocket EUR Savings from EUR,-0.25,0,EUR,COMPLETED,382.07
Transfer,Current,2025-07-30 10:05:37,2025-07-30 10:05:37,To pocket EUR Savings from EUR,-1,0,EUR,COMPLETED,381.07
Card Payment,Current,2025-07-29 10:22:59,2025-07-30 15:13:31,Claude.ai,-102.11,0,EUR,COMPLETED,278.96
Transfer,Current,2025-07-30 18:55:53,2025-07-30 18:55:53,To pocket EUR Savings from EUR,-0.19,0,EUR,COMPLETED,278.77
Deposit,Current,2025-07-30 18:57:15,2025-07-30 18:57:17,Apple Pay deposit by *0264,200,0,EUR,COMPLETED,478.77
Transfer,Current,2025-07-30 19:02:36,2025-07-30 19:02:36,To pocket EUR Savings from EUR,-0.4,0,EUR,COMPLETED,478.37
Card Payment,Current,2025-07-30 19:02:36,2025-07-31 05:55:48,Cafe Rest Beira Rio,-3.6,0,EUR,COMPLETED,474.77
Card Payment,Current,2025-07-30 18:55:53,2025-07-31 05:58:10,Minipreço,-12.81,0,EUR,COMPLETED,461.96
Transfer,Current,2025-07-31 07:59:38,2025-07-31 07:59:38,To pocket EUR Savings from EUR,-0.3,0,EUR,COMPLETED,461.66
Card Payment,Current,2025-07-29 05:52:55,2025-07-31 09:24:19,Apple,-5.49,0,EUR,COMPLETED,456.17
Card Payment,Current,2025-07-30 07:41:43,2025-07-31 11:49:37,Brisa,-6.75,0,EUR,COMPLETED,449.42
Card Payment,Current,2025-07-30 10:05:36,2025-07-31 12:39:54,Miió,-20,0,EUR,COMPLETED,429.42
Transfer,Current,2025-08-01 02:59:36,2025-08-01 02:59:36,To pocket EUR Rainy day from EUR,-50,0,EUR,COMPLETED,379.42
Transfer,Current,2025-08-01 08:00:30,2025-08-01 08:00:30,To pocket EUR Savings from EUR,-0.3,0,EUR,COMPLETED,379.12
Deposit,Current,2025-08-01 08:10:28,2025-08-01 08:10:29,Apple Pay deposit by *0264,200,0,EUR,COMPLETED,579.12
Card Payment,Current,2025-07-31 07:59:37,2025-08-01 11:06:37,C C Pombalinho,-6.7,0,EUR,COMPLETED,572.42
Card Payment,Current,2025-07-29 16:11:13,2025-08-01 12:34:27,FastSpring,-108.07,0,EUR,COMPLETED,464.35
Card Payment,Current,2025-07-30 02:54:01,2025-08-01 12:37:34,Apple,-21.95,0,EUR,COMPLETED,442.4
Transfer,Current,2025-08-01 13:14:42,2025-08-01 13:14:42,To pocket EUR Savings from EUR,-0.4,0,EUR,COMPLETED,442
Transfer,Current,2025-08-02 08:07:11,2025-08-02 08:07:11,To pocket EUR Savings from EUR,-0.3,0,EUR,COMPLETED,441.7
Transfer,Current,2025-08-02 09:00:14,2025-08-02 09:00:14,To pocket EUR Savings from EUR,-0.1,0,EUR,COMPLETED,441.6
Transfer,Current,2025-08-02 09:23:31,2025-08-02 09:23:31,To pocket EUR Savings from EUR,-0.88,0,EUR,COMPLETED,440.72
Transfer,Current,2025-08-02 09:40:03,2025-08-02 09:40:03,To pocket EUR Savings from EUR,-0.99,0,EUR,COMPLETED,439.73
Transfer,Current,2025-08-02 12:17:37,2025-08-02 12:17:37,To pocket EUR Savings from EUR,-0.01,0,EUR,COMPLETED,439.72
Transfer,Current,2025-08-02 13:59:40,2025-08-02 13:59:40,To pocket EUR Savings from EUR,-0.8,0,EUR,COMPLETED,438.92
Card Payment,Current,2025-08-01 13:14:37,2025-08-02 14:49:26,Petiscos Pego Escuro,-9.6,0,EUR,COMPLETED,429.32
Card Payment,Current,2025-08-01 08:00:29,2025-08-02 14:50:57,C C Pombalinho,-6.7,0,EUR,COMPLETED,422.62
Card Payment,Current,2025-08-02 09:40:03,2025-08-02 16:02:30,Continente,-17.01,0,EUR,COMPLETED,405.61
Transfer,Current,2025-08-02 18:47:51,2025-08-02 18:47:51,To pocket EUR Savings from EUR,-0.61,0,EUR,COMPLETED,405
Transfer,Current,2025-08-02 18:59:38,2025-08-02 18:59:38,To pocket EUR Savings from EUR,-0.9,0,EUR,COMPLETED,404.1
Card Payment,Current,2025-08-02 09:23:30,2025-08-03 06:34:11,Continente,-36.12,0,EUR,COMPLETED,367.98
Card Payment,Current,2025-08-02 09:00:13,2025-08-03 06:34:14,O Pao Quente,-5.9,0,EUR,COMPLETED,362.08
Card Payment,Current,2025-08-02 08:07:10,2025-08-03 06:37:08,C C Pombalinho,-6.7,0,EUR,COMPLETED,355.38
Card Payment,Current,2025-08-02 13:59:39,2025-08-03 06:37:10,Fazenda Da Avo Thoma,-17.2,0,EUR,COMPLETED,338.18
Transfer,Current,2025-08-03 12:18:01,2025-08-03 12:18:01,To pocket EUR Savings from EUR,-0.9,0,EUR,COMPLETED,337.28
Transfer,Current,2025-08-03 15:08:56,2025-08-03 15:08:56,To pocket EUR Savings from EUR,-0.58,0,EUR,COMPLETED,336.7
Deposit,Current,2025-08-03 15:09:52,2025-08-03 15:09:53,Apple Pay deposit by *0264,200,0,EUR,COMPLETED,536.7
Transfer,Current,2025-08-03 19:16:07,2025-08-03 19:16:07,To pocket EUR Savings from EUR,-0.55,0,EUR,COMPLETED,536.15
Transfer,Current,2025-08-03 19:30:06,2025-08-03 19:30:06,To pocket EUR Savings from EUR,-0.7,0,EUR,COMPLETED,535.45
Transfer,Current,2025-08-04 03:25:20,2025-08-04 03:25:20,To pocket EUR Savings from EUR,-20,0,EUR,COMPLETED,515.45
Card Payment,Current,2025-08-03 19:16:07,2025-08-04 06:25:12,Solidindex,-3.45,0,EUR,COMPLETED,512
Card Payment,Current,2025-08-02 18:47:50,2025-08-04 12:16:52,Amazon,-24.39,0,EUR,COMPLETED,487.61
Card Payment,Current,2025-08-02 12:17:37,2025-08-04 12:19:23,PlayStation,-8.99,0,EUR,COMPLETED,478.62
Card Payment,Current,2025-08-03 19:30:06,2025-08-04 13:19:08,Pingo Doce,-17.3,0,EUR,COMPLETED,461.32
Card Payment,Current,2025-08-03 12:18:00,2025-08-04 13:19:20,Brisa,-8.1,0,EUR,COMPLETED,453.22
Card Payment,Current,2025-08-02 18:59:38,2025-08-05 12:31:46,FastSpring,-140.1,0,EUR,COMPLETED,313.12
Transfer,Current,2025-08-06 08:34:22,2025-08-06 08:34:22,To pocket EUR Savings from EUR,-0.45,0,EUR,COMPLETED,312.67
Transfer,Current,2025-08-06 09:06:04,2025-08-06 09:06:04,To pocket EUR Savings from EUR,-0.01,0,EUR,COMPLETED,312.66
Transfer,Current,2025-08-06 09:09:43,2025-08-06 09:09:43,To pocket EUR Savings from EUR,-0.01,0,EUR,COMPLETED,312.65
Card Payment,Current,2025-08-03 15:08:56,2025-08-06 14:13:06,Uber Eats,-23.42,0,EUR,COMPLETED,289.23
Transfer,Current,2025-08-06 14:39:58,2025-08-06 14:39:58,To pocket EUR Savings from EUR,-0.35,0,EUR,COMPLETED,288.88
Card Payment,Current,2025-08-06 08:34:22,2025-08-07 10:30:25,Amazon,-15.55,0,EUR,COMPLETED,273.33
Card Payment,Current,2025-08-06 09:09:43,2025-08-07 10:53:55,Fnacportuga,-39.99,0,EUR,COMPLETED,233.34
Transfer,Current,2025-08-07 12:41:06,2025-08-07 12:41:06,To pocket EUR Savings from EUR,-0.86,0,EUR,COMPLETED,232.48
Deposit,Current,2025-08-07 12:47:56,2025-08-07 12:47:57,Apple Pay deposit by *0264,200,0,EUR,COMPLETED,432.48
Transfer,Current,2025-08-07 14:16:11,2025-08-07 14:16:11,To pocket EUR Savings from EUR,-1,0,EUR,COMPLETED,431.48
Card Payment,Current,2025-08-06 14:39:58,2025-08-07 17:05:41,GitHub,-8.65,0,EUR,COMPLETED,422.83
Transfer,Current,2025-08-07 19:23:49,2025-08-07 19:23:49,To pocket EUR Savings from EUR,-0.25,0,EUR,COMPLETED,422.58
Card Payment,Current,2025-08-07 19:23:48,2025-08-08 11:45:28,Fnac,-12.75,0,EUR,COMPLETED,409.83
Card Payment,Current,2025-08-06 09:06:04,2025-08-08 13:43:01,Leroy Merlin,-14.99,0,EUR,COMPLETED,394.84
Transfer,Current,2025-08-08 19:17:39,2025-08-08 19:17:39,To pocket EUR Savings from EUR,-0.6,0,EUR,COMPLETED,394.24
Transfer,Current,2025-08-09 07:26:20,2025-08-09 07:26:20,To pocket EUR Savings from EUR,-0.5,0,EUR,COMPLETED,393.74
Transfer,Current,2025-08-09 09:30:56,2025-08-09 09:30:56,To pocket EUR Savings from EUR,-0.79,0,EUR,COMPLETED,392.95
Transfer,Current,2025-08-09 20:54:13,2025-08-09 20:54:13,To pocket EUR Savings from EUR,-0.4,0,EUR,COMPLETED,392.55
Transfer,Current,2025-08-10 07:32:16,2025-08-10 07:32:16,To pocket EUR Savings from EUR,-0.5,0,EUR,COMPLETED,392.05
Transfer,Current,2025-08-10 08:16:52,2025-08-10 08:16:52,To pocket EUR Savings from EUR,-0.16,0,EUR,COMPLETED,391.89
Deposit,Current,2025-08-10 09:24:03,2025-08-10 09:24:04,Apple Pay deposit by *0264,200,0,EUR,COMPLETED,591.89
Card Payment,Current,2025-08-07 12:41:06,2025-08-10 11:03:57,Uber Eats,-46.14,0,EUR,COMPLETED,545.75
Card Payment,Current,2025-08-07 14:16:11,2025-08-10 11:04:02,Uber Eats,-2,0,EUR,COMPLETED,543.75
Transfer,Current,2025-08-10 14:16:30,2025-08-10 14:16:30,To pocket EUR Savings from EUR,-0.1,0,EUR,COMPLETED,543.65
Card Payment,Current,2025-08-08 19:17:39,2025-08-10 21:01:23,Portugalia Alm Reis,-74.4,0,EUR,COMPLETED,469.25
Card Payment,Current,2025-08-09 09:30:55,2025-08-10 22:33:11,Talho Super Desconto,-19.21,0,EUR,COMPLETED,450.04
Card Payment,Current,2025-08-09 07:26:19,2025-08-10 22:33:46,A Padaria Portuguesa,-2.5,0,EUR,COMPLETED,447.54
Transfer,Current,2025-08-11 03:21:37,2025-08-11 03:21:37,To pocket EUR Savings from EUR,-20,0,EUR,COMPLETED,427.54
Card Payment,Current,2025-08-10 07:32:15,2025-08-11 05:25:52,A Padaria Portuguesa,-2.5,0,EUR,COMPLETED,425.04
Card Payment,Current,2025-08-10 08:16:51,2025-08-11 11:23:26,Pingo Doce,-21.84,0,EUR,COMPLETED,403.2
Card Payment,Current,2025-08-09 20:54:12,2025-08-11 11:23:40,Zubir Churrasqueira,-60.6,0,EUR,COMPLETED,342.6
Card Payment,Current,2025-08-10 14:16:29,2025-08-11 15:41:44,Waves,-13.9,0.14,EUR,COMPLETED,328.56
Transfer,Current,2025-08-12 12:44:11,2025-08-12 12:44:11,To pocket EUR Savings from EUR,-0.78,0,EUR,COMPLETED,327.78
Transfer,Current,2025-08-14 12:48:35,2025-08-14 12:48:35,To pocket EUR Savings from EUR,-0.91,0,EUR,COMPLETED,326.87
Transfer,Current,2025-08-14 14:04:59,2025-08-14 14:04:59,To pocket EUR Savings from EUR,-0.02,0,EUR,COMPLETED,326.85
Deposit,Current,2025-08-14 14:05:36,2025-08-14 14:05:37,Apple Pay deposit by *0264,200,0,EUR,COMPLETED,526.85
Transfer,Current,2025-08-15 08:03:33,2025-08-15 08:03:33,To pocket EUR Savings from EUR,-0.5,0,EUR,COMPLETED,526.35
Card Payment,Current,2025-08-12 12:44:10,2025-08-15 12:46:22,Uber Eats,-18.22,0,EUR,COMPLETED,508.13
Transfer,Current,2025-08-15 15:13:19,2025-08-15 15:13:19,To pocket EUR Savings from EUR,-0.75,0,EUR,COMPLETED,507.38
Transfer,Current,2025-08-15 15:44:25,2025-08-15 15:44:25,To pocket EUR Savings from EUR,-0.2,0,EUR,COMPLETED,507.18
Card Payment,Current,2025-08-15 08:03:32,2025-08-16 05:28:09,A Padaria Portuguesa,-2.5,0,EUR,COMPLETED,504.68
Transfer,Current,2025-08-16 07:46:45,2025-08-16 07:46:45,To pocket EUR Savings from EUR,-0.5,0,EUR,COMPLETED,504.18
Transfer,Current,2025-08-16 08:28:21,2025-08-16 08:28:21,To pocket EUR Savings from EUR,-0.89,0,EUR,COMPLETED,503.29
Card Payment,Current,2025-08-15 15:13:19,2025-08-16 10:31:38,Passeio Do Exito,-84.25,0,EUR,COMPLETED,419.04
Card Payment,Current,2025-08-15 15:44:24,2025-08-16 10:39:11,Il Tempo L Italiano,-4.8,0,EUR,COMPLETED,414.24
Transfer,Current,2025-08-16 10:46:22,2025-08-16 10:46:22,To pocket EUR Savings from EUR,-1,0,EUR,COMPLETED,413.24
Transfer,Current,2025-08-16 11:33:32,2025-08-16 11:33:32,To pocket EUR Savings from EUR,-0.06,0,EUR,COMPLETED,413.18
Card Payment,Current,2025-08-16 07:46:44,2025-08-17 05:35:17,A Padaria Portuguesa,-2.5,0,EUR,COMPLETED,410.68
Transfer,Current,2025-08-17 07:49:25,2025-08-17 07:49:25,To pocket EUR Savings from EUR,-0.5,0,EUR,COMPLETED,410.18
Deposit,Current,2025-08-17 07:49:46,2025-08-17 07:49:47,Apple Pay deposit by *0264,200,0,EUR,COMPLETED,610.18
Transfer,Current,2025-08-17 08:43:40,2025-08-17 08:43:40,To pocket EUR Savings from EUR,-0.37,0,EUR,COMPLETED,609.81
Card Payment,Current,2025-08-16 10:46:21,2025-08-17 09:33:27,Vodafone,-20,0,EUR,COMPLETED,589.81
Card Payment,Current,2025-08-16 08:28:20,2025-08-17 09:33:32,Pingo Doce,-37.11,0,EUR,COMPLETED,552.7
Card Payment,Current,2025-08-16 11:33:31,2025-08-17 09:33:51,Well S Alges,-15.94,0,EUR,COMPLETED,536.76
Card Payment,Current,2025-08-14 12:48:33,2025-08-17 12:03:15,Uber Eats,-21.09,0,EUR,COMPLETED,515.67
Card Payment,Current,2025-08-14 14:04:58,2025-08-17 12:03:19,Leroy Merlin,-68.98,0,EUR,COMPLETED,446.69
Transfer,Current,2025-08-17 12:57:51,2025-08-17 12:57:51,To pocket EUR Savings from EUR,-0.1,0,EUR,COMPLETED,446.59
Transfer,Current,2025-08-17 13:00:06,2025-08-17 13:00:06,To pocket EUR Savings from EUR,-0.01,0,EUR,COMPLETED,446.58
Transfer,Current,2025-08-17 14:30:03,2025-08-17 14:30:03,To pocket EUR Savings from EUR,-0.01,0,EUR,COMPLETED,446.57
Deposit,Current,2025-08-17 18:31:11,2025-08-17 18:31:13,Apple Pay deposit by *0264,200,0,EUR,COMPLETED,646.57
Transfer,Current,2025-08-18 03:15:24,2025-08-18 03:15:24,To pocket EUR Savings from EUR,-20,0,EUR,COMPLETED,626.57
Card Payment,Current,2025-08-17 07:49:24,2025-08-18 05:21:29,A Padaria Portuguesa,-2.5,0,EUR,COMPLETED,624.07
Transfer,Current,2025-08-18 08:32:10,2025-08-18 08:32:10,To pocket EUR Savings from EUR,-0.84,0,EUR,COMPLETED,623.23
Card Payment,Current,2025-08-17 13:00:06,2025-08-18 10:44:14,Auchan,-49.99,0,EUR,COMPLETED,573.24
Card Payment,Current,2025-08-17 14:30:02,2025-08-18 10:44:14,Auchan,-50.99,0,EUR,COMPLETED,522.25
Card Payment,Current,2025-08-17 12:57:50,2025-08-18 10:45:04,Jean Louis David,-18.9,0,EUR,COMPLETED,503.35
Card Payment,Current,2025-08-17 08:43:40,2025-08-18 12:05:38,Amazon,-216.63,0,EUR,COMPLETED,286.72
Transfer,Current,2025-08-18 20:24:53,2025-08-18 20:24:53,To pocket EUR Savings from EUR,-1,0,EUR,COMPLETED,285.72
Card Refund,Current,2025-08-17 14:21:53,2025-08-19 11:01:57,Auchan,49.99,0,EUR,COMPLETED,335.71
Card Payment,Current,2025-08-18 08:32:10,2025-08-19 12:39:37,Amazon,-22.16,0,EUR,COMPLETED,313.55
Transfer,Current,2025-08-19 12:46:28,2025-08-19 12:46:28,To pocket EUR Savings from EUR,-0.84,0,EUR,COMPLETED,312.71
Card Payment,Current,2025-08-19 12:46:28,2025-08-20 13:09:20,OpenAI,-21.16,0,EUR,COMPLETED,291.55
Transfer,Current,2025-08-20 13:10:03,2025-08-20 13:10:03,To pocket EUR Savings from EUR,-0.01,0,EUR,COMPLETED,291.54
Card Payment,Current,2025-08-18 20:24:53,2025-08-21 12:22:16,Uber Eats,-23,0,EUR,COMPLETED,268.54
Card Payment,Current,2025-08-20 13:10:03,2025-08-21 12:35:19,Uber,-4.99,0,EUR,COMPLETED,263.55
Transfer,Current,2025-08-21 12:51:02,2025-08-21 12:51:02,To pocket EUR Savings from EUR,-0.86,0,EUR,COMPLETED,262.69
Transfer,Current,2025-08-21 14:06:57,2025-08-21 14:06:57,To pocket EUR Savings from EUR,-0.09,0,EUR,COMPLETED,262.6
Deposit,Current,2025-08-21 17:23:57,2025-08-21 17:23:58,Apple Pay deposit by *0264,200,0,EUR,COMPLETED,462.6
Deposit,Current,2025-08-21 17:24:13,2025-08-21 17:24:14,Apple Pay deposit by *0264,200,0,EUR,COMPLETED,662.6
Transfer,Current,2025-08-21 17:24:31,2025-08-21 17:24:31,To pocket EUR Savings from EUR,-0.27,0,EUR,COMPLETED,662.33
Card Payment,Current,2025-08-21 17:24:31,2025-08-22 09:58:03,Amazon,-40.73,0,EUR,COMPLETED,621.6
Transfer,Current,2025-08-22 12:53:49,2025-08-22 12:53:49,To pocket EUR Savings from EUR,-0.78,0,EUR,COMPLETED,620.82
Transfer,Current,2025-08-23 08:07:28,2025-08-23 08:07:28,To pocket EUR Savings from EUR,-0.5,0,EUR,COMPLETED,620.32
Transfer,Current,2025-08-23 08:12:26,2025-08-23 08:12:26,To pocket EUR Savings from EUR,-0.01,0,EUR,COMPLETED,620.31
Transfer,Current,2025-08-23 11:29:28,2025-08-23 11:29:28,To pocket EUR Savings from EUR,-0.94,0,EUR,COMPLETED,619.37
Transfer,Current,2025-08-23 20:14:08,2025-08-23 20:14:08,To pocket EUR Savings from EUR,-0.13,0,EUR,COMPLETED,619.24
Card Payment,Current,2025-08-23 11:29:27,2025-08-24 05:03:00,Talho Super Desconto,-13.06,0,EUR,COMPLETED,606.18
Card Payment,Current,2025-08-23 08:07:27,2025-08-24 05:03:33,A Padaria Portuguesa,-2.5,0,EUR,COMPLETED,603.68
Transfer,Current,2025-08-24 07:53:22,2025-08-24 07:53:22,To pocket EUR Savings from EUR,-0.5,0,EUR,COMPLETED,603.18
Transfer,Current,2025-08-24 10:05:22,2025-08-24 10:05:22,To pocket EUR Savings from EUR,-1,0,EUR,COMPLETED,602.18
Transfer,Current,2025-08-24 15:55:14,2025-08-24 15:55:14,To pocket EUR Savings from EUR,-0.75,0,EUR,COMPLETED,601.43
Deposit,Current,2025-08-24 15:55:44,2025-08-24 15:55:45,Apple Pay deposit by *0264,400,0,EUR,COMPLETED,1001.43
Transfer,Current,2025-08-25 03:18:53,2025-08-25 03:18:53,To pocket EUR Savings from EUR,-20,0,EUR,COMPLETED,981.43
Transfer,Current,2025-08-25 12:44:05,2025-08-25 12:44:05,To pocket EUR Savings from EUR,-0.7,0,EUR,COMPLETED,980.73
Transfer,Current,2025-08-25 12:57:52,2025-08-25 12:57:52,To pocket EUR Savings from EUR,-0.77,0,EUR,COMPLETED,979.96
Card Payment,Current,2025-08-24 10:05:22,2025-08-25 16:31:30,IKEA,-35,0,EUR,COMPLETED,944.96
Transfer,Current,2025-08-25 19:31:59,2025-08-25 19:31:59,To pocket EUR Savings from EUR,-0.83,0,EUR,COMPLETED,944.13
Card Payment,Current,2025-08-24 15:55:13,2025-08-26 02:33:24,Restaurante Californ,-206.25,0,EUR,COMPLETED,737.88
Card Payment,Current,2025-08-23 20:14:08,2025-08-26 02:44:42,Continente,-2.87,0,EUR,COMPLETED,735.01
Card Payment,Current,2025-08-24 07:53:21,2025-08-26 02:44:49,A Padaria Portuguesa,-2.5,0,EUR,COMPLETED,732.51
Transfer,Current,2025-08-26 04:10:41,2025-08-26 04:10:41,To pocket EUR Savings from EUR,-1,0,EUR,COMPLETED,731.51
Card Payment,Current,2025-08-25 12:44:04,2025-08-26 05:18:43,Cafe Rest Beira Rio,-23.3,0,EUR,COMPLETED,708.21
Card Payment,Current,2025-08-25 12:57:52,2025-08-26 05:22:19,Minipreço,-51.23,0,EUR,COMPLETED,656.98
Card Payment,Current,2025-08-25 19:31:58,2025-08-26 05:22:20,Minipreço,-35.17,0,EUR,COMPLETED,621.81
Transfer,Current,2025-08-26 09:48:27,2025-08-26 09:48:27,To pocket EUR Savings from EUR,-0.34,0,EUR,COMPLETED,621.47
Deposit,Current,2025-08-26 10:27:17,2025-08-26 10:27:19,Apple Pay deposit by *0264,200,0,EUR,COMPLETED,821.47
Transfer,Current,2025-08-26 10:28:29,2025-08-26 10:28:29,To pocket EUR Savings from EUR,-1,0,EUR,COMPLETED,820.47
Card Payment,Current,2025-08-23 08:12:25,2025-08-26 11:00:55,Google,-17.99,0,EUR,COMPLETED,802.48
Card Payment,Current,2025-08-21 12:51:01,2025-08-26 11:44:33,Uber Eats,-46.14,0,EUR,COMPLETED,756.34
Card Payment,Current,2025-08-21 14:06:56,2025-08-26 11:44:35,Ikeaportuga 15405,-191.91,0,EUR,COMPLETED,564.43
Card Payment,Current,2025-08-22 12:53:48,2025-08-26 11:44:54,Uber Eats,-18.22,0,EUR,COMPLETED,546.21
Card Payment,Current,2025-08-26 04:10:41,2025-08-26 12:07:03,Miió,-20,0,EUR,COMPLETED,526.21
Transfer,Current,2025-08-26 12:17:34,2025-08-26 12:17:34,To pocket EUR Savings from EUR,-0.86,0,EUR,COMPLETED,525.35
Transfer,Current,2025-08-27 02:44:57,2025-08-27 02:44:57,To pocket EUR Savings from EUR,-0.01,0,EUR,COMPLETED,525.34
Card Payment,Current,2025-08-26 10:28:28,2025-08-27 05:04:52,Minipreço,-29,0,EUR,COMPLETED,496.34
Card Payment,Current,2025-08-26 09:48:26,2025-08-27 05:04:55,Cidalia Manuela Pedr,-12.66,0,EUR,COMPLETED,483.68
Transfer,Current,2025-08-27 11:28:37,2025-08-27 11:28:37,To pocket EUR Savings from EUR,-0.8,0,EUR,COMPLETED,482.88
Card Payment,Current,2025-08-26 12:17:33,2025-08-27 15:22:13,Claude.ai,-22.14,0,EUR,COMPLETED,460.74
Transfer,Current,2025-08-27 20:41:14,2025-08-27 20:41:14,To pocket EUR Savings from EUR,-0.4,0,EUR,COMPLETED,460.34
Card Payment,Current,2025-08-27 11:28:36,2025-08-28 05:18:32,Fiel Tradicao Unip L,-9.2,0,EUR,COMPLETED,451.14
Card Payment,Current,2025-08-28 09:47:54,,Continente,-20,0,EUR,REVERTED,
Transfer,Current,2025-08-28 09:47:55,2025-08-28 09:47:55,To pocket EUR Savings from EUR,-1,0,EUR,COMPLETED,450.14
Transfer,Current,2025-08-28 10:57:54,2025-08-28 10:57:54,To pocket EUR Savings from EUR,-0.64,0,EUR,COMPLETED,449.5
Transfer,Current,2025-08-28 11:17:24,2025-08-28 11:17:24,To pocket EUR Savings from EUR,-0.5,0,EUR,COMPLETED,449
Transfer,Current,2025-08-28 11:36:41,2025-08-28 11:36:41,To pocket EUR Savings from EUR,-0.68,0,EUR,COMPLETED,448.32
Card Payment,Current,2025-08-27 02:44:57,2025-08-28 13:11:59,Netflix,-12.99,0,EUR,COMPLETED,435.33
Card Payment,Current,2025-08-28 10:57:54,2025-08-28 17:00:52,Continente,-18.36,0,EUR,COMPLETED,416.97
Transfer,Current,2025-08-28 20:38:25,2025-08-28 20:38:25,To pocket EUR Savings from EUR,-0.5,0,EUR,COMPLETED,416.47
Card Payment,Current,2025-08-28 11:36:40,2025-08-29 05:32:40,Continente,-57.32,0,EUR,COMPLETED,359.15
Card Payment,Current,2025-08-27 20:41:14,2025-08-29 05:32:43,Cafe Rest Beira Rio,-32.6,0,EUR,COMPLETED,326.55
Card Payment,Current,2025-08-28 11:17:23,2025-08-29 05:32:44,O Pao Quente,-7.5,0,EUR,COMPLETED,319.05
Transfer,Current,2025-08-29 05:52:33,2025-08-29 05:52:33,To pocket EUR Savings from EUR,-0.51,0,EUR,COMPLETED,318.54
Transfer,Current,2025-08-29 11:19:37,2025-08-29 11:19:37,To pocket EUR Savings from EUR,-0.8,0,EUR,COMPLETED,317.74
Transfer,Current,2025-08-29 11:23:51,2025-08-29 11:23:51,To pocket EUR Savings from EUR,-0.3,0,EUR,COMPLETED,317.44
Deposit,Current,2025-08-29 11:24:41,2025-08-29 11:24:42,Apple Pay deposit by *0264,200,0,EUR,COMPLETED,517.44
Transfer,Current,2025-08-29 11:42:18,2025-08-29 11:42:18,To pocket EUR Savings from EUR,-0.77,0,EUR,COMPLETED,516.67
Transfer,Current,2025-08-29 19:20:07,2025-08-29 19:20:07,To pocket EUR Savings from EUR,-0.4,0,EUR,COMPLETED,516.27
Transfer,Current,2025-08-30 02:53:44,2025-08-30 02:53:44,To pocket EUR Savings from EUR,-0.05,0,EUR,COMPLETED,516.22
Card Payment,Current,2025-08-29 11:42:17,2025-08-30 04:56:29,Minipreço,-37.23,0,EUR,COMPLETED,478.99
Card Payment,Current,2025-08-29 11:19:36,2025-08-30 04:56:29,Fiel Tradicao Unip L,-9.2,0,EUR,COMPLETED,469.79
Card Payment,Current,2025-08-28 20:38:25,2025-08-30 04:56:51,Alvaros,-4.5,0,EUR,COMPLETED,465.29
Card Payment,Current,2025-08-29 19:20:06,2025-08-30 04:56:52,Alvaros,-26.6,0,EUR,COMPLETED,438.69
Card Payment,Current,2025-08-29 11:23:50,2025-08-30 16:11:44,Claude.ai,-110.7,0,EUR,COMPLETED,327.99
Transfer,Current,2025-08-31 12:04:38,2025-08-31 12:04:38,To pocket EUR Savings from EUR,-1,0,EUR,COMPLETED,326.99
Card Payment,Current,2025-08-29 05:52:32,2025-08-31 13:01:55,Apple,-5.49,0,EUR,COMPLETED,321.5
Transfer,Current,2025-08-31 15:15:08,2025-08-31 15:15:08,To pocket EUR Savings from EUR,-1,0,EUR,COMPLETED,320.5
Transfer,Current,2025-08-31 15:42:35,2025-08-31 15:42:35,To pocket EUR Savings from EUR,-0.2,0,EUR,COMPLETED,320.3
Transfer,Current,2025-08-31 16:34:43,2025-08-31 16:34:43,To pocket EUR Savings from EUR,-0.85,0,EUR,COMPLETED,319.45
Transfer,Current,2025-08-31 16:47:08,2025-08-31 16:47:08,To pocket EUR Savings from EUR,-0.97,0,EUR,COMPLETED,318.48
Transfer,Current,2025-08-31 16:54:03,2025-08-31 16:54:03,To pocket EUR Savings from EUR,-1,0,EUR,COMPLETED,317.48
Transfer,Current,2025-09-01 03:48:53,2025-09-01 03:48:53,To pocket EUR Savings from EUR,-20,0,EUR,COMPLETED,297.48
Transfer,Current,2025-09-01 03:48:53,2025-09-01 03:48:53,To pocket EUR Rainy day from EUR,-50,0,EUR,COMPLETED,247.48
Card Payment,Current,2025-08-31 15:42:34,2025-09-01 05:07:55,Manteigaria Bolhao,-21.8,0,EUR,COMPLETED,225.68
Deposit,Current,2025-09-01 07:52:47,2025-09-01 07:52:48,Apple Pay deposit by *0264,400,0,EUR,COMPLETED,625.68
Transfer,Current,2025-09-01 08:02:41,2025-09-01 08:02:41,To pocket EUR Savings from EUR,-0.01,0,EUR,COMPLETED,625.67
Card Payment,Current,2025-08-31 16:47:07,2025-09-01 09:21:47,Porto Mar,-3.03,0,EUR,COMPLETED,622.64
Card Payment,Current,2025-08-31 15:15:07,2025-09-01 09:22:04,Restaurante Luffa,-139,0,EUR,COMPLETED,483.64
Card Payment,Current,2025-08-31 12:04:38,2025-09-01 12:19:22,Miió,-20,0,EUR,COMPLETED,463.64
Card Payment,Current,2025-08-30 02:53:44,2025-09-01 13:31:30,Apple,-21.95,0,EUR,COMPLETED,441.69
Card Payment,Current,2025-08-31 16:54:03,2025-09-01 13:31:34,Uber,-2,0,EUR,COMPLETED,439.69
Card Payment,Current,2025-08-31 16:34:42,2025-09-01 13:31:39,Uber,-6.15,0,EUR,COMPLETED,433.54
Transfer,Current,2025-09-02 12:16:05,2025-09-02 12:16:05,To pocket EUR Savings from EUR,-0.01,0,EUR,COMPLETED,433.53
Card Payment,Current,2025-09-01 08:02:41,2025-09-03 13:28:27,Google,-99.99,0,EUR,COMPLETED,333.54
Transfer,Current,2025-09-04 08:43:31,2025-09-04 08:43:31,To pocket EUR Savings from EUR,-0.3,0,EUR,COMPLETED,333.24
Card Payment,Current,2025-09-02 12:16:04,2025-09-04 13:13:46,PlayStation,-8.99,0,EUR,COMPLETED,324.25
Card Payment,Current,2025-09-04 14:59:01,,Continente,-20,0,EUR,REVERTED,
Transfer,Current,2025-09-04 14:59:02,2025-09-04 14:59:02,To pocket EUR Savings from EUR,-1,0,EUR,COMPLETED,323.25
Card Payment,Current,2025-09-04 15:00:22,,Continente,-20,0,EUR,REVERTED,
Transfer,Current,2025-09-04 15:00:23,2025-09-04 15:00:23,To pocket EUR Savings from EUR,-1,0,EUR,COMPLETED,322.25
Card Payment,Current,2025-09-04 15:01:48,,Continente,-20,0,EUR,REVERTED,
Transfer,Current,2025-09-04 15:01:49,2025-09-04 15:01:49,To pocket EUR Savings from EUR,-1,0,EUR,COMPLETED,321.25
Transfer,Current,2025-09-04 15:07:33,2025-09-04 15:07:33,To pocket EUR Savings from EUR,-1,0,EUR,COMPLETED,320.25
Transfer,Current,2025-09-04 15:19:58,2025-09-04 15:19:58,To pocket EUR Savings from EUR,-0.38,0,EUR,COMPLETED,319.87
Card Payment,Current,2025-09-04 15:07:32,2025-09-05 02:29:20,Continente,-15.93,0,EUR,COMPLETED,303.94
Card Payment,Current,2025-09-04 15:19:58,2025-09-05 05:28:32,Continente,-39.62,0,EUR,COMPLETED,264.32
Card Payment,Current,2025-09-04 08:43:31,2025-09-05 05:32:39,C C Pombalinho,-10.7,0,EUR,COMPLETED,253.62
Transfer,Current,2025-09-05 11:43:29,2025-09-05 11:43:29,To pocket EUR Savings from EUR,-0.05,0,EUR,COMPLETED,253.57
Transfer,Current,2025-09-05 12:35:17,2025-09-05 12:35:17,To pocket EUR Savings from EUR,-1,0,EUR,COMPLETED,252.57
Transfer,Current,2025-09-05 18:34:54,2025-09-05 18:34:54,To pocket EUR Savings from EUR,-0.39,0,EUR,COMPLETED,252.18
Transfer,Current,2025-09-05 19:34:33,2025-09-05 19:34:33,To pocket EUR Savings from EUR,-0.89,0,EUR,COMPLETED,251.29
Card Payment,Current,2025-09-05 18:34:53,2025-09-06 05:12:29,Continente,-12.61,0,EUR,COMPLETED,238.68
Transfer,Current,2025-09-06 09:17:38,2025-09-06 09:17:38,To pocket EUR Savings from EUR,-0.45,0,EUR,COMPLETED,238.23
Card Payment,Current,2025-09-05 11:43:28,2025-09-06 09:35:58,Brisa,-3.95,0,EUR,COMPLETED,234.28
Transfer,Current,2025-09-06 13:45:38,2025-09-06 13:45:38,To pocket EUR Savings from EUR,-0.89,0,EUR,COMPLETED,233.39
Transfer,Current,2025-09-06 14:02:08,2025-09-06 14:02:08,To pocket EUR Savings from EUR,-1,0,EUR,COMPLETED,232.39
Card Payment,Current,2025-09-05 12:35:17,2025-09-06 18:08:39,Miió,-20,0,EUR,COMPLETED,212.39
Transfer,Current,2025-09-06 18:48:15,2025-09-06 18:48:15,To pocket EUR Savings from EUR,-0.41,0,EUR,COMPLETED,211.98
Card Payment,Current,2025-09-06 13:45:37,2025-09-07 05:51:16,Continente,-12.11,0,EUR,COMPLETED,199.87
Transfer,Current,2025-09-07 08:19:08,2025-09-07 08:19:08,To pocket EUR Savings from EUR,-0.5,0,EUR,COMPLETED,199.37
Deposit,Current,2025-09-07 08:19:32,2025-09-07 08:19:33,Apple Pay deposit by *0264,400,0,EUR,COMPLETED,599.37
Card Payment,Current,2025-09-06 09:17:37,2025-09-07 08:34:01,Padaria Taleiga,-24.55,0,EUR,COMPLETED,574.82
Transfer,Current,2025-09-07 09:21:39,2025-09-07 09:21:39,To pocket EUR Savings from EUR,-0.51,0,EUR,COMPLETED,574.31
Transfer,Current,2025-09-07 13:06:54,2025-09-07 13:06:54,To pocket EUR Savings from EUR,-0.06,0,EUR,COMPLETED,574.25
Card Payment,Current,2025-09-06 18:48:14,2025-09-07 16:34:23,GitHub,-8.59,0.09,EUR,COMPLETED,565.57
Transfer,Current,2025-09-08 03:15:13,2025-09-08 03:15:13,To pocket EUR Savings from EUR,-20,0,EUR,COMPLETED,545.57
Card Payment,Current,2025-09-07 08:19:08,2025-09-08 05:30:55,A Padaria Portuguesa,-2.5,0,EUR,COMPLETED,543.07
Transfer,Current,2025-09-08 07:44:42,2025-09-08 07:44:42,To pocket EUR Savings from EUR,-0.5,0,EUR,COMPLETED,542.57
Card Payment,Current,2025-09-07 09:21:38,2025-09-08 11:11:39,Pingo Doce,-26.49,0,EUR,COMPLETED,516.08
Transfer,Current,2025-09-08 13:08:54,2025-09-08 13:08:54,To pocket EUR Savings from EUR,-0.01,0,EUR,COMPLETED,516.07
Card Payment,Current,2025-09-05 19:34:33,2025-09-08 14:10:35,Uber Eats,-49.11,0,EUR,COMPLETED,466.96
Card Payment,Current,2025-09-08 07:44:42,2025-09-09 05:19:53,A Padaria Portuguesa,-2.5,0,EUR,COMPLETED,464.46
Transfer,Current,2025-09-09 09:43:31,2025-09-09 09:43:31,To pocket EUR Savings from EUR,-0.45,0,EUR,COMPLETED,464.01
Card Payment,Current,2025-09-06 14:02:07,2025-09-09 12:02:15,Uber Eats,-27,0,EUR,COMPLETED,437.01
Transfer,Current,2025-09-10 09:30:25,2025-09-10 09:30:25,To pocket EUR Savings from EUR,-0.52,0,EUR,COMPLETED,436.49
Transfer,Current,2025-09-10 11:08:28,2025-09-10 11:08:28,To pocket EUR Savings from EUR,-0.98,0,EUR,COMPLETED,435.51
Deposit,Current,2025-09-10 11:09:24,2025-09-10 11:09:25,Apple Pay deposit by *0264,200,0,EUR,COMPLETED,635.51
Card Payment,Current,2025-09-07 13:06:53,2025-09-10 11:53:03,Uber Eats,-53.94,0,EUR,COMPLETED,581.57
Card Payment,Current,2025-09-09 09:43:29,2025-09-10 13:55:19,Submithub,-8.55,0,EUR,COMPLETED,573.02
Card Payment,Current,2025-09-08 13:08:49,2025-09-11 11:25:34,Uber Eats,-69.99,0,EUR,COMPLETED,503.03
Transfer,Current,2025-09-11 12:45:42,2025-09-11 12:45:42,To pocket EUR Savings from EUR,-0.98,0,EUR,COMPLETED,502.05
Card Payment,Current,2025-09-10 09:30:25,2025-09-11 12:52:10,Forasongmed,-21.48,0,EUR,COMPLETED,480.57
Card Payment,Current,2025-09-10 11:08:27,2025-09-11 13:19:53,Forasongmed,-15.02,0,EUR,COMPLETED,465.55
Transfer,Current,2025-09-13 09:57:40,2025-09-13 09:57:40,To pocket EUR Savings from EUR,-0.95,0,EUR,COMPLETED,464.6
Transfer,Current,2025-09-13 10:18:12,2025-09-13 10:18:12,To pocket EUR Savings from EUR,-0.65,0,EUR,COMPLETED,463.95
Transfer,Current,2025-09-13 19:41:05,2025-09-13 19:41:05,To pocket EUR Savings from EUR,-0.01,0,EUR,COMPLETED,463.94
Card Payment,Current,2025-09-13 09:41:18,2025-09-14 05:11:05,Burguezia Do Leitao,-10.35,0,EUR,COMPLETED,453.59
Card Payment,Current,2025-09-13 09:57:14,2025-09-14 05:11:05,Burguezia Do Leitao,-1.05,0,EUR,COMPLETED,452.54
Transfer,Current,2025-09-14 08:54:09,2025-09-14 08:54:09,To pocket EUR Savings from EUR,-0.2,0,EUR,COMPLETED,452.34
Transfer,Current,2025-09-14 09:39:42,2025-09-14 09:39:42,To pocket EUR Savings from EUR,-1,0,EUR,COMPLETED,451.34
Transfer,Current,2025-09-14 10:34:13,2025-09-14 10:34:13,To pocket EUR Savings from EUR,-0.1,0,EUR,COMPLETED,451.24
Card Payment,Current,2025-09-11 12:45:42,2025-09-14 10:47:46,Uber Eats,-25.02,0,EUR,COMPLETED,426.22
Card Payment,Current,2025-09-13 19:41:04,2025-09-14 10:53:40,Apple,-1.99,0,EUR,COMPLETED,424.23
Transfer,Current,2025-09-14 18:06:13,2025-09-14 18:06:13,To pocket EUR Savings from EUR,-0.05,0,EUR,COMPLETED,424.18
Transfer,Current,2025-09-15 03:23:05,2025-09-15 03:23:05,To pocket EUR Savings from EUR,-20,0,EUR,COMPLETED,404.18
Card Payment,Current,2025-09-14 18:06:12,2025-09-15 04:55:39,Burguezia Do Leitao,-1.95,0,EUR,COMPLETED,402.23
Card Payment,Current,2025-09-14 10:34:12,2025-09-15 04:55:45,Confeitaria Lailai,-18.9,0,EUR,COMPLETED,383.33
Card Payment,Current,2025-09-14 08:54:08,2025-09-15 09:16:07,Cp 208 Amarante,-0.8,0,EUR,COMPLETED,382.53
Card Payment,Current,2025-09-14 09:39:41,2025-09-15 10:20:39,Miió,-20,0,EUR,COMPLETED,362.53
Transfer,Current,2025-09-16 11:16:58,2025-09-16 11:16:58,To pocket EUR Savings from EUR,-0.85,0,EUR,COMPLETED,361.68
Transfer,Current,2025-09-16 22:40:35,2025-09-16 22:40:35,To pocket EUR Savings from EUR,-1,0,EUR,COMPLETED,360.68
Transfer,Current,2025-09-16 22:59:00,2025-09-16 22:59:00,To pocket EUR Savings from EUR,-0.6,0,EUR,COMPLETED,360.08
Transfer,Current,2025-09-16 23:22:11,2025-09-16 23:22:11,To pocket EUR Savings from EUR,-1,0,EUR,COMPLETED,359.08
Deposit,Current,2025-09-16 23:24:04,2025-09-16 23:24:05,Apple Pay deposit by *0264,200,0,EUR,COMPLETED,559.08
Transfer,Current,2025-09-17 03:14:45,2025-09-17 03:14:45,To pocket EUR Savings from EUR,-0.6,0,EUR,COMPLETED,558.48
Transfer,Current,2025-09-17 07:15:32,2025-09-17 07:15:32,To pocket EUR Savings from EUR,-0.5,0,EUR,COMPLETED,557.98
Transfer,Current,2025-09-17 08:44:05,2025-09-17 08:44:05,To pocket EUR Savings from EUR,-0.1,0,EUR,COMPLETED,557.88
Card Payment,Current,2025-09-16 22:40:35,2025-09-17 09:58:46,Uber,-10,0,EUR,COMPLETED,547.88
Card Payment,Current,2025-09-17 03:14:44,2025-09-17 12:28:27,Gate Gourmet,-2.4,0,EUR,COMPLETED,545.48
Card Payment,Current,2025-09-16 11:16:57,2025-09-17 12:37:59,areas,-28.15,0,EUR,COMPLETED,517.33
Card Payment,Current,2025-09-17 08:44:04,2025-09-17 21:49:48,Spaces Walvis,-6.9,0,EUR,COMPLETED,510.43
Card Payment,Current,2025-09-16 22:59:00,2025-09-18 09:00:55,Room Mate Aitana,-51.4,0,EUR,COMPLETED,459.03
Card Payment,Current,2025-09-16 23:22:11,2025-09-18 09:00:55,Room Mate Aitana,-4,0,EUR,COMPLETED,455.03
Card Payment,Current,2025-09-17 07:15:31,2025-09-18 09:00:55,Room Mate Aitana,-24.5,0,EUR,COMPLETED,430.53
Transfer,Current,2025-09-19 12:45:33,2025-09-19 12:45:33,To pocket EUR Savings from EUR,-0.96,0,EUR,COMPLETED,429.57
Transfer,Current,2025-09-19 12:48:52,2025-09-19 12:48:52,To pocket EUR Savings from EUR,-0.78,0,EUR,COMPLETED,428.79
Transfer,Current,2025-09-19 20:39:22,2025-09-19 20:39:22,To pocket EUR Savings from EUR,-1,0,EUR,COMPLETED,427.79
Transfer,Current,2025-09-20 08:11:04,2025-09-20 08:11:04,To pocket EUR Savings from EUR,-0.5,0,EUR,COMPLETED,427.29
Transfer,Current,2025-09-20 09:20:42,2025-09-20 09:20:42,To pocket EUR Savings from EUR,-0.03,0,EUR,COMPLETED,427.26
Transfer,Current,2025-09-20 10:05:30,2025-09-20 10:05:30,To pocket EUR Savings from EUR,-0.44,0,EUR,COMPLETED,426.82
Card Payment,Current,2025-09-19 12:48:52,2025-09-20 10:40:03,Uber Eats,-18.22,0,EUR,COMPLETED,408.6
Transfer,Current,2025-09-20 10:59:21,2025-09-20 10:59:21,To pocket EUR Savings from EUR,-0.44,0,EUR,COMPLETED,408.16
Transfer,Current,2025-09-20 13:10:03,2025-09-20 13:10:03,To pocket EUR Savings from EUR,-0.01,0,EUR,COMPLETED,408.15
Card Payment,Current,2025-09-19 12:45:33,2025-09-20 18:20:30,OpenAI,-21.04,0,EUR,COMPLETED,387.11
Card Payment,Current,2025-09-20 10:05:29,2025-09-21 05:49:06,Talho Super Desconto,-50.56,0,EUR,COMPLETED,336.55
Card Payment,Current,2025-09-20 08:11:04,2025-09-21 05:50:00,A Padaria Portuguesa,-2.5,0,EUR,COMPLETED,334.05
Transfer,Current,2025-09-21 08:09:00,2025-09-21 08:09:00,To pocket EUR Savings from EUR,-0.5,0,EUR,COMPLETED,333.55
Card Payment,Current,2025-09-20 13:10:03,2025-09-21 10:02:12,Uber,-4.99,0,EUR,COMPLETED,328.56
Card Payment,Current,2025-09-20 09:20:42,2025-09-21 12:03:16,Pingo Doce,-32.97,0,EUR,COMPLETED,295.59
Card Payment,Current,2025-09-19 20:39:22,2025-09-21 12:03:34,Restaurante Coradinh,-80,0,EUR,COMPLETED,215.59
Transfer,Current,2025-09-21 14:24:06,2025-09-21 14:24:06,To pocket EUR Savings from EUR,-0.82,0,EUR,COMPLETED,214.77
Deposit,Current,2025-09-21 14:27:58,2025-09-21 14:27:59,Apple Pay deposit by *0264,200,0,EUR,COMPLETED,414.77
Card Payment,Current,2025-09-20 10:59:20,2025-09-21 16:26:45,Submithub,-8.56,0.09,EUR,COMPLETED,406.12
Transfer,Current,2025-09-22 03:15:48,2025-09-22 03:15:48,To pocket EUR Savings from EUR,-20,0,EUR,COMPLETED,386.12
Card Payment,Current,2025-09-21 08:08:59,2025-09-22 05:14:18,A Padaria Portuguesa,-2.5,0,EUR,COMPLETED,383.62
Card Payment,Current,2025-09-21 14:24:01,2025-09-22 10:05:55,Bcm Bricolage,-13.18,0,EUR,COMPLETED,370.44
Transfer,Current,2025-09-23 08:12:26,2025-09-23 08:12:26,To pocket EUR Savings from EUR,-0.01,0,EUR,COMPLETED,370.43
Card Payment,Current,2025-09-23 08:12:26,2025-09-25 09:23:22,Google,-17.99,0,EUR,COMPLETED,352.44
Transfer,Current,2025-09-25 12:50:34,2025-09-25 12:50:34,To pocket EUR Savings from EUR,-0.2,0,EUR,COMPLETED,352.24
Transfer,Current,2025-09-26 12:29:25,2025-09-26 12:29:25,To pocket EUR Savings from EUR,-0.12,0,EUR,COMPLETED,352.12
Transfer,Current,2025-09-27 03:05:03,2025-09-27 03:05:03,To pocket EUR Savings from EUR,-0.01,0,EUR,COMPLETED,352.11
Transfer,Current,2025-09-27 08:21:54,2025-09-27 08:21:54,To pocket EUR Savings from EUR,-0.5,0,EUR,COMPLETED,351.61
Card Payment,Current,2025-09-27 08:21:53,2025-09-28 05:06:52,A Padaria Portuguesa,-2.5,0,EUR,COMPLETED,349.11
Transfer,Current,2025-09-28 07:47:01,2025-09-28 07:47:01,To pocket EUR Savings from EUR,-0.5,0,EUR,COMPLETED,348.61
Transfer,Current,2025-09-28 08:27:42,2025-09-28 08:27:42,To pocket EUR Savings from EUR,-0.38,0,EUR,COMPLETED,348.23
Card Payment,Current,2025-09-25 12:50:34,2025-09-28 09:52:53,Uber Eats,-24.8,0,EUR,COMPLETED,323.43
Card Payment,Current,2025-09-27 03:05:02,2025-09-28 09:53:27,Netflix,-12.99,0,EUR,COMPLETED,310.44
Transfer,Current,2025-09-29 03:46:46,2025-09-29 03:46:46,To pocket EUR Savings from EUR,-20,0,EUR,COMPLETED,290.44
Card Payment,Current,2025-09-28 07:47:00,2025-09-29 05:13:57,A Padaria Portuguesa,-2.5,0,EUR,COMPLETED,287.94
Transfer,Current,2025-09-29 05:52:40,2025-09-29 05:52:40,To pocket EUR Savings from EUR,-0.51,0,EUR,COMPLETED,287.43
Deposit,Current,2025-09-29 08:13:22,2025-09-29 08:13:23,Apple Pay deposit by *0264,200,0,EUR,COMPLETED,487.43
Card Payment,Current,2025-09-28 08:27:41,2025-09-29 08:40:35,Pingo Doce,-60.62,0,EUR,COMPLETED,426.81
Transfer,Current,2025-09-29 11:26:15,2025-09-29 11:26:15,To pocket EUR Savings from EUR,-0.3,0,EUR,COMPLETED,426.51
Card Payment,Current,2025-09-26 12:29:25,2025-09-29 12:09:05,Uber Eats,-17.88,0,EUR,COMPLETED,408.63
Card Payment,Current,2025-09-30 02:54:35,,Apple,-21.95,0,EUR,PENDING,
Transfer,Current,2025-09-30 02:54:35,2025-09-30 02:54:35,To pocket EUR Savings from EUR,-0.05,0,EUR,COMPLETED,408.58
Card Payment,Current,2025-09-29 05:52:39,2025-09-30 16:27:08,Apple,-5.49,0,EUR,COMPLETED,403.09
Card Payment,Current,2025-09-29 11:26:14,2025-09-30 18:30:42,Claude.ai,-110.7,0,EUR,COMPLETED,292.39
Transfer,Current,2025-10-01 02:39:23,2025-10-01 02:39:23,To pocket EUR Rainy day from EUR,-50,0,EUR,COMPLETED,242.39
Card Payment,Current,2025-10-01 08:35:07,,Amplesot2jl,-91.46,0,EUR,PENDING,
Transfer,Current,2025-10-01 08:35:07,2025-10-01 08:35:07,To pocket EUR Savings from EUR,-0.54,0,EUR,COMPLETED,241.85
Deposit,Current,2025-10-01 08:35:33,2025-10-01 08:35:35,Apple Pay deposit by *0264,200,0,EUR,COMPLETED,441.85